"","word","Life and Times (1881)","My Bondage (1855)","Narrative Life (1845)","Travel Diary","sum_word_counts"
"1","slave",423,539,146,2,1110
"2","slavery",414,470,94,1,979
"3","time",397,248,126,13,784
"4","master",292,355,124,1,772
"5","slaves",248,286,132,1,667
"6","one",600,0,0,48,648
"7","people",353,166,18,31,568
"8","colored",351,108,29,2,490
"9","life",243,186,40,15,484
"10","upon",434,0,0,29,463
"11","man",430,0,0,13,443
"12","day",184,127,50,46,407
"13","men",364,0,0,17,381
"14","free",191,132,36,4,363
"15","now",326,0,0,29,355
"16","house",163,119,44,10,336
"17","“",333,0,0,0,333
"18","made",313,0,0,12,325
"19","white",169,107,44,4,324
"20","country",219,84,11,9,323
"21","home",170,105,42,6,323
"22","found",145,100,47,16,308
"23","covey",108,138,61,0,307
"24","power",179,105,14,5,303
"25","great",278,0,0,22,300
"26","old",280,0,0,20,300
"27","said",277,0,0,18,295
"28","friends",169,94,16,2,281
"29","new",272,0,0,7,279
"30","will",266,0,0,12,278
"31","told",137,82,43,7,269
"32","well",243,0,0,20,263
"33","baltimore",104,113,44,0,261
"34","children",91,127,33,4,255
"35","much",235,0,0,19,254
"36","hands",115,93,41,3,252
"37","called",119,77,37,17,250
"38","american",128,96,8,7,239
"39","first",218,0,0,10,228
"40","slaveholders",76,121,30,1,228
"41","south",150,62,14,2,228
"42","states",226,0,0,0,226
"43","little",211,0,0,14,225
"44","hand",105,89,26,4,224
"45","freedom",105,79,29,2,215
"46","many",196,0,0,19,215
"47","condition",106,80,26,1,213
"48","good",199,0,0,13,212
"49","left",96,71,42,2,211
"50","thomas",102,85,21,1,209
"51","work",203,0,0,6,209
"52","united",146,54,4,0,204
"53","every",198,0,0,3,201
"54","liberty",106,82,13,0,201
"55","human",87,96,13,4,200
"56","north",129,50,21,0,200
"57","years",181,0,0,19,200
"58","never",193,0,0,5,198
"59","world",103,77,8,10,198
"60","can",190,0,0,7,197
"61","heart",82,88,26,1,197
"62","may",180,0,0,17,197
"63","must",182,0,0,15,197
"64","might",193,0,0,2,195
"65","without",184,0,0,11,195
"66","mind",87,77,21,4,189
"67","thought",180,0,0,7,187
"68","came",178,0,0,8,186
"69","saw",155,0,0,29,184
"70","chapter",95,64,23,0,182
"71","way",165,0,0,17,182
"72","escape",82,74,24,1,181
"73","night",85,62,26,8,181
"74","plantation",48,97,36,0,181
"75","john",136,25,13,5,179
"76","like",162,0,0,17,179
"77","god",55,92,25,6,178
"78","place",166,0,0,11,177
"79","character",83,74,16,2,175
"80","read",73,65,33,3,174
"81","public",90,76,7,0,173
"82","state",172,0,0,1,173
"83","blood",61,75,35,1,172
"84","city",95,37,12,28,172
"85","spirit",85,69,17,1,172
"86","law",88,66,16,0,170
"87","say",164,0,0,6,170
"88","brought",92,57,14,6,169
"89","long",156,0,0,13,169
"90","make",161,0,0,5,166
"91","means",86,61,18,0,165
"92","two",144,0,0,21,165
"93","among",157,0,0,7,164
"94","head",72,61,23,6,162
"95","poor",67,72,23,0,162
"96","see",130,0,0,31,161
"97","words",80,59,20,2,161
"98","part",151,0,0,9,160
"99","morning",61,50,24,23,158
"100","nature",69,83,6,0,158
"101","slaveholder",52,84,22,0,158
"102","col",66,91,0,0,157
"103","manner",72,65,12,7,156
"104","hugh",65,72,18,0,155
"105","reader",57,93,2,0,152
"106","word",81,48,20,3,152
"107","auld",70,67,14,0,151
"108","though",143,0,0,8,151
"109","days",65,50,17,16,148
"110","take",146,0,0,2,148
"111","field",59,60,25,1,145
"112","lloyd",61,62,21,0,144
"113","experience",69,65,9,0,143
"114","hope",76,47,18,2,143
"115","death",59,47,32,4,142
"116","black",74,58,9,0,141
"117","come",137,0,0,4,141
"118","right",138,0,0,2,140
"119","england",86,44,3,6,139
"120","church",52,61,11,14,138
"121","class",89,37,11,1,138
"122","friend",85,41,6,6,138
"123","ever",132,0,0,5,137
"124","heard",65,53,15,4,137
"125","mrs",109,0,0,28,137
"126","war",119,12,4,1,136
"127","went",113,0,0,23,136
"128","family",61,61,11,2,135
"129","matter",49,65,21,0,135
"130","feeling",82,38,13,1,134
"131","henry",64,43,23,4,134
"132","hard",57,52,18,6,133
"133","met",71,44,13,5,133
"134","felt",131,0,0,1,132
"135","times",67,41,21,3,132
"136","antislavery",129,2,0,0,131
"137","done",127,0,0,4,131
"138","held",79,40,11,1,131
"139","question",82,45,3,0,130
"140","true",78,42,9,1,130
"141","money",71,40,17,1,129
"142","union",87,25,17,0,129
"143","land",55,51,14,8,128
"144","moment",62,47,18,1,128
"145","negro",89,34,4,0,127
"146","cause",125,0,0,1,126
"147","mother",41,65,15,4,125
"148","sense",67,46,9,3,125
"149","soon",112,0,0,11,123
"150","view",53,51,5,14,123
"151","douglass",64,46,11,1,122
"152","government",97,21,3,1,122
"153","party",78,42,0,2,122
"154","president",117,4,1,0,122
"155","yet",109,0,0,13,122
"156","even",115,0,0,6,121
"157","hold",56,42,23,0,121
"158","know",116,0,0,5,121
"159","meeting",72,34,12,3,121
"160","shall",111,0,0,10,121
"161","week",44,47,27,2,120
"162","william",63,44,13,0,120
"163","justice",65,49,5,0,119
"164","knowledge",56,53,9,1,119
"165","overseer",44,59,16,0,119
"166","race",92,22,5,0,119
"167","masters",43,52,23,0,118
"168","seemed",109,0,0,9,118
"169","soul",35,57,24,1,117
"170","still",112,0,0,5,117
"171","subject",62,50,5,0,117
"172","away",110,0,0,6,116
"173","”",115,0,0,0,115
"174","dear",53,51,8,3,115
"175","ground",67,36,8,4,115
"176","lincoln",114,0,0,1,115
"177","moral",57,52,6,0,115
"178","presence",62,34,15,4,115
"179","speech",73,36,6,0,115
"180","thus",111,0,0,4,115
"181","woman",42,52,17,4,115
"182","system",52,56,6,0,114
"183","whip",28,55,29,2,114
"184","lived",45,36,31,1,113
"185","speak",60,39,11,3,113
"186","common",62,39,9,2,112
"187","stand",49,46,13,4,112
"188","whole",107,0,0,5,112
"189","however",107,0,0,4,111
"190","set",53,41,15,2,111
"191","york",73,29,9,0,111
"192","lloyd’s",38,51,21,0,110
"193","received",65,24,15,6,110
"194","half",43,38,23,5,109
"195","religious",40,52,15,2,109
"196","society",53,48,8,0,109
"197","took",97,0,0,12,109
"198","fact",104,0,0,4,108
"199","property",55,43,10,0,108
"200","woods",43,47,18,0,108
"201","far",101,0,0,6,107
"202","get",103,0,0,4,107
"203","given",103,0,0,4,107
"204","best",100,0,0,5,105
"205","circumstances",54,40,11,0,105
"206","brother",35,50,17,2,104
"207","just",99,0,0,5,104
"208","reason",56,39,7,2,104
"209","easily",56,44,1,1,102
"210","gave",97,0,0,5,102
"211","nation",59,39,3,1,102
"212","something",98,0,0,4,102
"213","three",94,0,0,8,102
"214","labor",59,37,5,0,101
"215","leave",59,26,11,5,101
"216","respect",66,31,2,2,101
"217","wife",40,45,14,2,101
"218","maryland",42,43,15,0,100
"219","strong",55,35,5,5,100
"220","give",97,0,0,2,99
"221","southern",59,34,5,1,99
"222","stood",44,36,15,4,99
"223","another",93,0,0,5,98
"224","natural",43,47,8,0,98
"225","nothing",91,0,0,7,98
"226","spent",36,34,11,17,98
"227","frederick",48,31,18,0,97
"228","mistress",33,46,17,1,97
"229","person",43,41,13,0,97
"230","religion",19,54,18,6,97
"231","return",43,37,16,1,97
"232","better",88,0,0,8,96
"233","cruel",36,41,19,0,96
"234","light",34,49,10,3,96
"235","end",92,0,0,3,95
"236","last",89,0,0,6,95
"237","single",35,45,14,1,95
"238","truth",41,41,10,3,95
"239","young",94,0,0,1,95
"240","bedford",28,46,19,1,94
"241","blow",38,44,12,0,94
"242","back",89,0,0,4,93
"243","feel",40,35,14,4,93
"244","fellow",37,38,15,3,93
"245","persons",48,40,4,1,93
"246","purpose",52,26,15,0,93
"247","living",48,34,9,1,92
"248","till",48,22,17,5,92
"249","anti",0,78,13,0,91
"250","large",84,0,0,7,91
"251","master’s",29,46,16,0,91
"252","occasion",63,23,3,2,91
"253","passed",48,28,12,3,91
"254","seen",70,0,0,21,91
"255","others",89,0,0,1,90
"256","peace",63,25,0,2,90
"257","color",53,32,1,3,89
"258","seldom",27,42,20,0,89
"259","slaveholding",43,36,10,0,89
"260","hour",53,26,6,3,88
"261","miles",38,27,17,6,88
"262","school",34,37,14,3,88
"263","body",42,36,7,2,87
"264","doubt",52,30,5,0,87
"265","less",85,0,0,2,87
"266","live",38,25,21,3,87
"267","name",84,0,0,3,87
"268","ship",17,43,15,12,87
"269","brown",82,3,0,1,86
"270","company",44,29,6,7,86
"271","enough",86,0,0,0,86
"272","history",54,25,4,3,86
"273","rights",50,30,6,0,86
"274","since",84,0,0,2,86
"275","learn",35,32,18,0,85
"276","love",25,45,13,2,85
"277","meet",49,25,9,2,85
"278","think",75,0,0,10,85
"279","allowed",40,32,10,2,84
"280","equal",53,23,4,4,84
"281","hundred",49,23,3,9,84
"282","object",47,30,7,0,84
"283","ready",39,24,19,2,84
"284","run",32,28,22,2,84
"285","care",36,32,14,1,83
"286","child",30,44,9,0,83
"287","dollars",42,31,9,1,83
"288","effect",47,20,13,3,83
"289","full",74,0,0,9,83
"290","hear",34,33,12,4,83
"291","looked",41,28,12,2,83
"292","regard",31,42,10,0,83
"293","already",77,0,0,5,82
"294","convention",69,8,5,0,82
"295","eyes",40,31,5,6,82
"296","heavy",36,29,13,4,82
"297","leaving",30,38,13,1,82
"298","thousand",43,28,2,9,82
"299","aunt",34,40,7,0,81
"300","knew",80,0,0,1,81
"301","national",60,19,1,1,81
"302","reached",53,18,7,3,81
"303","boy",34,37,7,2,80
"304","cold",37,30,11,2,80
"305","compelled",46,28,6,0,80
"306","glad",42,25,11,2,80
"307","point",80,0,0,0,80
"308","side",69,0,0,11,80
"309","st",0,59,21,0,80
"310","father",26,41,12,0,79
"311","michael’s",1,57,21,0,79
"312","paper",52,24,3,0,79
"313","succeeded",33,26,20,0,79
"314","write",32,31,15,1,79
"315","bill",35,36,7,0,78
"316","fear",41,31,5,1,78
"317","feelings",33,32,13,0,78
"318","general",74,0,0,4,78
"319","grandmother",26,44,8,0,78
"320","months",36,28,13,1,78
"321","often",77,0,0,1,78
"322","present",76,0,0,2,78
"323","result",37,31,10,0,78
"324","bring",40,29,7,1,77
"325","broken",38,31,5,3,77
"326","constitution",60,12,4,1,77
"327","deep",34,29,12,2,77
"328","freeland",29,33,15,0,77
"329","learning",36,27,14,0,77
"330","movement",37,39,0,1,77
"331","remember",33,31,13,0,77
"332","rochester",62,14,0,1,77
"333","several",68,0,0,9,77
"334","strange",38,25,5,9,77
"335","voice",45,25,6,1,77
"336","whipped",23,32,22,0,77
"337","citizens",63,12,0,1,76
"338","food",31,34,10,1,76
"339","lash",28,34,13,1,76
"340","women",23,25,17,11,76
"341","coming",35,29,8,3,75
"342","dark",31,32,10,2,75
"343","distance",31,30,12,2,75
"344","humanity",30,35,10,0,75
"345","measure",64,10,1,0,75
"346","strength",37,24,11,3,75
"347","almost",66,0,0,8,74
"348","call",35,30,7,2,74
"349","change",37,29,7,1,74
"350","cruelty",23,38,13,0,74
"351","duty",46,23,5,0,74
"352","idea",34,33,6,1,74
"353","kind",68,0,0,6,74
"354","known",72,0,0,2,74
"355","prejudice",42,27,5,0,74
"356","sentiment",54,17,3,0,74
"357","short",28,23,20,3,74
"358","whose",71,0,0,3,74
"359","bondage",35,32,5,1,73
"360","miss",36,20,0,17,73
"361","sunday",29,20,7,17,73
"362","supposed",33,30,7,3,73
"363","taken",67,0,0,6,73
"364","emancipation",51,14,7,0,72
"365","laws",38,30,2,2,72
"366","quite",67,0,0,5,72
"367","things",69,0,0,3,72
"368","always",70,0,0,1,71
"369","bound",39,23,6,3,71
"370","farm",27,27,16,1,71
"371","feet",26,25,9,11,71
"372","going",65,0,0,6,71
"373","learned",30,31,8,2,71
"374","put",71,0,0,0,71
"375","story",40,25,4,2,71
"376","book",25,29,13,3,70
"377","colonel",17,10,43,0,70
"378","committed",34,29,7,0,70
"379","door",29,26,15,0,70
"380","expected",34,25,9,2,70
"381","fugitive",33,27,10,0,70
"382","influence",41,22,7,0,70
"383","noble",38,19,12,1,70
"384","office",50,13,7,0,70
"385","opinion",33,31,6,0,70
"386","position",42,26,1,1,70
"387","sandy",25,35,9,1,70
"388","answer",28,24,11,6,69
"389","business",35,25,7,2,69
"390","captain",47,8,10,4,69
"391","giving",38,23,7,1,69
"392","running",33,29,6,1,69
"393","abolition",49,18,1,0,68
"394","abroad",40,24,2,2,68
"395","america",27,34,2,5,68
"396","became",66,0,0,2,68
"397","form",27,25,9,7,68
"398","making",65,0,0,3,68
"399","sort",30,30,8,0,68
"400","year",67,0,0,1,68
"401","attempt",36,24,7,0,67
"402","board",30,23,7,7,67
"403","capt",39,28,0,0,67
"404","garrison",40,25,2,0,67
"405","horses",26,28,12,1,67
"406","plan",42,18,7,0,67
"407","sight",28,25,7,7,67
"408","trouble",34,26,6,1,67
"409","age",25,24,14,3,66
"410","conduct",29,31,6,0,66
"411","greatly",36,26,4,0,66
"412","son",31,24,9,2,66
"413","taking",31,23,10,2,66
"414","thing",64,0,0,2,66
"415","become",64,0,0,1,65
"416","case",64,0,0,1,65
"417","direction",31,26,7,1,65
"418","grand",34,22,1,8,65
"419","marked",30,22,11,2,65
"420","pass",27,26,11,1,65
"421","rest",38,20,6,1,65
"422","act",36,21,7,0,64
"423","future",41,18,5,0,64
"424","street",31,21,8,4,64
"425","advantage",33,24,5,1,63
"426","ago",31,19,3,10,63
"427","course",63,0,0,0,63
"428","eye",21,26,13,3,63
"429","favor",33,21,7,2,63
"430","kitchen",27,32,4,0,63
"431","regarded",30,20,13,0,63
"432","soldiers",60,2,0,1,63
"433","wild",25,28,7,3,63
"434","written",32,23,5,3,63
"435","account",30,28,3,1,62
"436","asked",61,0,0,1,62
"437","attention",35,18,4,5,62
"438","forward",27,26,9,0,62
"439","rule",34,25,3,0,62
"440","standing",33,23,4,2,62
"441","wrong",28,29,5,0,62
"442","bay",18,25,14,4,61
"443","beautiful",30,17,5,9,61
"444","crime",30,23,7,1,61
"445","longer",59,0,0,2,61
"446","papers",39,21,1,0,61
"447","pleased",30,21,7,3,61
"448","treatment",30,25,6,0,61
"449","visit",42,13,3,3,61
"450","washington",54,4,3,0,61
"451","wished",37,15,9,0,61
"452","also",52,0,0,8,60
"453","bread",20,32,7,1,60
"454","edward",29,25,6,0,60
"455","force",41,14,5,0,60
"456","high",58,0,0,2,60
"457","interest",48,0,0,12,60
"458","look",54,0,0,6,60
"459","massachusetts",34,16,9,1,60
"460","privilege",24,26,9,1,60
"461","remained",26,25,9,0,60
"462","step",36,19,5,0,60
"463","wisdom",37,23,0,0,60
"464","bitter",29,26,4,0,59
"465","covey’s",21,30,8,0,59
"466","led",26,28,3,2,59
"467","lucretia",27,24,8,0,59
"468","road",26,20,4,9,59
"469","scene",31,24,0,4,59
"470","sea",21,11,1,26,59
"471","sought",38,16,5,0,59
"472","toward",57,0,0,2,59
"473","town",31,13,6,9,59
"474","yard",9,37,13,0,59
"475","abraham",55,0,0,3,58
"476","address",35,16,1,6,58
"477","bear",25,19,11,3,58
"478","find",53,0,0,5,58
"479","forever",25,23,10,0,58
"480","impossible",30,22,5,1,58
"481","keep",56,0,0,2,58
"482","northern",28,26,4,0,58
"483","opportunity",31,19,8,0,58
"484","speaking",33,19,5,1,58
"485","success",37,13,8,0,58
"486","appearance",25,22,7,3,57
"487","arms",38,15,3,1,57
"488","boston",33,21,3,0,57
"489","considered",27,20,10,0,57
"490","guilty",18,32,7,0,57
"491","honor",41,9,6,1,57
"492","ignorance",30,24,2,1,57
"493","open",56,0,0,1,57
"494","pride",31,20,1,5,57
"495","protection",39,13,5,0,57
"496","relation",24,29,4,0,57
"497","service",34,19,3,1,57
"498","sold",20,25,10,2,57
"499","terrible",32,18,7,0,57
"500","twenty",16,26,10,5,57
"501","christian",24,23,3,6,56
"502","especially",54,0,0,2,56
"503","fine",22,18,3,13,56
"504","letter",29,18,6,3,56
"505","lost",33,19,4,0,56
"506","paid",33,18,4,1,56
"507","possible",54,0,0,2,56
"508","powerful",30,16,6,4,56
"509","rebellion",52,4,0,0,56
"510","sir",25,28,3,0,56
"511","abolitionists",29,21,5,0,55
"512","bad",20,29,6,0,55
"513","covered",24,21,6,4,55
"514","desire",30,16,9,0,55
"515","fight",33,15,6,1,55
"516","finding",20,25,8,2,55
"517","neither",52,0,0,3,55
"518","rich",24,22,5,4,55
"519","stay",32,13,5,5,55
"520","tell",54,0,0,1,55
"521","able",51,0,0,3,54
"522","altogether",29,22,3,0,54
"523","bright",32,16,1,5,54
"524","deeply",21,24,5,4,54
"525","effort",30,17,6,1,54
"526","existence",19,27,7,1,54
"527","face",52,0,0,2,54
"528","gentleman",29,17,5,3,54
"529","johnson",29,14,11,0,54
"530","kindly",24,19,11,0,54
"531","piece",19,26,8,1,54
"532","political",38,12,4,0,54
"533","views",33,15,3,3,54
"534","water",16,26,6,6,54
"535","boys",16,27,8,2,53
"536","evidence",21,24,7,1,53
"537","fall",29,19,3,2,53
"538","horse",17,25,9,2,53
"539","reasons",28,21,3,1,53
"540","relations",32,21,0,0,53
"541","therefore",52,0,0,1,53
"542","ability",27,16,8,1,52
"543","beginning",30,15,5,2,52
"544","carried",27,16,9,0,52
"545","failed",26,19,7,0,52
"546","fell",23,17,11,1,52
"547","invited",41,8,2,1,52
"548","joy",24,20,8,0,52
"549","lay",24,15,13,0,52
"550","necessity",28,17,7,0,52
"551","peculiar",25,19,4,4,52
"552","personal",27,23,2,0,52
"553","progress",35,16,1,0,52
"554","rather",49,0,0,3,52
"555","subjected",20,22,10,0,52
"556","ten",22,24,5,1,52
"557","audience",31,14,3,3,51
"558","corn",20,21,9,1,51
"559","courage",37,11,3,0,51
"560","due",32,15,4,0,51
"561","duties",26,22,3,0,51
"562","education",30,20,1,0,51
"563","hamilton",17,20,14,0,51
"564","holidays",19,23,9,0,51
"565","hours",26,11,9,5,51
"566","iron",24,22,5,0,51
"567","kindness",22,25,4,0,51
"568","michaels",49,0,2,0,51
"569","neighborhood",23,25,3,0,51
"570","order",49,0,0,2,51
"571","reach",25,19,5,2,51
"572","required",30,15,6,0,51
"573","thinking",24,18,9,0,51
"574","trade",17,27,7,0,51
"575","wise",38,12,1,0,51
"576","believe",47,0,0,3,50
"577","born",20,21,6,3,50
"578","dead",23,19,5,3,50
"579","either",46,0,0,4,50
"580","gore",15,21,14,0,50
"581","mine",19,26,5,0,50
"582","named",21,20,9,0,50
"583","pleasure",19,20,8,3,50
"584","proper",21,25,4,0,50
"585","reaching",21,24,4,1,50
"586","republic",40,8,1,1,50
"587","spoke",29,11,8,2,50
"588","anything",48,0,0,1,49
"589","charles",35,7,5,2,49
"590","county",20,19,10,0,49
"591","got",47,0,0,2,49
"592","lady",28,14,1,6,49
"593","late",26,15,4,4,49
"594","lives",27,16,5,1,49
"595","meant",27,16,6,0,49
"596","memory",28,20,0,1,49
"597","mere",21,21,6,1,49
"598","names",18,19,12,0,49
"599","pay",24,14,11,0,49
"600","resolved",22,16,11,0,49
"601","shore",21,22,3,3,49
"602","simple",25,21,3,0,49
"603","sympathy",25,19,5,0,49
"604","understand",21,21,7,0,49
"605","whipping",12,17,20,0,49
"606","worse",23,17,9,0,49
"607","british",27,19,0,2,48
"608","broad",28,17,2,1,48
"609","chief",27,13,6,2,48
"610","conflict",36,12,0,0,48
"611","eat",10,18,20,0,48
"612","four",44,0,0,4,48
"613","intended",24,16,8,0,48
"614","kept",45,0,0,3,48
"615","lot",18,23,7,0,48
"616","month",22,19,7,0,48
"617","policy",38,10,0,0,48
"618","prayer",14,23,10,1,48
"619","principles",22,24,2,0,48
"620","send",21,23,4,0,48
"621","simply",27,19,1,1,48
"622","small",41,0,0,7,48
"623","social",27,21,0,0,48
"624","talk",27,14,7,0,48
"625","treated",22,17,6,3,48
"626","usual",26,16,5,1,48
"627","wealth",26,13,7,2,48
"628","adopted",22,17,7,1,47
"629","behind",46,0,0,1,47
"630","cabin",23,24,0,0,47
"631","chains",10,24,11,2,47
"632","eastern",22,23,0,2,47
"633","easy",22,23,2,0,47
"634","evil",20,20,7,0,47
"635","flesh",13,27,6,1,47
"636","happened",23,19,4,1,47
"637","katy",20,27,0,0,47
"638","loyal",46,0,1,0,47
"639","mental",22,21,4,0,47
"640","painful",15,19,12,1,47
"641","past",25,18,0,4,47
"642","prison",20,19,8,0,47
"643","refused",28,13,6,0,47
"644","rise",24,16,4,3,47
"645","scarcely",20,19,7,1,47
"646","shoulders",17,23,7,0,47
"647","sometimes",46,0,0,1,47
"648","stop",25,13,8,1,47
"649","telling",22,16,8,1,47
"650","west",31,9,3,4,47
"651","wood",17,20,9,1,47
"652","consideration",31,13,1,1,46
"653","died",18,14,12,2,46
"654","employment",15,14,17,0,46
"655","favorable",22,20,1,3,46
"656","forty",24,13,1,8,46
"657","gone",44,0,0,2,46
"658","happiness",17,19,10,0,46
"659","hired",22,16,8,0,46
"660","leading",22,21,3,0,46
"661","letters",21,14,5,6,46
"662","millions",25,15,4,2,46
"663","minds",18,20,8,0,46
"664","outrage",15,26,5,0,46
"665","quarter",25,18,2,1,46
"666","reply",28,13,5,0,46
"667","secure",25,17,2,2,46
"668","suffered",19,19,8,0,46
"669","thirty",22,21,3,0,46
"670","tree",20,16,5,5,46
"671","within",46,0,0,0,46
"672","anthony",28,13,4,0,45
"673","building",23,16,1,5,45
"674","difficulty",19,19,7,0,45
"675","disposed",19,15,10,1,45
"676","evening",22,10,3,10,45
"677","evidently",21,20,1,3,45
"678","excellent",17,21,2,5,45
"679","finally",20,12,13,0,45
"680","fire",20,17,7,1,45
"681","forget",24,15,6,0,45
"682","hall",36,6,1,2,45
"683","hunger",14,23,8,0,45
"684","keeping",20,20,5,0,45
"685","laid",20,19,6,0,45
"686","prevent",23,18,4,0,45
"687","sent",43,0,0,2,45
"688","struck",21,18,5,1,45
"689","whether",44,0,0,1,45
"690","acquainted",17,19,8,0,44
"691","air",29,13,1,1,44
"692","believed",29,9,4,2,44
"693","determined",26,12,6,0,44
"694","elsewhere",44,0,0,0,44
"695","entire",19,23,2,0,44
"696","escaped",16,13,15,0,44
"697","farms",12,15,17,0,44
"698","heaven",16,22,5,1,44
"699","help",43,0,0,1,44
"700","holding",24,15,4,1,44
"701","honest",24,19,1,0,44
"702","hungry",17,20,7,0,44
"703","immediately",15,10,19,0,44
"704","journey",20,19,3,2,44
"705","labors",28,12,3,1,44
"706","lecture",29,15,0,0,44
"707","near",41,0,0,3,44
"708","overseers",20,15,9,0,44
"709","proved",21,15,8,0,44
"710","raised",25,15,4,0,44
"711","river",22,17,2,3,44
"712","seat",22,19,3,0,44
"713","second",42,0,0,2,44
"714","shocking",19,22,3,0,44
"715","taught",28,14,2,0,44
"716","toil",21,17,5,1,44
"717","use",42,0,0,2,44
"718","virginia",35,8,1,0,44
"719","wages",18,18,8,0,44
"720","around",40,0,0,3,43
"721","bloody",15,13,15,0,43
"722","brave",36,6,1,0,43
"723","connected",21,17,3,2,43
"724","continued",24,13,5,1,43
"725","district",31,9,3,0,43
"726","efforts",30,9,4,0,43
"727","faith",27,12,3,1,43
"728","ferry",41,1,1,0,43
"729","george",31,10,1,1,43
"730","line",26,13,3,1,43
"731","loved",21,14,8,0,43
"732","nearly",40,0,0,3,43
"733","need",42,0,0,1,43
"734","oxen",17,16,9,1,43
"735","passengers",15,14,0,14,43
"736","perhaps",41,0,0,2,43
"737","powers",21,18,4,0,43
"738","remain",18,17,6,2,43
"739","save",30,8,5,0,43
"740","served",19,17,7,0,43
"741","towards",42,0,0,1,43
"742","walk",19,18,4,2,43
"743","blows",22,18,2,0,42
"744","civilization",30,11,0,1,42
"745","complete",24,15,2,1,42
"746","confidence",24,13,5,0,42
"747","corner",21,17,3,1,42
"748","daughter",21,14,6,1,42
"749","description",20,13,6,3,42
"750","disposition",19,16,7,0,42
"751","early",41,0,0,1,42
"752","equally",28,11,3,0,42
"753","gained",24,11,6,1,42
"754","generally",42,0,0,0,42
"755","happy",18,19,4,1,42
"756","husband",16,20,6,0,42
"757","literally",18,20,4,0,42
"758","man’s",27,12,3,0,42
"759","move",14,13,15,0,42
"760","physical",19,19,1,3,42
"761","possessed",23,15,4,0,42
"762","resistance",22,16,3,1,42
"763","rev",18,14,4,6,42
"764","situation",27,5,10,0,42
"765","spoken",25,11,4,2,42
"766","close",23,13,3,2,41
"767","command",25,12,3,1,41
"768","degree",24,11,6,0,41
"769","distinguished",27,12,2,0,41
"770","don’t",17,19,5,0,41
"771","earnest",31,9,1,0,41
"772","enjoyed",14,18,8,1,41
"773","freeman",16,21,4,0,41
"774","indeed",41,0,0,0,41
"775","latter",35,0,0,6,41
"776","special",23,12,4,2,41
"777","statement",18,17,6,0,41
"778","watched",19,17,5,0,41
"779","brutal",16,24,0,0,40
"780","dread",20,17,3,0,40
"781","events",30,8,1,1,40
"782","gate",15,15,9,1,40
"783","gentlemen",30,7,2,1,40
"784","hopes",19,19,2,0,40
"785","ignorant",17,17,6,0,40
"786","james",30,9,1,0,40
"787","necessary",40,0,0,0,40
"788","rate",21,14,5,0,40
"789","sabbath",6,23,11,0,40
"790","safe",18,16,6,0,40
"791","smith",27,11,2,0,40
"792","started",17,13,9,1,40
"793","table",24,12,3,1,40
"794","tied",14,13,13,0,40
"795","warm",15,17,7,1,40
"796","writing",17,14,6,3,40
"797","brothers",16,20,1,2,39
"798","caused",22,12,3,2,39
"799","childhood",16,20,3,0,39
"800","cut",14,19,6,0,39
"801","darkness",11,21,5,2,39
"802","democratic",27,12,0,0,39
"803","exercise",15,20,4,0,39
"804","fair",21,12,4,2,39
"805","hearing",18,12,9,0,39
"806","impression",19,12,3,5,39
"807","let",39,0,0,0,39
"808","meal",14,20,4,1,39
"809","meetings",21,16,2,0,39
"810","naturally",28,10,1,0,39
"811","needed",38,0,0,1,39
"812","passing",21,14,1,3,39
"813","prepared",23,10,5,1,39
"814","sad",15,20,2,2,39
"815","saturday",11,11,9,8,39
"816","show",32,0,0,7,39
"817","shown",21,9,4,5,39
"818","sure",38,0,0,1,39
"819","train",26,7,1,5,39
"820","violence",28,11,0,0,39
"821","winter",16,19,3,1,39
"822","worth",20,15,2,2,39
"823","allowance",10,19,9,0,38
"824","armed",22,13,3,0,38
"825","arrest",23,13,2,0,38
"826","attended",16,11,5,6,38
"827","began",34,0,0,4,38
"828","chance",18,14,5,1,38
"829","community",15,18,5,0,38
"830","completely",22,14,1,1,38
"831","danger",20,14,4,0,38
"832","daniel",23,11,4,0,38
"833","engaged",11,16,11,0,38
"834","entered",16,17,5,0,38
"835","entirely",35,0,0,3,38
"836","houses",15,14,5,4,38
"837","language",19,15,4,0,38
"838","manhood",18,16,3,1,38
"839","mercy",15,20,3,0,38
"840","observed",22,14,2,0,38
"841","owned",19,12,6,1,38
"842","popular",29,7,1,1,38
"843","practice",17,17,4,0,38
"844","reading",16,15,5,2,38
"845","real",22,12,3,1,38
"846","returned",19,12,6,1,38
"847","severe",10,14,14,0,38
"848","sleep",13,20,5,0,38
"849","songs",11,17,10,0,38
"850","summer",17,17,3,1,38
"851","attempted",24,11,2,0,37
"852","breaking",15,18,4,0,37
"853","cart",14,15,8,0,37
"854","decided",18,11,7,1,37
"855","delivered",23,11,3,0,37
"856","determination",14,10,13,0,37
"857","earth",16,17,1,3,37
"858","getting",37,0,0,0,37
"859","harper’s",37,0,0,0,37
"860","hon",35,2,0,0,37
"861","instance",16,17,4,0,37
"862","killed",16,10,11,0,37
"863","least",35,0,0,2,37
"864","length",16,12,7,2,37
"865","moved",19,11,4,3,37
"866","opposite",19,13,3,2,37
"867","pretty",15,17,3,2,37
"868","prove",19,16,2,0,37
"869","rough",19,14,1,3,37
"870","solemn",17,11,3,6,37
"871","speeches",24,12,1,0,37
"872","suppose",14,12,7,4,37
"873","teach",16,14,7,0,37
"874","victim",13,19,5,0,37
"875","allow",36,0,0,0,36
"876","argument",23,10,3,0,36
"877","circumstance",14,18,4,0,36
"878","coarse",12,16,8,0,36
"879","deemed",13,16,7,0,36
"880","else",32,0,0,4,36
"881","excited",17,17,2,0,36
"882","expression",22,11,3,0,36
"883","frequently",6,11,18,1,36
"884","holy",13,20,3,0,36
"885","important",36,0,0,0,36
"886","increase",19,14,2,1,36
"887","philadelphia",29,6,1,0,36
"888","pious",12,14,9,1,36
"889","platform",26,9,1,0,36
"890","play",17,19,0,0,36
"891","promise",24,9,1,2,36
"892","proof",18,13,2,3,36
"893","punishment",14,15,7,0,36
"894","receive",25,8,3,0,36
"895","republican",28,8,0,0,36
"896","separation",16,12,8,0,36
"897","soil",26,6,3,1,36
"898","sound",12,17,4,3,36
"899","successful",15,15,5,1,36
"900","support",21,12,3,0,36
"901","used",33,0,0,3,36
"902","walked",17,11,4,4,36
"903","advice",16,15,4,0,35
"904","andrew",19,10,6,0,35
"905","appeared",21,8,6,0,35
"906","battle",22,10,2,1,35
"907","changed",23,7,4,1,35
"908","denied",18,15,1,1,35
"909","difference",17,16,2,0,35
"910","enterprise",20,14,1,0,35
"911","expressed",25,7,3,0,35
"912","fields",15,12,2,6,35
"913","filled",18,11,6,0,35
"914","hotel",12,5,0,18,35
"915","increased",16,16,2,1,35
"916","jail",15,11,9,0,35
"917","looking",26,0,0,9,35
"918","makes",16,12,4,3,35
"919","moments",16,11,8,0,35
"920","number",33,0,0,2,35
"921","opposition",21,12,2,0,35
"922","perfect",14,10,4,7,35
"923","promptly",20,14,0,1,35
"924","root",15,16,3,1,35
"925","satisfaction",22,9,4,0,35
"926","seem",28,0,0,7,35
"927","sell",13,16,6,0,35
"928","sisters",11,21,2,1,35
"929","skill",20,13,0,2,35
"930","sky",21,9,1,4,35
"931","strike",17,13,5,0,35
"932","sufficient",16,15,4,0,35
"933","superior",17,16,2,0,35
"934","thousands",24,6,4,1,35
"935","tuckahoe",12,22,1,0,35
"936","alike",14,17,2,1,34
"937","alone",33,0,0,1,34
"938","attend",22,9,3,0,34
"939","besides",34,0,0,0,34
"940","cast",15,16,2,1,34
"941","dangerous",18,13,2,1,34
"942","die",15,12,6,1,34
"943","different",34,0,0,0,34
"944","divided",20,10,4,0,34
"945","easton",14,11,9,0,34
"946","eloquence",18,13,3,0,34
"947","fallen",18,11,1,4,34
"948","floor",15,11,5,3,34
"949","front",15,12,3,4,34
"950","generous",21,13,0,0,34
"951","grant",27,6,0,1,34
"952","hate",13,16,3,2,34
"953","hated",19,12,2,1,34
"954","injustice",20,11,3,0,34
"955","murder",17,15,2,0,34
"956","occupied",20,13,0,1,34
"957","offense",16,17,0,1,34
"958","pen",18,14,2,0,34
"959","population",16,11,7,0,34
"960","removed",20,13,1,0,34
"961","singing",11,16,5,2,34
"962","six",30,0,0,4,34
"963","slave’s",15,17,2,0,34
"964","souls",12,14,8,0,34
"965","tender",17,11,6,0,34
"966","thoughts",34,0,0,0,34
"967","tone",15,12,7,0,34
"968","understood",10,15,9,0,34
"969","affection",10,17,6,0,33
"970","authority",17,13,3,0,33
"971","belonged",18,11,4,0,33
"972","break",15,14,4,0,33
"973","clothing",10,13,7,3,33
"974","consequence",12,13,8,0,33
"975","devoted",18,11,4,0,33
"976","difficult",19,10,1,3,33
"977","dust",17,12,1,3,33
"978","flung",16,17,0,0,33
"979","former",32,0,0,1,33
"980","glorious",17,14,2,0,33
"981","harris",16,13,4,0,33
"982","hearts",20,8,5,0,33
"983","kill",10,15,8,0,33
"984","knowing",16,13,4,0,33
"985","outside",31,0,0,2,33
"986","placed",33,0,0,0,33
"987","plain",19,8,3,3,33
"988","pleasant",12,11,0,10,33
"989","protect",17,11,5,0,33
"990","remarkable",18,6,3,6,33
"991","room",26,0,0,7,33
"992","space",21,10,2,0,33
"993","suffering",15,13,5,0,33
"994","surrounded",15,12,4,2,33
"995","together",33,0,0,0,33
"996","wretched",8,17,8,0,33
"997","addressed",17,10,3,2,32
"998","apparently",18,11,1,2,32
"999","birth",11,14,6,1,32
"1000","certain",32,0,0,0,32
"1001","certainly",28,0,0,4,32
"1002","doctor",19,13,0,0,32
"1003","dozen",15,14,3,0,32
"1004","earnings",17,14,1,0,32
"1005","failure",17,10,5,0,32
"1006","forgotten",9,15,3,5,32
"1007","fully",31,0,0,1,32
"1008","girl",12,15,5,0,32
"1009","governor",27,5,0,0,32
"1010","hardships",19,9,4,0,32
"1011","highly",15,10,6,1,32
"1012","march",16,4,3,9,32
"1013","measures",20,10,2,0,32
"1014","ministers",18,11,3,0,32
"1015","oppressed",14,12,6,0,32
"1016","pray",15,14,2,1,32
"1017","properly",22,6,4,0,32
"1018","qualities",23,7,2,0,32
"1019","questions",16,15,1,0,32
"1020","railroad",18,12,2,0,32
"1021","reputation",10,12,10,0,32
"1022","safety",14,10,6,2,32
"1023","satisfied",15,8,8,1,32
"1024","senate",27,4,0,1,32
"1025","spend",14,10,6,2,32
"1026","start",13,13,6,0,32
"1027","stern",16,14,2,0,32
"1028","testimony",14,11,6,1,32
"1029","uncle",14,17,1,0,32
"1030","want",31,0,0,1,32
"1031","whatever",30,0,0,2,32
"1032","arrival",11,10,8,2,31
"1033","awakened",14,15,2,0,31
"1034","brute",10,15,6,0,31
"1035","carry",15,11,5,0,31
"1036","conscience",12,15,4,0,31
"1037","ease",11,10,9,1,31
"1038","expect",16,15,0,0,31
"1039","fate",10,13,8,0,31
"1040","five",24,0,0,7,31
"1041","huge",13,18,0,0,31
"1042","humane",16,11,4,0,31
"1043","induced",18,12,1,0,31
"1044","institution",19,10,2,0,31
"1045","interesting",22,0,0,9,31
"1046","judgment",16,11,4,0,31
"1047","kansas",31,0,0,0,31
"1048","loss",12,13,5,1,31
"1049","mention",20,8,3,0,31
"1050","numerous",17,12,1,1,31
"1051","objects",14,15,0,2,31
"1052","parties",14,14,3,0,31
"1053","plans",14,13,4,0,31
"1054","principle",16,14,1,0,31
"1055","rendered",14,14,1,2,31
"1056","seeing",26,0,0,5,31
"1057","share",18,10,2,1,31
"1058","territory",30,1,0,0,31
"1059","today",30,0,0,1,31
"1060","treat",11,15,5,0,31
"1061","troops",29,1,0,1,31
"1062","visited",13,7,2,9,31
"1063","wish",29,0,0,2,31
"1064","added",15,10,5,0,30
"1065","affected",17,11,2,0,30
"1066","afforded",13,12,5,0,30
"1067","aid",14,10,6,0,30
"1068","books",10,12,2,6,30
"1069","calling",14,10,5,1,30
"1070","clothes",12,10,5,3,30
"1071","conditions",25,4,0,1,30
"1072","connection",23,3,4,0,30
"1073","conviction",13,12,3,2,30
"1074","credit",21,6,2,1,30
"1075","departure",15,8,7,0,30
"1076","enemies",19,9,2,0,30
"1077","extent",14,15,1,0,30
"1078","firmly",17,12,1,0,30
"1079","follow",14,11,5,0,30
"1080","formed",15,14,0,1,30
"1081","greater",30,0,0,0,30
"1082","green",19,9,0,2,30
"1083","happily",21,9,0,0,30
"1084","ideas",16,13,0,1,30
"1085","incident",16,14,0,0,30
"1086","intelligence",17,12,1,0,30
"1087","merely",29,0,0,1,30
"1088","methodist",10,15,4,1,30
"1089","mighty",15,11,4,0,30
"1090","none",30,0,0,0,30
"1091","pain",13,11,5,1,30
"1092","published",17,11,2,0,30
"1093","removal",17,13,0,0,30
"1094","sic",0,30,0,0,30
"1095","similar",15,8,7,0,30
"1096","sloop",9,13,8,0,30
"1097","sorrow",12,14,4,0,30
"1098","talbot",12,10,8,0,30
"1099","trees",15,11,3,1,30
"1100","value",30,0,0,0,30
"1101","wicked",6,21,3,0,30
"1102","apprehension",15,11,3,0,29
"1103","bare",7,20,0,2,29
"1104","brethren",9,12,7,1,29
"1105","carpenters",9,11,9,0,29
"1106","chain",11,18,0,0,29
"1107","congress",20,7,2,0,29
"1108","consequences",11,12,6,0,29
"1109","constantly",13,14,1,1,29
"1110","drawn",15,9,4,1,29
"1111","driven",12,16,1,0,29
"1112","emancipated",25,3,1,0,29
"1113","event",19,7,3,0,29
"1114","everything",25,0,0,4,29
"1115","followed",28,0,0,1,29
"1116","gain",17,10,1,1,29
"1117","gospel",10,18,1,0,29
"1118","hair",13,12,3,1,29
"1119","honorable",17,11,1,0,29
"1120","horrible",7,13,8,1,29
"1121","immense",17,8,2,2,29
"1122","industry",18,9,2,0,29
"1123","lord",15,10,4,0,29
"1124","members",29,0,0,0,29
"1125","minister",15,9,3,2,29
"1126","monday",7,8,4,10,29
"1127","obtained",17,10,1,1,29
"1128","occurred",15,12,2,0,29
"1129","offered",20,9,0,0,29
"1130","permitted",17,8,2,2,29
"1131","phillips",21,5,3,0,29
"1132","previous",12,13,3,1,29
"1133","probably",26,0,0,3,29
"1134","really",29,0,0,0,29
"1135","remove",11,15,3,0,29
"1136","results",12,10,6,1,29
"1137","savage",7,13,9,0,29
"1138","search",12,13,2,2,29
"1139","skin",11,16,2,0,29
"1140","streets",15,6,2,6,29
"1141","struggle",19,8,1,1,29
"1142","sun",12,14,3,0,29
"1143","surprise",14,9,4,2,29
"1144","suspected",13,13,3,0,29
"1145","voyage",11,8,0,10,29
"1146","wrath",18,10,1,0,29
"1147","art",9,11,1,7,28
"1148","attached",11,15,2,0,28
"1149","belonging",9,11,8,0,28
"1150","bible",12,12,2,2,28
"1151","bringing",13,14,1,0,28
"1152","charge",13,11,4,0,28
"1153","ears",10,14,2,2,28
"1154","experienced",8,10,10,0,28
"1155","fifty",17,6,3,2,28
"1156","flogging",9,18,1,0,28
"1157","fortune",17,9,1,1,28
"1158","heat",14,12,1,1,28
"1159","hence",27,0,0,1,28
"1160","homes",15,10,3,0,28
"1161","increasing",19,8,1,0,28
"1162","information",16,9,3,0,28
"1163","lead",16,7,4,1,28
"1164","likely",27,0,0,1,28
"1165","matters",13,12,3,0,28
"1166","motive",18,9,1,0,28
"1167","naked",10,7,11,0,28
"1168","occasionally",10,15,2,1,28
"1169","places",26,0,0,2,28
"1170","press",14,14,0,0,28
"1171","seek",13,10,5,0,28
"1172","seized",10,9,9,0,28
"1173","separated",9,16,3,0,28
"1174","serve",13,9,4,2,28
"1175","somewhat",25,0,0,3,28
"1176","store",17,8,3,0,28
"1177","sum",15,11,2,0,28
"1178","tommy",10,18,0,0,28
"1179","transaction",10,13,5,0,28
"1180","twelve",12,10,5,1,28
"1181","wanted",27,0,0,1,28
"1182","worst",10,13,4,1,28
"1183","action",17,8,1,1,27
"1184","admitted",14,12,1,0,27
"1185","anxiety",11,11,4,1,27
"1186","anxious",14,7,6,0,27
"1187","army",26,1,0,0,27
"1188","assured",17,8,2,0,27
"1189","bank",26,1,0,0,27
"1190","bed",7,15,4,1,27
"1191","burden",15,9,1,2,27
"1192","canada",23,2,2,0,27
"1193","carrying",10,9,7,1,27
"1194","conversation",20,4,2,1,27
"1195","defense",15,12,0,0,27
"1196","dreaded",11,10,5,1,27
"1197","eloquent",16,7,3,1,27
"1198","english",11,10,1,5,27
"1199","equality",17,9,0,1,27
"1200","established",14,10,2,1,27
"1201","except",25,0,0,2,27
"1202","excitement",10,12,5,0,27
"1203","features",14,9,1,3,27
"1204","friendly",20,3,3,1,27
"1205","grateful",19,6,1,1,27
"1206","grave",9,11,3,4,27
"1207","horrid",3,11,13,0,27
"1208","illustration",23,4,0,0,27
"1209","importance",10,9,8,0,27
"1210","listen",18,7,2,0,27
"1211","low",18,7,1,1,27
"1212","manly",16,11,0,0,27
"1213","mark",12,14,0,1,27
"1214","married",9,10,7,1,27
"1215","midst",12,5,10,0,27
"1216","mother’s",9,16,2,0,27
"1217","nigger",10,9,8,0,27
"1218","occasions",18,6,1,2,27
"1219","opinions",15,12,0,0,27
"1220","oppression",15,12,0,0,27
"1221","pair",9,11,7,0,27
"1222","partly",14,11,2,0,27
"1223","remains",8,8,5,6,27
"1224","repeated",14,12,1,0,27
"1225","saying",27,0,0,0,27
"1226","scotland",13,14,0,0,27
"1227","shame",11,14,2,0,27
"1228","shape",12,11,2,2,27
"1229","silence",14,12,1,0,27
"1230","slightest",7,11,9,0,27
"1231","stable",9,13,5,0,27
"1232","stock",12,14,1,0,27
"1233","stone",11,9,6,1,27
"1234","sumner",26,1,0,0,27
"1235","suspicion",13,13,1,0,27
"1236","terms",17,6,4,0,27
"1237","unable",13,9,4,1,27
"1238","valuable",17,8,2,0,27
"1239","vast",14,6,0,7,27
"1240","weak",18,9,0,0,27
"1241","weeks",16,7,4,0,27
"1242","welcome",27,0,0,0,27
"1243","alive",15,9,1,1,26
"1244","although",26,0,0,0,26
"1245","appointed",19,5,2,0,26
"1246","assistance",11,12,3,0,26
"1247","comfortable",15,7,2,2,26
"1248","contrast",17,8,0,1,26
"1249","court",16,6,3,1,26
"1250","cowardly",12,12,2,0,26
"1251","degradation",16,10,0,0,26
"1252","denounced",14,11,1,0,26
"1253","doctrine",18,8,0,0,26
"1254","drink",8,9,8,1,26
"1255","editor",18,8,0,0,26
"1256","enslaved",12,12,2,0,26
"1257","evils",13,11,2,0,26
"1258","exception",13,11,1,1,26
"1259","explanation",9,14,3,0,26
"1260","extraordinary",6,14,6,0,26
"1261","fathers",11,11,4,0,26
"1262","fish",12,9,3,2,26
"1263","fortunate",12,4,10,0,26
"1264","fred",4,12,10,0,26
"1265","hardly",24,0,0,2,26
"1266","helpless",10,10,6,0,26
"1267","institutions",14,12,0,0,26
"1268","intelligent",16,8,2,0,26
"1269","intense",11,14,1,0,26
"1270","london",10,10,0,6,26
"1271","mass",11,9,2,4,26
"1272","newspaper",14,10,2,0,26
"1273","next",26,0,0,0,26
"1274","ran",10,8,8,0,26
"1275","reception",19,6,0,1,26
"1276","regret",15,8,3,0,26
"1277","remembered",14,8,2,2,26
"1278","seated",17,7,1,1,26
"1279","secretary",23,2,1,0,26
"1280","servants",9,12,4,1,26
"1281","striking",13,7,2,4,26
"1282","sweet",10,15,1,0,26
"1283","thoughtful",17,7,0,2,26
"1284","turn",25,0,0,1,26
"1285","weather",13,8,0,5,26
"1286","whites",11,14,1,0,26
"1287","wishes",12,12,2,0,26
"1288","wrote",13,4,4,5,26
"1289","youth",16,7,2,1,26
"1290","accustomed",9,11,5,0,25
"1291","advance",19,5,1,0,25
"1292","afford",8,13,3,1,25
"1293","americans",11,11,0,3,25
"1294","ask",25,0,0,0,25
"1295","behalf",12,9,4,0,25
"1296","belong",14,9,2,0,25
"1297","careful",10,12,3,0,25
"1298","caught",10,11,4,0,25
"1299","churches",11,8,4,2,25
"1300","circle",11,10,2,2,25
"1301","claims",11,13,1,0,25
"1302","commanded",12,8,5,0,25
"1303","confess",14,11,0,0,25
"1304","constant",7,10,7,1,25
"1305","cowskin",2,13,10,0,25
"1306","describe",11,9,4,1,25
"1307","dollar",15,7,3,0,25
"1308","election",20,3,2,0,25
"1309","esther",10,15,0,0,25
"1310","fan",10,9,6,0,25
"1311","feature",10,10,1,4,25
"1312","following",24,0,0,1,25
"1313","fresh",9,12,3,1,25
"1314","gratitude",17,6,2,0,25
"1315","hopkins",5,11,9,0,25
"1316","ill",8,16,1,0,25
"1317","incidents",17,7,1,0,25
"1318","instantly",16,8,0,1,25
"1319","ireland",15,8,2,0,25
"1320","lips",14,10,1,0,25
"1321","marshal",25,0,0,0,25
"1322","meaning",13,8,4,0,25
"1323","meanness",11,10,4,0,25
"1324","mistake",16,5,3,1,25
"1325","mob",17,8,0,0,25
"1326","native",15,9,1,0,25
"1327","niggers",9,13,3,0,25
"1328","notwithstanding",15,6,2,2,25
"1329","owner",12,12,1,0,25
"1330","possession",14,7,3,1,25
"1331","presented",23,0,0,2,25
"1332","proceeded",12,7,4,2,25
"1333","readily",17,7,1,0,25
"1334","reward",9,10,5,1,25
"1335","rome",5,1,0,19,25
"1336","rose",11,9,5,0,25
"1337","scenes",10,12,3,0,25
"1338","sheep",8,12,4,1,25
"1339","sons",11,9,4,1,25
"1340","spring",10,10,5,0,25
"1341","straight",11,12,2,0,25
"1342","stranger",11,10,4,0,25
"1343","strangers",10,11,4,0,25
"1344","teaching",7,13,4,1,25
"1345","threat",14,11,0,0,25
"1346","trial",12,11,2,0,25
"1347","trust",15,9,1,0,25
"1348","witness",7,11,6,1,25
"1349","abolished",18,4,2,0,24
"1350","advocate",11,10,3,0,24
"1351","africa",7,14,3,0,24
"1352","arguments",16,7,1,0,24
"1353","car",18,6,0,0,24
"1354","charged",15,9,0,0,24
"1355","civil",17,6,1,0,24
"1356","considerable",11,4,9,0,24
"1357","consisted",7,9,6,2,24
"1358","contempt",12,10,2,0,24
"1359","cousin",10,12,2,0,24
"1360","crimes",4,16,4,0,24
"1361","cry",10,14,0,0,24
"1362","deal",11,9,3,1,24
"1363","delightful",7,7,1,9,24
"1364","described",24,0,0,0,24
"1365","distant",12,10,0,2,24
"1366","eight",22,0,0,2,24
"1367","encouraged",14,5,4,1,24
"1368","enslavement",8,12,4,0,24
"1369","facts",24,0,0,0,24
"1370","fast",9,7,5,3,24
"1371","flight",11,10,3,0,24
"1372","heads",10,7,4,3,24
"1373","indignation",13,9,2,0,24
"1374","lines",17,4,2,1,24
"1375","loud",11,7,4,2,24
"1376","market",9,13,1,1,24
"1377","mountains",17,1,0,6,24
"1378","opposed",16,8,0,0,24
"1379","otherwise",23,0,0,1,24
"1380","pieces",10,9,5,0,24
"1381","profession",7,14,3,0,24
"1382","proposed",18,3,3,0,24
"1383","purposes",14,9,1,0,24
"1384","rank",12,10,2,0,24
"1385","remarkably",13,10,0,1,24
"1386","respects",15,6,2,1,24
"1387","returning",11,9,3,1,24
"1388","ride",7,4,0,13,24
"1389","rope",9,10,5,0,24
"1390","safely",17,4,2,1,24
"1391","samuel",18,4,2,0,24
"1392","seven",21,0,0,3,24
"1393","shoot",9,10,5,0,24
"1394","steamer",13,4,0,7,24
"1395","tears",9,10,5,0,24
"1396","torn",12,10,1,1,24
"1397","troubled",11,12,1,0,24
"1398","utterly",15,7,2,0,24
"1399","volume",12,11,0,1,24
"1400","watch",10,13,1,0,24
"1401","waters",7,10,3,4,24
"1402","wherever",23,0,0,1,24
"1403","worship",8,8,0,8,24
"1404","wrongs",11,12,1,0,24
"1405","agent",12,8,3,0,23
"1406","apparent",14,9,0,0,23
"1407","approach",9,8,5,1,23
"1408","arm",16,4,2,1,23
"1409","aware",9,12,2,0,23
"1410","barney",8,10,5,0,23
"1411","bearing",10,10,1,2,23
"1412","beauty",11,9,1,2,23
"1413","belief",14,6,3,0,23
"1414","beyond",21,0,0,2,23
"1415","bought",8,12,2,1,23
"1416","buy",7,10,4,2,23
"1417","camp",4,14,5,0,23
"1418","capital",18,4,1,0,23
"1419","chesapeake",8,10,5,0,23
"1420","columbia",19,2,2,0,23
"1421","confusion",12,7,3,1,23
"1422","contest",16,7,0,0,23
"1423","cost",11,9,3,0,23
"1424","crowd",16,4,0,3,23
"1425","custom",13,8,2,0,23
"1426","daily",10,12,1,0,23
"1427","depths",10,9,1,3,23
"1428","devil",8,8,7,0,23
"1429","educated",15,7,1,0,23
"1430","effective",18,4,1,0,23
"1431","enemy",13,8,2,0,23
"1432","enter",13,8,1,1,23
"1433","express",12,7,4,0,23
"1434","fought",17,6,0,0,23
"1435","glance",9,14,0,0,23
"1436","grown",11,10,0,2,23
"1437","invitation",20,2,0,1,23
"1438","neck",8,12,3,0,23
"1439","negroes",12,7,2,2,23
"1440","nights",13,5,4,1,23
"1441","note",17,2,1,3,23
"1442","notice",15,6,2,0,23
"1443","ox",0,20,3,0,23
"1444","passage",13,5,5,0,23
"1445","picture",8,9,3,3,23
"1446","proclamation",23,0,0,0,23
"1447","provided",12,8,3,0,23
"1448","pursuit",13,6,4,0,23
"1449","sacred",10,8,3,2,23
"1450","seeking",10,10,3,0,23
"1451","senator",18,2,0,3,23
"1452","sharp",12,9,1,1,23
"1453","sing",5,10,8,0,23
"1454","star",12,8,3,0,23
"1455","stopping",11,7,0,5,23
"1456","study",12,9,0,2,23
"1457","suffer",7,9,7,0,23
"1458","suffrage",22,1,0,0,23
"1459","thompson",14,9,0,0,23
"1460","troubles",11,12,0,0,23
"1461","vessels",10,8,3,2,23
"1462","victims",9,11,3,0,23
"1463","vote",19,3,0,1,23
"1464","wait",13,5,4,1,23
"1465","welfare",14,8,1,0,23
"1466","wharves",10,10,3,0,23
"1467","wholly",13,9,1,0,23
"1468","wilson",20,2,1,0,23
"1469","wind",8,8,1,6,23
"1470","witnessed",12,7,3,1,23
"1471","absent",9,10,3,0,22
"1472","abuse",10,11,1,0,22
"1473","addition",10,10,2,0,22
"1474","admit",13,9,0,0,22
"1475","along",13,0,0,9,22
"1476","arrived",7,5,2,8,22
"1477","auld’s",16,6,0,0,22
"1478","bailey",11,3,8,0,22
"1479","beneath",11,10,1,0,22
"1480","bleeding",9,12,1,0,22
"1481","bore",16,5,0,1,22
"1482","borne",12,8,2,0,22
"1483","breakfast",8,8,4,2,22
"1484","capable",15,6,1,0,22
"1485","chase",16,5,1,0,22
"1486","commenced",5,4,13,0,22
"1487","countenance",10,12,0,0,22
"1488","cross",6,7,6,3,22
"1489","deeper",15,7,0,0,22
"1490","desired",10,6,5,1,22
"1491","despised",15,7,0,0,22
"1492","dignity",13,8,1,0,22
"1493","directions",12,10,0,0,22
"1494","drive",12,6,3,1,22
"1495","driver",7,10,5,0,22
"1496","employed",12,8,2,0,22
"1497","establishment",13,7,2,0,22
"1498","eternal",7,12,2,1,22
"1499","faithful",12,7,2,1,22
"1500","falling",13,6,3,0,22
"1501","famous",10,4,0,8,22
"1502","gaining",9,10,3,0,22
"1503","growing",17,4,1,0,22
"1504","hughes",8,6,8,0,22
"1505","impressed",11,5,5,1,22
"1506","independence",11,10,1,0,22
"1507","individual",11,9,2,0,22
"1508","insurrection",16,4,2,0,22
"1509","isaac",14,6,2,0,22
"1510","lashes",4,14,4,0,22
"1511","management",13,8,1,0,22
"1512","mission",14,7,0,1,22
"1513","mode",8,6,8,0,22
"1514","narrow",11,6,2,3,22
"1515","officers",18,2,0,2,22
"1516","opened",21,0,0,1,22
"1517","performance",9,7,4,2,22
"1518","piety",10,10,2,0,22
"1519","possibly",11,10,1,0,22
"1520","post",11,4,7,0,22
"1521","praise",12,8,2,0,22
"1522","proceed",8,11,1,2,22
"1523","pursued",10,10,2,0,22
"1524","quality",11,9,1,1,22
"1525","red",10,7,3,2,22
"1526","relief",10,10,2,0,22
"1527","selfish",14,8,0,0,22
"1528","shelter",15,5,2,0,22
"1529","ships",9,9,3,1,22
"1530","showed",21,0,0,1,22
"1531","sleeping",11,9,2,0,22
"1532","term",11,9,2,0,22
"1533","terror",10,10,2,0,22
"1534","tongue",10,10,2,0,22
"1535","turned",22,0,0,0,22
"1536","urged",14,5,3,0,22
"1537","wharf",12,6,3,1,22
"1538","willing",22,0,0,0,22
"1539","woe",4,9,9,0,22
"1540","absence",9,8,4,0,21
"1541","acquaintance",13,5,2,1,21
"1542","add",11,8,2,0,21
"1543","afternoon",6,5,4,6,21
"1544","assumed",10,9,2,0,21
"1545","august",13,3,5,0,21
"1546","barn",9,7,5,0,21
"1547","beaten",12,8,1,0,21
"1548","blacks",13,8,0,0,21
"1549","career",10,5,6,0,21
"1550","chair",15,4,2,0,21
"1551","christ",7,9,4,1,21
"1552","citizen",18,3,0,0,21
"1553","college",18,1,0,2,21
"1554","conclusion",14,6,1,0,21
"1555","contrary",10,8,3,0,21
"1556","copy",7,9,5,0,21
"1557","cunning",8,10,3,0,21
"1558","curiosity",9,9,2,1,21
"1559","dealt",11,9,1,0,21
"1560","deeds",10,6,5,0,21
"1561","dinner",10,8,1,2,21
"1562","directly",10,8,3,0,21
"1563","discovered",11,8,2,0,21
"1564","driving",10,9,1,1,21
"1565","element",13,6,2,0,21
"1566","esteemed",7,10,4,0,21
"1567","example",20,0,0,1,21
"1568","excluded",15,6,0,0,21
"1569","fault",6,10,5,0,21
"1570","feared",8,9,4,0,21
"1571","fifteen",9,9,3,0,21
"1572","firm",11,5,4,1,21
"1573","freedmen",21,0,0,0,21
"1574","furnished",9,11,0,1,21
"1575","genuine",10,11,0,0,21
"1576","georgia",12,6,3,0,21
"1577","glory",10,6,4,1,21
"1578","grew",9,9,3,0,21
"1579","health",10,8,1,2,21
"1580","humble",12,6,3,0,21
"1581","hurried",10,9,1,1,21
"1582","informed",14,6,1,0,21
"1583","inquired",8,5,7,1,21
"1584","instead",20,0,0,1,21
"1585","insult",11,10,0,0,21
"1586","island",15,4,1,1,21
"1587","ladies",12,5,1,3,21
"1588","largest",11,4,1,5,21
"1589","limbs",7,11,2,1,21
"1590","loneliness",8,8,4,1,21
"1591","marriage",4,11,6,0,21
"1592","material",14,7,0,0,21
"1593","mentioned",11,9,1,0,21
"1594","minutes",12,6,2,1,21
"1595","misery",9,10,2,0,21
"1596","neighbors",4,13,4,0,21
"1597","obtain",14,6,1,0,21
"1598","offer",12,7,2,0,21
"1599","ones",20,0,0,1,21
"1600","owe",9,9,3,0,21
"1601","passion",12,9,0,0,21
"1602","perform",12,7,2,0,21
"1603","poverty",12,5,3,1,21
"1604","prospect",9,9,1,2,21
"1605","quarters",12,7,2,0,21
"1606","quick",8,9,3,1,21
"1607","raise",12,6,3,0,21
"1608","recently",16,2,2,1,21
"1609","ruggles",5,7,9,0,21
"1610","sale",12,7,1,1,21
"1611","separate",7,13,1,0,21
"1612","services",13,7,0,1,21
"1613","shade",9,11,0,1,21
"1614","shipyard",18,2,1,0,21
"1615","sides",21,0,0,0,21
"1616","speedily",13,8,0,0,21
"1617","stands",9,8,2,2,21
"1618","suggested",13,4,4,0,21
"1619","teeth",11,10,0,0,21
"1620","violent",12,7,2,0,21
"1621","weight",9,8,4,0,21
"1622","wheat",8,8,5,0,21
"1623","worked",20,0,0,1,21
"1624","advantages",12,8,0,0,20
"1625","agents",16,3,1,0,20
"1626","answered",10,8,1,1,20
"1627","appointment",20,0,0,0,20
"1628","ashes",8,9,0,3,20
"1629","aspect",8,11,1,0,20
"1630","becoming",19,0,0,1,20
"1631","behavior",8,9,1,2,20
"1632","benefit",11,7,2,0,20
"1633","broke",8,5,7,0,20
"1634","calm",11,6,1,2,20
"1635","claim",11,8,1,0,20
"1636","closed",10,6,3,1,20
"1637","committee",18,2,0,0,20
"1638","complaint",12,5,3,0,20
"1639","conducted",10,6,2,2,20
"1640","deed",7,7,6,0,20
"1641","defend",13,6,1,0,20
"1642","demand",12,7,1,0,20
"1643","derived",11,9,0,0,20
"1644","direct",10,8,1,1,20
"1645","drew",8,8,4,0,20
"1646","dropped",11,9,0,0,20
"1647","ear",7,12,1,0,20
"1648","enthusiasm",11,7,1,1,20
"1649","fairly",8,7,4,1,20
"1650","fare",8,7,2,3,20
"1651","favored",10,8,0,2,20
"1652","fears",9,9,2,0,20
"1653","fill",14,5,1,0,20
"1654","friendship",10,9,0,1,20
"1655","gardiner’s",11,9,0,0,20
"1656","gentle",8,11,1,0,20
"1657","harsh",9,10,1,0,20
"1658","helen",0,0,0,20,20
"1659","horror",7,9,4,0,20
"1660","hot",9,5,4,2,20
"1661","impressive",10,1,2,7,20
"1662","interests",19,0,0,1,20
"1663","jesus",6,6,3,5,20
"1664","judge",5,11,1,3,20
"1665","leaders",13,5,2,0,20
"1666","legs",9,9,2,0,20
"1667","main",13,7,0,0,20
"1668","mankind",9,10,1,0,20
"1669","manners",8,10,1,1,20
"1670","merciless",6,11,3,0,20
"1671","messrs",14,5,1,0,20
"1672","motion",8,8,3,1,20
"1673","motives",12,8,0,0,20
"1674","movements",12,8,0,0,20
"1675","mystery",9,11,0,0,20
"1676","newly",13,6,1,0,20
"1677","ocean",11,6,2,1,20
"1678","operation",13,6,1,0,20
"1679","orleans",13,7,0,0,20
"1680","perfectly",10,8,2,0,20
"1681","pigs",7,8,5,0,20
"1682","prayers",8,8,4,0,20
"1683","preacher",7,10,3,0,20
"1684","precious",10,7,1,2,20
"1685","precisely",12,7,0,1,20
"1686","produce",10,7,3,0,20
"1687","purchase",12,6,2,0,20
"1688","pure",9,6,3,2,20
"1689","quiet",11,7,0,2,20
"1690","rapidly",12,8,0,0,20
"1691","rebels",19,1,0,0,20
"1692","referred",9,11,0,0,20
"1693","relieved",8,5,7,0,20
"1694","replied",15,4,1,0,20
"1695","represented",12,3,4,1,20
"1696","responsible",9,9,2,0,20
"1697","revolting",7,12,0,1,20
"1698","riding",6,11,3,0,20
"1699","rising",14,5,1,0,20
"1700","roused",8,9,3,0,20
"1701","servant",6,9,4,1,20
"1702","shot",9,7,4,0,20
"1703","sick",10,8,2,0,20
"1704","silent",17,3,0,0,20
"1705","stealing",6,9,5,0,20
"1706","strongest",7,6,6,1,20
"1707","supported",13,6,0,1,20
"1708","sustained",10,6,4,0,20
"1709","takes",7,10,3,0,20
"1710","torture",8,11,1,0,20
"1711","touched",12,6,2,0,20
"1712","undertaking",9,8,3,0,20
"1713","unreasonable",13,7,0,0,20
"1714","abolitionist",11,8,0,0,19
"1715","absolute",8,9,1,1,19
"1716","abused",8,10,1,0,19
"1717","active",9,6,4,0,19
"1718","amongst",19,0,0,0,19
"1719","amount",9,4,5,1,19
"1720","assisted",12,5,2,0,19
"1721","attack",12,6,1,0,19
"1722","beasts",6,7,6,0,19
"1723","beat",7,11,1,0,19
"1724","behold",7,9,2,1,19
"1725","blue",9,3,0,7,19
"1726","choice",13,4,2,0,19
"1727","christianity",0,9,10,0,19
"1728","clear",19,0,0,0,19
"1729","complaints",10,6,3,0,19
"1730","concerned",8,9,2,0,19
"1731","concerning",19,0,0,0,19
"1732","control",9,8,1,1,19
"1733","conversion",7,8,4,0,19
"1734","deliver",10,5,3,1,19
"1735","demands",15,4,0,0,19
"1736","denby",9,10,0,0,19
"1737","discussion",12,7,0,0,19
"1738","disturbed",10,6,2,1,19
"1739","divine",6,10,2,1,19
"1740","doubtless",8,10,1,0,19
"1741","emancipate",10,6,3,0,19
"1742","esteem",9,10,0,0,19
"1743","exposed",9,10,0,0,19
"1744","fail",13,5,1,0,19
"1745","false",6,8,5,0,19
"1746","final",10,7,2,0,19
"1747","fitted",11,6,1,1,19
"1748","forms",7,7,1,4,19
"1749","freeland’s",6,12,1,0,19
"1750","freely",11,7,1,0,19
"1751","gates",6,7,1,5,19
"1752","gathered",11,8,0,0,19
"1753","grace",12,4,2,1,19
"1754","hire",6,7,6,0,19
"1755","improvement",11,8,0,0,19
"1756","impudence",6,11,2,0,19
"1757","instruction",7,6,4,2,19
"1758","intellect",7,7,4,1,19
"1759","laborer",10,8,1,0,19
"1760","leisure",7,8,4,0,19
"1761","level",7,8,2,2,19
"1762","meat",6,9,4,0,19
"1763","narrative",5,4,10,0,19
"1764","newspapers",9,9,1,0,19
"1765","path",8,7,3,1,19
"1766","promote",11,8,0,0,19
"1767","providence",8,7,4,0,19
"1768","pulpit",6,8,4,1,19
"1769","ranks",8,9,2,0,19
"1770","reality",9,7,3,0,19
"1771","recapture",11,8,0,0,19
"1772","recognized",11,5,1,2,19
"1773","reproach",8,11,0,0,19
"1774","reserve",9,6,0,4,19
"1775","rid",7,7,4,1,19
"1776","round",10,6,2,1,19
"1777","sat",12,6,1,0,19
"1778","secured",12,4,2,1,19
"1779","security",11,7,1,0,19
"1780","shut",6,10,3,0,19
"1781","solid",13,4,0,2,19
"1782","spirits",10,7,1,1,19
"1783","splendid",12,4,3,0,19
"1784","spot",6,6,7,0,19
"1785","startling",14,2,1,2,19
"1786","station",11,5,2,1,19
"1787","stowe",18,1,0,0,19
"1788","stripes",6,11,2,0,19
"1789","succeed",8,7,4,0,19
"1790","superstition",7,8,1,3,19
"1791","sustain",7,9,3,0,19
"1792","talked",9,7,3,0,19
"1793","tear",7,10,2,0,19
"1794","temper",7,11,1,0,19
"1795","tie",7,6,6,0,19
"1796","timber",5,6,8,0,19
"1797","unknown",13,3,2,1,19
"1798","usefulness",10,8,1,0,19
"1799","utmost",7,6,5,1,19
"1800","vain",13,4,2,0,19
"1801","western",10,7,1,1,19
"1802","whenever",19,0,0,0,19
"1803","wonderful",14,1,2,2,19
"1804","wore",11,5,2,1,19
"1805","worn",6,9,3,1,19
"1806","acknowledge",5,10,3,0,18
"1807","admiration",8,6,2,2,18
"1808","admission",11,6,1,0,18
"1809","afraid",6,10,2,0,18
"1810","ages",9,6,3,0,18
"1811","agitation",13,4,1,0,18
"1812","aim",9,8,1,0,18
"1813","almighty",7,8,2,1,18
"1814","angry",8,7,3,0,18
"1815","ascertain",8,5,5,0,18
"1816","assist",13,5,0,0,18
"1817","attending",6,6,6,0,18
"1818","austin",9,7,2,0,18
"1819","author",9,9,0,0,18
"1820","boast",7,6,5,0,18
"1821","brilliant",10,6,1,1,18
"1822","calking",4,7,7,0,18
"1823","capture",15,2,1,0,18
"1824","cared",10,7,1,0,18
"1825","carefully",9,7,1,1,18
"1826","cease",10,6,2,0,18
"1827","cent",6,8,4,0,18
"1828","commission",12,3,3,0,18
"1829","compared",3,8,7,0,18
"1830","compromise",12,5,1,0,18
"1831","confined",9,7,2,0,18
"1832","consented",11,6,1,0,18
"1833","contented",7,7,3,1,18
"1834","cries",7,9,2,0,18
"1835","daughters",7,8,2,1,18
"1836","deck",9,4,0,5,18
"1837","difficulties",8,7,3,0,18
"1838","division",11,4,3,0,18
"1839","doctors",9,9,0,0,18
"1840","doomed",9,8,1,0,18
"1841","dream",8,9,1,0,18
"1842","eager",8,6,1,3,18
"1843","east",11,4,1,2,18
"1844","energy",8,7,1,2,18
"1845","entering",7,6,4,1,18
"1846","exodus",18,0,0,0,18
"1847","families",8,7,2,1,18
"1848","favorite",7,11,0,0,18
"1849","fence",4,8,6,0,18
"1850","fighting",13,5,0,0,18
"1851","foster",13,5,0,0,18
"1852","freemen",9,6,3,0,18
"1853","gladly",10,7,1,0,18
"1854","hatred",9,7,2,0,18
"1855","heavenly",0,3,15,0,18
"1856","hell",4,9,5,0,18
"1857","hill",9,4,2,3,18
"1858","honored",14,4,0,0,18
"1859","idle",8,9,1,0,18
"1860","instances",5,9,4,0,18
"1861","intellectual",6,9,3,0,18
"1862","jan",0,0,0,18,18
"1863","january",8,4,5,1,18
"1864","leader",11,4,3,0,18
"1865","listening",14,4,0,0,18
"1866","loving",7,9,2,0,18
"1867","luxury",8,7,3,0,18
"1868","lying",6,9,3,0,18
"1869","mansion",15,3,0,0,18
"1870","mechanics",12,6,0,0,18
"1871","missouri",17,1,0,0,18
"1872","narrate",8,8,2,0,18
"1873","obedience",8,9,0,1,18
"1874","pains",8,7,3,0,18
"1875","parts",18,0,0,0,18
"1876","period",9,4,4,1,18
"1877","permission",5,10,3,0,18
"1878","philosophy",7,10,1,0,18
"1879","plainly",14,4,0,0,18
"1880","price",10,6,2,0,18
"1881","procession",13,3,0,2,18
"1882","raising",13,2,3,0,18
"1883","rebuke",7,10,1,0,18
"1884","responsibility",7,10,1,0,18
"1885","sable",7,10,1,0,18
"1886","sears",18,0,0,0,18
"1887","selected",8,7,2,1,18
"1888","series",10,6,2,0,18
"1889","severely",6,10,2,0,18
"1890","sister",4,7,4,3,18
"1891","spectacle",7,7,1,3,18
"1892","standard",13,4,1,0,18
"1893","stick",7,6,5,0,18
"1894","strongly",8,7,3,0,18
"1895","supplied",11,7,0,0,18
"1896","supply",11,7,0,0,18
"1897","surprised",11,6,0,1,18
"1898","temperance",16,2,0,0,18
"1899","threats",9,7,2,0,18
"1900","tom",4,11,3,0,18
"1901","trembling",5,5,6,2,18
"1902","unlike",10,5,3,0,18
"1903","useful",18,0,0,0,18
"1904","walls",12,3,1,2,18
"1905","warning",9,6,3,0,18
"1906","wit",7,7,3,1,18
"1907","ye",0,3,15,0,18
"1908","afterwards",17,0,0,0,17
"1909","agony",9,7,1,0,17
"1910","amid",9,7,1,0,17
"1911","applied",8,6,3,0,17
"1912","arrangement",6,9,2,0,17
"1913","aside",15,0,0,2,17
"1914","assembled",12,4,0,1,17
"1915","avoid",9,5,3,0,17
"1916","bent",7,8,2,0,17
"1917","betrayed",10,6,1,0,17
"1918","border",16,0,1,0,17
"1919","brains",6,5,6,0,17
"1920","breast",6,9,2,0,17
"1921","burned",10,6,1,0,17
"1922","calculated",7,8,1,1,17
"1923","canoe",7,7,3,0,17
"1924","cattle",6,10,1,0,17
"1925","ceremony",8,7,1,1,17
"1926","chattel",6,9,2,0,17
"1927","cheerful",8,2,3,4,17
"1928","colors",13,2,0,2,17
"1929","combined",9,6,2,0,17
"1930","comparatively",9,7,1,0,17
"1931","cool",11,4,1,1,17
"1932","dare",5,8,3,1,17
"1933","defeat",15,1,1,0,17
"1934","degrading",7,7,3,0,17
"1935","disappointed",10,5,2,0,17
"1936","distinct",7,10,0,0,17
"1937","endured",7,5,4,1,17
"1938","enlightened",13,3,1,0,17
"1939","essential",9,7,1,0,17
"1940","evident",8,8,1,0,17
"1941","extract",3,14,0,0,17
"1942","extreme",7,7,3,0,17
"1943","febry",0,0,0,17,17
"1944","feeding",7,8,2,0,17
"1945","friday",4,4,1,8,17
"1946","gardiner",9,8,0,0,17
"1947","gen",17,0,0,0,17
"1948","grief",7,8,2,0,17
"1949","hearted",0,13,4,0,17
"1950","hut",4,9,4,0,17
"1951","imposing",8,4,1,4,17
"1952","indebted",9,7,1,0,17
"1953","indifference",10,6,0,1,17
"1954","induce",8,8,1,0,17
"1955","industrious",10,6,1,0,17
"1956","introduction",8,9,0,0,17
"1957","justified",8,9,0,0,17
"1958","justify",5,9,3,0,17
"1959","larger",9,4,2,2,17
"1960","linen",3,10,4,0,17
"1961","listened",10,4,2,1,17
"1962","logic",9,8,0,0,17
"1963","monument",14,0,0,3,17
"1964","nations",11,4,0,2,17
"1965","notions",5,11,1,0,17
"1966","o’clock",10,5,2,0,17
"1967","obeyed",8,6,2,1,17
"1968","occur",10,6,1,0,17
"1969","ordinary",6,8,3,0,17
"1970","preachers",5,10,2,0,17
"1971","prefer",5,9,3,0,17
"1972","private",9,8,0,0,17
"1973","privileges",6,9,2,0,17
"1974","produced",9,7,1,0,17
"1975","prominent",13,4,0,0,17
"1976","rebel",17,0,0,0,17
"1977","render",8,7,2,0,17
"1978","residence",9,5,1,2,17
"1979","resist",7,9,1,0,17
"1980","robert",16,0,0,1,17
"1981","schools",14,3,0,0,17
"1982","secret",8,8,1,0,17
"1983","sending",9,6,1,1,17
"1984","sensation",6,8,2,1,17
"1985","settled",11,5,1,0,17
"1986","shake",10,6,0,1,17
"1987","sin",3,13,1,0,17
"1988","sober",9,6,2,0,17
"1989","source",6,7,3,1,17
"1990","speed",7,6,4,0,17
"1991","spread",8,5,0,4,17
"1992","stately",9,5,0,3,17
"1993","storm",10,3,1,3,17
"1994","style",6,9,2,0,17
"1995","sudden",9,5,3,0,17
"1996","utterance",9,5,3,0,17
"1997","various",16,0,0,1,17
"1998","waiting",10,4,3,0,17
"1999","wall",6,9,1,1,17
"2000","warrant",7,8,2,0,17
"2001","wound",8,5,4,0,17
"2002","accomplished",13,3,0,0,16
"2003","acted",6,8,2,0,16
"2004","advanced",8,7,1,0,16
"2005","african",8,7,1,0,16
"2006","barbarity",3,6,7,0,16
"2007","base",7,6,2,1,16
"2008","basis",10,6,0,0,16
"2009","begin",9,6,1,0,16
"2010","belongs",10,6,0,0,16
"2011","bodies",6,7,3,0,16
"2012","bold",7,6,2,1,16
"2013","buchanan",16,0,0,0,16
"2014","buildings",8,6,1,1,16
"2015","caroline",6,6,2,2,16
"2016","classes",13,3,0,0,16
"2017","collins",10,5,1,0,16
"2018","comfort",4,10,2,0,16
"2019","compel",8,6,2,0,16
"2020","contemplated",8,6,2,0,16
"2021","converted",5,8,2,1,16
"2022","cruelties",3,11,2,0,16
"2023","crushed",6,8,2,0,16
"2024","dashed",6,6,3,1,16
"2025","dashing",6,7,1,2,16
"2026","day’s",6,8,2,0,16
"2027","deadly",8,5,3,0,16
"2028","degraded",7,6,2,1,16
"2029","demanded",8,8,0,0,16
"2030","departed",7,3,4,2,16
"2031","desperate",10,5,1,0,16
"2032","destiny",10,5,1,0,16
"2033","destruction",13,3,0,0,16
"2034","dragged",6,9,1,0,16
"2035","drawing",9,5,1,1,16
"2036","drove",6,7,1,2,16
"2037","effects",8,5,3,0,16
"2038","ended",16,0,0,0,16
"2039","enjoy",5,10,1,0,16
"2040","exceedingly",5,7,4,0,16
"2041","execution",14,2,0,0,16
"2042","existed",9,4,3,0,16
"2043","faithfully",8,6,2,0,16
"2044","fetters",7,6,3,0,16
"2045","fiendish",5,8,3,0,16
"2046","fit",8,6,2,0,16
"2047","fixed",7,6,2,1,16
"2048","fortunately",11,5,0,0,16
"2049","fruits",7,8,1,0,16
"2050","gold",7,6,1,2,16
"2051","grandeur",9,5,1,1,16
"2052","greatest",14,0,0,2,16
"2053","grounds",9,6,0,1,16
"2054","harm",9,4,3,0,16
"2055","henny",6,8,2,0,16
"2056","higher",15,0,0,1,16
"2057","hospitality",8,7,1,0,16
"2058","illustrate",8,7,1,0,16
"2059","impressions",9,6,1,0,16
"2060","inauguration",16,0,0,0,16
"2061","indian",8,8,0,0,16
"2062","inspiration",11,5,0,0,16
"2063","inspired",10,4,2,0,16
"2064","instrument",10,4,1,1,16
"2065","intention",8,4,4,0,16
"2066","introduced",14,2,0,0,16
"2067","knees",5,7,4,0,16
"2068","lawson",7,9,0,0,16
"2069","liability",4,9,3,0,16
"2070","liberator",14,0,2,0,16
"2071","lie",5,3,4,4,16
"2072","mary",3,7,5,1,16
"2073","mill",5,9,2,0,16
"2074","miserable",9,4,3,0,16
"2075","nevertheless",16,0,0,0,16
"2076","nine",15,0,0,1,16
"2077","observation",10,5,1,0,16
"2078","offering",5,9,1,1,16
"2079","orator",9,5,2,0,16
"2080","ordered",16,0,0,0,16
"2081","origin",9,7,0,0,16
"2082","original",5,10,1,0,16
"2083","owners",8,7,1,0,16
"2084","pennsylvania",11,4,1,0,16
"2085","peril",11,4,1,0,16
"2086","pictures",3,5,1,7,16
"2087","pity",6,8,2,0,16
"2088","portion",5,8,3,0,16
"2089","positive",5,10,1,0,16
"2090","prey",5,8,3,0,16
"2091","probable",8,6,2,0,16
"2092","prosperity",7,7,1,1,16
"2093","proud",8,5,3,0,16
"2094","putting",9,6,0,1,16
"2095","rain",6,5,2,3,16
"2096","refinement",6,8,2,0,16
"2097","resisted",9,5,1,1,16
"2098","rude",7,7,2,0,16
"2099","runaway",11,5,0,0,16
"2100","rushed",6,7,3,0,16
"2101","scale",7,5,4,0,16
"2102","season",12,4,0,0,16
"2103","sentiments",8,5,3,0,16
"2104","shock",10,5,1,0,16
"2105","signs",7,8,0,1,16
"2106","stage",9,5,2,0,16
"2107","sugar",8,7,1,0,16
"2108","tenderness",6,8,2,0,16
"2109","threw",8,5,3,0,16
"2110","traders",3,10,3,0,16
"2111","unusual",9,7,0,0,16
"2112","utter",4,6,4,2,16
"2113","valued",9,6,1,0,16
"2114","virtue",4,9,3,0,16
"2115","visible",9,5,1,1,16
"2116","wendell",11,2,3,0,16
"2117","whilst",3,5,8,0,16
"2118","wickedness",6,10,0,0,16
"2119","works",12,0,0,4,16
"2120","wounds",11,5,0,0,16
"2121","abhorrence",8,5,2,0,15
"2122","according",15,0,0,0,15
"2123","approached",9,3,1,2,15
"2124","ashamed",10,5,0,0,15
"2125","band",6,7,2,0,15
"2126","barbarous",7,8,0,0,15
"2127","believing",7,8,0,0,15
"2128","bondman",3,9,3,0,15
"2129","bones",6,7,1,1,15
"2130","borders",10,5,0,0,15
"2131","branches",11,2,0,2,15
"2132","brief",12,0,0,3,15
"2133","britain",4,11,0,0,15
"2134","buffum",10,5,0,0,15
"2135","catch",5,6,3,1,15
"2136","cents",7,4,4,0,15
"2137","characteristics",6,9,0,0,15
"2138","characters",9,5,1,0,15
"2139","civilized",8,7,0,0,15
"2140","clay",10,4,1,0,15
"2141","columns",8,5,0,2,15
"2142","comes",14,0,0,1,15
"2143","complexion",7,5,3,0,15
"2144","concern",6,8,1,0,15
"2145","content",6,6,3,0,15
"2146","contentment",3,8,4,0,15
"2147","cook",10,5,0,0,15
"2148","cover",6,8,0,1,15
"2149","curious",7,7,1,0,15
"2150","daring",7,6,2,0,15
"2151","decision",11,1,3,0,15
"2152","desolate",4,5,4,2,15
"2153","destroy",6,8,1,0,15
"2154","details",8,6,1,0,15
"2155","dialogue",5,6,4,0,15
"2156","distinctly",9,6,0,0,15
"2157","distressing",8,7,0,0,15
"2158","dreams",8,7,0,0,15
"2159","employ",11,2,2,0,15
"2160","entertained",8,7,0,0,15
"2161","erected",11,3,0,1,15
"2162","establish",7,7,1,0,15
"2163","estate",11,2,2,0,15
"2164","everywhere",15,0,0,0,15
"2165","exposure",6,8,1,0,15
"2166","extended",9,6,0,0,15
"2167","fatal",11,3,1,0,15
"2168","feed",5,8,2,0,15
"2169","forced",9,5,1,0,15
"2170","foregoing",9,5,1,0,15
"2171","foundation",12,2,1,0,15
"2172","frightful",3,5,7,0,15
"2173","fugitives",10,5,0,0,15
"2174","garden",8,1,6,0,15
"2175","goodness",4,8,3,0,15
"2176","gradually",9,6,0,0,15
"2177","grandchildren",5,5,5,0,15
"2178","hit",10,5,0,0,15
"2179","horrors",5,9,1,0,15
"2180","hunted",5,8,2,0,15
"2181","infernal",3,6,6,0,15
"2182","innocent",7,6,2,0,15
"2183","insensible",5,6,4,0,15
"2184","joyous",4,11,0,0,15
"2185","july",4,10,1,0,15
"2186","keen",3,11,1,0,15
"2187","landed",10,5,0,0,15
"2188","largely",15,0,0,0,15
"2189","leaves",5,9,1,0,15
"2190","lloyds",7,8,0,0,15
"2191","load",4,7,3,1,15
"2192","lose",6,5,4,0,15
"2193","maintain",8,7,0,0,15
"2194","malice",7,7,1,0,15
"2195","marks",7,6,1,1,15
"2196","member",15,0,0,0,15
"2197","mothers",5,7,3,0,15
"2198","mountain",8,1,1,5,15
"2199","moving",5,7,2,1,15
"2200","multitude",7,5,1,2,15
"2201","noise",7,6,1,1,15
"2202","objection",10,5,0,0,15
"2203","offended",8,7,0,0,15
"2204","offenses",2,13,0,0,15
"2205","opportunities",8,5,2,0,15
"2206","pathway",6,6,3,0,15
"2207","patience",11,2,0,2,15
"2208","plenty",6,7,2,0,15
"2209","pocket",7,7,1,0,15
"2210","preferred",9,4,2,0,15
"2211","presidential",14,1,0,0,15
"2212","races",12,2,1,0,15
"2213","reasoning",9,4,2,0,15
"2214","reflections",12,2,1,0,15
"2215","regular",7,5,3,0,15
"2216","repeal",14,0,1,0,15
"2217","respectable",8,7,0,0,15
"2218","respected",11,3,1,0,15
"2219","resting",7,6,0,2,15
"2220","ruffians",9,6,0,0,15
"2221","seats",6,7,2,0,15
"2222","shadow",8,4,2,1,15
"2223","singularly",8,6,1,0,15
"2224","slight",7,8,0,0,15
"2225","soft",7,7,0,1,15
"2226","sounds",5,7,1,2,15
"2227","stopped",8,3,4,0,15
"2228","submit",11,4,0,0,15
"2229","sufficiently",6,7,2,0,15
"2230","supreme",14,1,0,0,15
"2231","taste",6,7,2,0,15
"2232","throughout",15,0,0,0,15
"2233","throw",8,6,1,0,15
"2234","traveling",10,5,0,0,15
"2235","trials",9,6,0,0,15
"2236","tyrant",8,6,1,0,15
"2237","understanding",7,7,1,0,15
"2238","unless",15,0,0,0,15
"2239","victory",13,2,0,0,15
"2240","waited",11,4,0,0,15
"2241","wide",3,10,1,1,15
"2242","wonder",12,0,0,3,15
"2243","worthy",9,3,3,0,15
"2244","wretchedness",6,6,2,1,15
"2245","yea",6,7,2,0,15
"2246","activity",9,3,1,1,14
"2247","administration",13,1,0,0,14
"2248","affectionate",5,7,2,0,14
"2249","afterward",3,7,2,2,14
"2250","alleged",6,6,2,0,14
"2251","amanda",7,5,2,0,14
"2252","ambition",7,4,1,2,14
"2253","approaching",4,9,1,0,14
"2254","assailed",12,2,0,0,14
"2255","author’s",13,1,0,0,14
"2256","avail",9,5,0,0,14
"2257","beast",4,7,3,0,14
"2258","beating",5,4,4,1,14
"2259","beds",5,7,2,0,14
"2260","benefits",5,8,1,0,14
"2261","bind",5,5,4,0,14
"2262","birds",6,6,1,1,14
"2263","bitterness",10,4,0,0,14
"2264","brotherhood",7,7,0,0,14
"2265","built",7,3,1,3,14
"2266","cake",4,10,0,0,14
"2267","calamity",9,3,2,0,14
"2268","cambria",4,10,0,0,14
"2269","carriage",8,3,2,1,14
"2270","chances",5,7,2,0,14
"2271","closely",7,6,1,0,14
"2272","conductor",13,1,0,0,14
"2273","consent",8,4,1,1,14
"2274","conventions",13,1,0,0,14
"2275","convictions",11,3,0,0,14
"2276","cried",5,7,2,0,14
"2277","cunningham",6,8,0,0,14
"2278","curses",5,6,3,0,14
"2279","declared",10,3,1,0,14
"2280","deem",4,5,5,0,14
"2281","defended",7,5,0,2,14
"2282","deprived",5,8,1,0,14
"2283","designed",9,5,0,0,14
"2284","desirable",8,6,0,0,14
"2285","devotion",9,2,2,1,14
"2286","directed",7,6,1,0,14
"2287","domingo",13,0,1,0,14
"2288","earnestly",9,4,1,0,14
"2289","eminent",11,2,1,0,14
"2290","escaping",4,8,2,0,14
"2291","examined",5,7,2,0,14
"2292","excuse",5,6,3,0,14
"2293","exist",4,10,0,0,14
"2294","expense",6,5,3,0,14
"2295","extend",8,2,2,2,14
"2296","extra",7,7,0,0,14
"2297","fed",4,6,4,0,14
"2298","fierce",10,3,0,1,14
"2299","fingers",5,5,3,1,14
"2300","florence",0,0,0,14,14
"2301","fly",5,5,4,0,14
"2302","forces",9,4,0,1,14
"2303","furious",10,4,0,0,14
"2304","garfield",14,0,0,0,14
"2305","gloom",5,5,4,0,14
"2306","handed",6,5,1,2,14
"2307","headed",2,9,1,2,14
"2308","height",7,4,1,2,14
"2309","helped",10,3,1,0,14
"2310","hesitation",7,7,0,0,14
"2311","highest",13,0,0,1,14
"2312","hitherto",10,4,0,0,14
"2313","hoped",8,2,2,2,14
"2314","hostility",11,3,0,0,14
"2315","hugh’s",3,8,3,0,14
"2316","inflicted",4,5,5,0,14
"2317","inside",12,2,0,0,14
"2318","interested",10,0,0,4,14
"2319","job",7,4,3,0,14
"2320","joseph",8,2,2,2,14
"2321","kidnappers",6,6,2,0,14
"2322","killing",4,6,4,0,14
"2323","knows",12,0,0,2,14
"2324","lane",6,6,2,0,14
"2325","lesson",9,3,1,1,14
"2326","lessons",7,4,2,1,14
"2327","liberal",11,2,0,1,14
"2328","lightning",7,5,2,0,14
"2329","literary",8,6,0,0,14
"2330","mean",14,0,0,0,14
"2331","middle",4,6,3,1,14
"2332","mouth",6,8,0,0,14
"2333","murray",6,4,3,1,14
"2334","obey",6,6,2,0,14
"2335","obliged",9,4,0,1,14
"2336","oil",7,5,2,0,14
"2337","owing",3,7,3,1,14
"2338","patriotic",13,1,0,0,14
"2339","patriotism",8,6,0,0,14
"2340","performed",5,5,4,0,14
"2341","permit",9,5,0,0,14
"2342","points",11,0,0,3,14
"2343","positions",12,2,0,0,14
"2344","practiced",6,8,0,0,14
"2345","pressed",9,4,1,0,14
"2346","proposition",8,5,1,0,14
"2347","punish",6,8,0,0,14
"2348","quickly",9,4,1,0,14
"2349","quietly",7,6,0,1,14
"2350","reduced",4,7,3,0,14
"2351","refusal",6,6,2,0,14
"2352","regularly",5,7,2,0,14
"2353","resort",5,6,2,1,14
"2354","rhode",14,0,0,0,14
"2355","roll",4,6,2,2,14
"2356","roof",9,5,0,0,14
"2357","ruin",10,4,0,0,14
"2358","rules",7,6,1,0,14
"2359","santo",13,0,1,0,14
"2360","scheme",9,5,0,0,14
"2361","serious",12,0,0,2,14
"2362","shirt",7,5,2,0,14
"2363","silver",4,7,1,2,14
"2364","singular",8,5,1,0,14
"2365","sixty",12,1,1,0,14
"2366","spirited",6,7,1,0,14
"2367","stamped",9,4,1,0,14
"2368","starve",7,6,1,0,14
"2369","stated",6,8,0,0,14
"2370","steam",4,6,1,3,14
"2371","steamboats",9,3,2,0,14
"2372","steps",8,6,0,0,14
"2373","strictly",5,7,2,0,14
"2374","stronger",8,3,3,0,14
"2375","sublime",9,4,1,0,14
"2376","suddenly",6,7,1,0,14
"2377","sufferings",4,7,3,0,14
"2378","supper",7,5,1,1,14
"2379","swore",6,6,2,0,14
"2380","teacher",5,6,3,0,14
"2381","title",7,5,2,0,14
"2382","tools",5,5,4,0,14
"2383","trained",4,9,1,0,14
"2384","tremendous",12,2,0,0,14
"2385","trip",7,2,0,5,14
"2386","twentyfive",14,0,0,0,14
"2387","unhappy",6,5,3,0,14
"2388","unnatural",4,10,0,0,14
"2389","vengeance",8,5,1,0,14
"2390","ventured",10,4,0,0,14
"2391","vindication",9,4,1,0,14
"2392","virtuous",2,8,4,0,14
"2393","vision",6,6,1,1,14
"2394","walking",5,5,1,3,14
"2395","won",8,6,0,0,14
"2396","won’t",4,6,4,0,14
"2397","alarm",6,6,1,0,13
"2398","alas",6,2,3,2,13
"2399","anguish",4,7,2,0,13
"2400","announced",11,2,0,0,13
"2401","appeal",5,8,0,0,13
"2402","approval",13,0,0,0,13
"2403","assembly",6,7,0,0,13
"2404","astonished",6,5,2,0,13
"2405","awkward",4,5,4,0,13
"2406","begun",7,6,0,0,13
"2407","beloved",8,4,1,0,13
"2408","benevolent",9,3,1,0,13
"2409","bitterest",7,4,2,0,13
"2410","blessings",8,5,0,0,13
"2411","block",3,8,1,1,13
"2412","bond",5,5,3,0,13
"2413","bravely",8,4,0,1,13
"2414","breath",6,6,1,0,13
"2415","breeze",5,6,2,0,13
"2416","brick",6,5,2,0,13
"2417","brutality",6,7,0,0,13
"2418","buffalo",13,0,0,0,13
"2419","buried",5,4,1,3,13
"2420","burning",4,9,0,0,13
"2421","butler",9,3,1,0,13
"2422","cases",12,0,0,1,13
"2423","ceased",7,5,1,0,13
"2424","changing",5,6,0,2,13
"2425","cities",7,3,0,3,13
"2426","clean",4,4,4,1,13
"2427","clouds",5,5,0,3,13
"2428","coal",6,2,1,4,13
"2429","commit",5,6,2,0,13
"2430","compensation",5,5,3,0,13
"2431","concluded",4,4,5,0,13
"2432","condemned",6,7,0,0,13
"2433","continue",7,3,3,0,13
"2434","copper",7,6,0,0,13
"2435","countrymen",9,4,0,0,13
"2436","created",7,4,2,0,13
"2437","creature",5,8,0,0,13
"2438","crowded",7,3,1,2,13
"2439","current",10,3,0,0,13
"2440","dared",6,3,3,1,13
"2441","definite",6,7,0,0,13
"2442","delay",12,1,0,0,13
"2443","denunciation",9,3,1,0,13
"2444","design",6,5,2,0,13
"2445","dim",6,4,3,0,13
"2446","distinction",8,5,0,0,13
"2447","doors",9,3,1,0,13
"2448","doubts",6,7,0,0,13
"2449","dreamed",6,7,0,0,13
"2450","dressed",7,2,2,2,13
"2451","drop",6,6,1,0,13
"2452","drunken",7,6,0,0,13
"2453","edge",4,7,1,1,13
"2454","enabled",8,3,2,0,13
"2455","endeavoring",8,4,0,1,13
"2456","endurance",5,5,2,1,13
"2457","endure",7,5,1,0,13
"2458","energies",4,8,1,0,13
"2459","evangelical",8,5,0,0,13
"2460","exalted",9,4,0,0,13
"2461","executive",13,0,0,0,13
"2462","expectations",6,5,2,0,13
"2463","fame",7,4,2,0,13
"2464","farther",8,2,3,0,13
"2465","fastened",7,6,0,0,13
"2466","fearful",4,7,2,0,13
"2467","fell’s",4,8,1,0,13
"2468","finest",3,3,3,4,13
"2469","foul",5,6,2,0,13
"2470","frequent",8,5,0,0,13
"2471","gerrit",11,2,0,0,13
"2472","gray",8,5,0,0,13
"2473","hamilton’s",6,6,1,0,13
"2474","hardened",2,8,2,1,13
"2475","hateful",4,7,2,0,13
"2476","heroic",11,2,0,0,13
"2477","hiring",5,5,3,0,13
"2478","imagine",3,5,3,2,13
"2479","imposed",8,5,0,0,13
"2480","indifferent",10,3,0,0,13
"2481","influences",4,9,0,0,13
"2482","instruct",4,4,5,0,13
"2483","join",9,3,0,1,13
"2484","laborers",6,6,0,1,13
"2485","laboring",8,4,1,0,13
"2486","lacked",3,5,5,0,13
"2487","legal",7,4,2,0,13
"2488","lest",13,0,0,0,13
"2489","limits",7,3,2,1,13
"2490","memorable",12,0,1,0,13
"2491","necessarily",5,4,4,0,13
"2492","nelly",2,11,0,0,13
"2493","news",11,0,0,2,13
"2494","notion",5,6,1,1,13
"2495","obtaining",7,6,0,0,13
"2496","occasional",4,7,1,1,13
"2497","ohio",12,1,0,0,13
"2498","older",12,0,0,1,13
"2499","pages",6,7,0,0,13
"2500","pour",5,5,2,1,13
"2501","prayed",5,4,4,0,13
"2502","preaching",4,7,2,0,13
"2503","probability",7,5,1,0,13
"2504","promised",10,2,1,0,13
"2505","proscription",7,6,0,0,13
"2506","raid",13,0,0,0,13
"2507","recognition",10,3,0,0,13
"2508","related",8,5,0,0,13
"2509","remaining",5,5,2,1,13
"2510","remark",4,8,1,0,13
"2511","remarks",8,3,2,0,13
"2512","require",9,3,1,0,13
"2513","requires",4,9,0,0,13
"2514","respectfully",10,2,0,1,13
"2515","respecting",2,7,4,0,13
"2516","revealed",6,5,2,0,13
"2517","richmond",11,1,1,0,13
"2518","rigid",7,4,1,1,13
"2519","risk",7,4,1,1,13
"2520","robbed",6,7,0,0,13
"2521","rode",4,2,4,3,13
"2522","sake",5,7,1,0,13
"2523","satisfy",6,6,1,0,13
"2524","section",11,2,0,0,13
"2525","seems",9,0,0,4,13
"2526","selfishness",6,6,1,0,13
"2527","solely",4,7,2,0,13
"2528","speakers",12,1,0,0,13
"2529","spiritual",4,9,0,0,13
"2530","starting",6,4,2,1,13
"2531","starved",6,3,4,0,13
"2532","statesmen",10,3,0,0,13
"2533","steal",5,5,3,0,13
"2534","stephen",11,2,0,0,13
"2535","sword",12,0,0,1,13
"2536","tall",6,7,0,0,13
"2537","task",5,5,3,0,13
"2538","thrown",6,5,2,0,13
"2539","towns",8,2,0,3,13
"2540","travel",6,6,1,0,13
"2541","traveled",9,4,0,0,13
"2542","triumph",6,5,1,1,13
"2543","vanished",7,5,1,0,13
"2544","viewed",5,7,1,0,13
"2545","voices",5,4,3,1,13
"2546","webster",11,2,0,0,13
"2547","whisky",3,6,4,0,13
"2548","wounded",9,2,1,1,13
"2549","wrought",7,5,0,1,13
"2550","wye",4,7,2,0,13
"2551","yoke",6,5,2,0,13
"2552","_the",0,11,1,0,12
"2553","absolutely",5,6,1,0,12
"2554","acquired",5,5,2,0,12
"2555","additional",7,3,2,0,12
"2556","advocates",9,2,1,0,12
"2557","agitated",5,6,1,0,12
"2558","alabama",4,5,3,0,12
"2559","alliance",5,7,0,0,12
"2560","ambitious",5,5,2,0,12
"2561","amidst",5,7,0,0,12
"2562","ample",7,5,0,0,12
"2563","animals",5,6,0,1,12
"2564","apology",5,7,0,0,12
"2565","appealed",5,6,1,0,12
"2566","application",5,6,1,0,12
"2567","april",6,0,0,6,12
"2568","argue",3,9,0,0,12
"2569","assume",7,5,0,0,12
"2570","assuming",7,4,1,0,12
"2571","attachment",5,6,1,0,12
"2572","behave",4,5,3,0,12
"2573","boat",8,3,0,1,12
"2574","bolts",7,5,0,0,12
"2575","bonds",4,4,4,0,12
"2576","brow",5,4,2,1,12
"2577","bruises",6,5,1,0,12
"2578","calkers",5,5,2,0,12
"2579","certainty",6,4,2,0,12
"2580","characteristic",6,6,0,0,12
"2581","cherished",6,6,0,0,12
"2582","christians",3,7,2,0,12
"2583","coast",2,7,0,3,12
"2584","collected",6,4,2,0,12
"2585","comforts",3,5,4,0,12
"2586","commended",8,3,0,1,12
"2587","confident",6,3,3,0,12
"2588","constables",4,5,3,0,12
"2589","contact",7,5,0,0,12
"2590","convince",5,6,1,0,12
"2591","cookman",4,5,3,0,12
"2592","dangers",8,4,0,0,12
"2593","de",0,12,0,0,12
"2594","debate",8,4,0,0,12
"2595","defeated",7,5,0,0,12
"2596","delegates",12,0,0,0,12
"2597","denounce",5,7,0,0,12
"2598","destitute",6,4,2,0,12
"2599","destitution",11,1,0,0,12
"2600","dey",6,6,0,0,12
"2601","discovery",7,5,0,0,12
"2602","domestic",4,7,1,0,12
"2603","double",6,5,1,0,12
"2604","doubted",7,4,1,0,12
"2605","douglas",11,1,0,0,12
"2606","dying",6,4,2,0,12
"2607","earnestness",6,3,2,1,12
"2608","earthly",6,6,0,0,12
"2609","egypt",2,1,0,9,12
"2610","europe",7,2,0,3,12
"2611","everybody",11,0,0,1,12
"2612","examination",6,2,4,0,12
"2613","exhibition",5,4,1,2,12
"2614","explain",6,6,0,0,12
"2615","facilities",5,6,1,0,12
"2616","fashion",8,4,0,0,12
"2617","favorably",8,3,0,1,12
"2618","fiery",6,6,0,0,12
"2619","footing",8,4,0,0,12
"2620","foreign",4,7,0,1,12
"2621","formerly",9,0,0,3,12
"2622","gash",4,8,0,0,12
"2623","globe",3,5,2,2,12
"2624","gloomy",6,6,0,0,12
"2625","granite",5,3,1,3,12
"2626","grasp",4,7,1,0,12
"2627","gratification",5,3,4,0,12
"2628","habits",8,4,0,0,12
"2629","hanged",6,5,1,0,12
"2630","hickory",5,5,2,0,12
"2631","hicks",5,4,3,0,12
"2632","hunters",5,5,2,0,12
"2633","impress",5,3,3,1,12
"2634","improved",4,7,1,0,12
"2635","inclined",6,5,1,0,12
"2636","included",6,5,1,0,12
"2637","independent",7,4,1,0,12
"2638","india",9,2,1,0,12
"2639","inferior",6,5,1,0,12
"2640","ingratitude",6,4,2,0,12
"2641","inquiry",6,6,0,0,12
"2642","insisted",9,2,1,0,12
"2643","inspire",5,6,1,0,12
"2644","intensely",7,4,1,0,12
"2645","intimated",6,5,1,0,12
"2646","kick",3,3,6,0,12
"2647","kinds",5,5,1,1,12
"2648","landing",9,2,1,0,12
"2649","letting",3,7,2,0,12
"2650","lynn",4,7,1,0,12
"2651","maintained",6,6,0,0,12
"2652","majority",5,7,0,0,12
"2653","marshall",10,1,1,0,12
"2654","monroe",10,0,0,2,12
"2655","murderer",8,4,0,0,12
"2656","murderous",5,6,1,0,12
"2657","music",5,5,1,1,12
"2658","nearer",7,3,1,1,12
"2659","notorious",5,7,0,0,12
"2660","numbers",12,0,0,0,12
"2661","objections",6,6,0,0,12
"2662","oratory",11,1,0,0,12
"2663","page",5,7,0,0,12
"2664","park",9,1,0,2,12
"2665","pistols",5,5,2,0,12
"2666","port",6,3,0,3,12
"2667","possess",3,8,1,0,12
"2668","practical",6,6,0,0,12
"2669","preach",3,4,3,2,12
"2670","prepare",3,6,3,0,12
"2671","prisoners",11,1,0,0,12
"2672","prompt",6,6,0,0,12
"2673","protecting",6,3,3,0,12
"2674","rapid",7,5,0,0,12
"2675","ray",6,4,2,0,12
"2676","receiving",3,4,4,1,12
"2677","regretted",10,1,0,1,12
"2678","remainder",5,4,1,2,12
"2679","remedy",6,5,1,0,12
"2680","remond",5,1,0,6,12
"2681","representation",8,4,0,0,12
"2682","resentment",10,1,0,1,12
"2683","resolution",3,6,3,0,12
"2684","ridiculous",7,5,0,0,12
"2685","rivers",5,5,1,1,12
"2686","rush",6,4,1,1,12
"2687","sailor",8,2,1,1,12
"2688","satisfactory",7,3,1,1,12
"2689","saved",10,1,1,0,12
"2690","scandalous",6,6,0,0,12
"2691","scorn",6,6,0,0,12
"2692","select",7,5,0,0,12
"2693","seventy",3,6,2,1,12
"2694","shared",7,5,0,0,12
"2695","shores",3,6,0,3,12
"2696","shoulder",7,5,0,0,12
"2697","shrouded",4,6,2,0,12
"2698","sickness",5,3,1,3,12
"2699","signal",9,2,1,0,12
"2700","sit",6,4,2,0,12
"2701","smile",7,5,0,0,12
"2702","sports",3,7,2,0,12
"2703","statements",2,8,2,0,12
"2704","strangely",8,2,2,0,12
"2705","straw",7,5,0,0,12
"2706","successfully",11,1,0,0,12
"2707","suitable",4,7,1,0,12
"2708","suited",8,4,0,0,12
"2709","summoned",5,6,1,0,12
"2710","suppression",6,6,0,0,12
"2711","survey",6,5,1,0,12
"2712","tempest",9,3,0,0,12
"2713","thick",6,5,1,0,12
"2714","threatened",7,5,0,0,12
"2715","throat",5,5,2,0,12
"2716","ties",5,5,2,0,12
"2717","touching",7,3,1,1,12
"2718","track",6,6,0,0,12
"2719","training",5,5,2,0,12
"2720","transient",8,4,0,0,12
"2721","truly",8,0,0,4,12
"2722","unfavorable",5,6,1,0,12
"2723","unjust",7,4,1,0,12
"2724","village",7,4,1,0,12
"2725","visits",5,7,0,0,12
"2726","washed",5,6,1,0,12
"2727","wear",5,6,1,0,12
"2728","winds",7,5,0,0,12
"2729","world’s",7,5,0,0,12
"2730","wright",6,5,1,0,12
"2731","_i",0,10,1,0,11
"2732","’ll",11,0,0,0,11
"2733","“old",11,0,0,0,11
"2734","absurd",4,7,0,0,11
"2735","accept",10,1,0,0,11
"2736","accomplish",6,5,0,0,11
"2737","acting",5,6,0,0,11
"2738","adapted",8,3,0,0,11
"2739","administrators",5,6,0,0,11
"2740","adopt",7,2,2,0,11
"2741","adrift",4,4,3,0,11
"2742","agreed",7,3,1,0,11
"2743","amazed",8,3,0,0,11
"2744","angels",3,3,4,1,11
"2745","announcement",9,2,0,0,11
"2746","apprehended",6,5,0,0,11
"2747","apt",4,6,1,0,11
"2748","armies",10,0,0,1,11
"2749","arranged",8,3,0,0,11
"2750","aspirations",5,5,1,0,11
"2751","assault",6,4,1,0,11
"2752","assurance",4,3,4,0,11
"2753","assuring",6,4,1,0,11
"2754","attained",9,2,0,0,11
"2755","attendance",8,2,1,0,11
"2756","bade",7,2,2,0,11
"2757","bag",6,2,2,1,11
"2758","banks",6,3,2,0,11
"2759","based",8,3,0,0,11
"2760","bosom",3,6,1,1,11
"2761","bridge",3,7,1,0,11
"2762","briefly",7,2,2,0,11
"2763","calls",5,2,3,1,11
"2764","capacity",6,3,2,0,11
"2765","cars",6,5,0,0,11
"2766","celebrate",11,0,0,0,11
"2767","changes",10,0,0,1,11
"2768","chosen",7,1,2,1,11
"2769","cloud",4,5,1,1,11
"2770","conceal",4,5,2,0,11
"2771","congenial",6,5,0,0,11
"2772","consciousness",5,6,0,0,11
"2773","constituted",7,4,0,0,11
"2774","contending",2,5,4,0,11
"2775","curse",4,5,2,0,11
"2776","date",6,2,1,2,11
"2777","dealing",6,5,0,0,11
"2778","delicate",5,5,1,0,11
"2779","depended",7,3,1,0,11
"2780","deprive",6,2,3,0,11
"2781","deserving",3,4,4,0,11
"2782","designs",6,5,0,0,11
"2783","despair",7,3,1,0,11
"2784","despite",10,0,0,1,11
"2785","destroyed",9,2,0,0,11
"2786","discontent",4,6,1,0,11
"2787","discourse",6,5,0,0,11
"2788","display",7,1,1,2,11
"2789","disregard",4,7,0,0,11
"2790","dogs",5,6,0,0,11
"2791","drunk",5,3,3,0,11
"2792","dull",6,4,0,1,11
"2793","earned",3,4,4,0,11
"2794","economy",9,2,0,0,11
"2795","elements",6,5,0,0,11
"2796","elevation",5,6,0,0,11
"2797","embraced",6,5,0,0,11
"2798","encountered",10,0,1,0,11
"2799","ends",11,0,0,0,11
"2800","enforced",6,5,0,0,11
"2801","enfranchisement",11,0,0,0,11
"2802","etc",11,0,0,0,11
"2803","evinced",4,6,1,0,11
"2804","exact",4,3,3,1,11
"2805","exceptions",3,6,2,0,11
"2806","execute",8,3,0,0,11
"2807","executed",6,5,0,0,11
"2808","executors",5,6,0,0,11
"2809","fancy",5,6,0,0,11
"2810","fences",6,5,0,0,11
"2811","fever",5,4,2,0,11
"2812","figure",5,6,0,0,11
"2813","finger",4,5,2,0,11
"2814","finished",6,4,1,0,11
"2815","firmness",4,2,5,0,11
"2816","fled",5,4,2,0,11
"2817","foremost",6,5,0,0,11
"2818","forth",11,0,0,0,11
"2819","frankly",1,8,1,1,11
"2820","fraud",3,4,4,0,11
"2821","fretful",3,6,2,0,11
"2822","fruit",4,3,3,1,11
"2823","fury",5,3,3,0,11
"2824","gather",4,6,1,0,11
"2825","genius",7,4,0,0,11
"2826","graceful",6,4,1,0,11
"2827","granted",5,5,1,0,11
"2828","greatness",2,4,2,3,11
"2829","grievous",5,5,1,0,11
"2830","hayes",11,0,0,0,11
"2831","here_",0,11,0,0,11
"2832","hesitate",5,5,1,0,11
"2833","hills",3,6,1,1,11
"2834","holds",1,7,1,2,11
"2835","hounds",5,4,1,1,11
"2836","hurry",6,4,1,0,11
"2837","hymns",4,7,0,0,11
"2838","image",3,6,2,0,11
"2839","imagined",6,3,2,0,11
"2840","inch",2,8,1,0,11
"2841","indiana",9,2,0,0,11
"2842","inhabitants",4,5,1,1,11
"2843","instant",5,3,3,0,11
"2844","interfere",4,7,0,0,11
"2845","interview",10,1,0,0,11
"2846","issue",5,4,2,0,11
"2847","kentucky",9,2,0,0,11
"2848","knife",3,8,0,0,11
"2849","knock",3,6,2,0,11
"2850","labored",7,4,0,0,11
"2851","lecturer",4,7,0,0,11
"2852","legislation",9,2,0,0,11
"2853","lewis",9,0,0,2,11
"2854","liked",11,0,0,0,11
"2855","liverpool",4,3,0,4,11
"2856","loose",5,5,1,0,11
"2857","losing",4,5,2,0,11
"2858","lower",4,5,2,0,11
"2859","managed",6,3,2,0,11
"2860","meals",3,5,2,1,11
"2861","method",5,6,0,0,11
"2862","methods",5,6,0,0,11
"2863","midnight",5,4,2,0,11
"2864","mingled",5,6,0,0,11
"2865","morality",2,9,0,0,11
"2866","mutual",5,4,2,0,11
"2867","nathan",5,4,2,0,11
"2868","neighboring",2,3,5,1,11
"2869","newport",6,1,4,0,11
"2870","nowhere",10,0,0,1,11
"2871","oath",8,2,1,0,11
"2872","observe",5,5,0,1,11
"2873","openly",5,4,2,0,11
"2874","outrages",5,3,3,0,11
"2875","outward",4,5,2,0,11
"2876","palace",1,0,0,10,11
"2877","parker",9,0,0,2,11
"2878","passes",5,6,0,0,11
"2879","pathos",6,2,3,0,11
"2880","perception",5,5,1,0,11
"2881","perilous",8,3,0,0,11
"2882","perpetuate",8,3,0,0,11
"2883","persecuted",7,4,0,0,11
"2884","pierce",6,5,0,0,11
"2885","playing",5,4,1,1,11
"2886","plead",7,4,0,0,11
"2887","please",10,0,0,1,11
"2888","pleasing",4,2,0,5,11
"2889","pork",6,4,1,0,11
"2890","pounds",5,5,1,0,11
"2891","poured",6,5,0,0,11
"2892","practically",8,3,0,0,11
"2893","prejudices",7,3,1,0,11
"2894","prospects",6,5,0,0,11
"2895","protected",8,3,0,0,11
"2896","publishing",5,6,0,0,11
"2897","punished",5,5,1,0,11
"2898","pursue",7,3,1,0,11
"2899","refuse",6,3,1,1,11
"2900","refusing",6,4,1,0,11
"2901","rejoice",5,5,0,1,11
"2902","repeat",7,4,0,0,11
"2903","repose",4,6,0,1,11
"2904","represent",6,3,1,1,11
"2905","representatives",10,1,0,0,11
"2906","reproaches",8,3,0,0,11
"2907","resided",6,3,1,1,11
"2908","resolutions",6,5,0,0,11
"2909","resorted",5,5,1,0,11
"2910","revelation",7,3,1,0,11
"2911","rice",2,6,3,0,11
"2912","richard",5,3,2,1,11
"2913","rob",3,5,3,0,11
"2914","roberts",4,5,2,0,11
"2915","sadly",5,5,1,0,11
"2916","scattered",8,3,0,0,11
"2917","scholars",3,7,1,0,11
"2918","sections",9,2,0,0,11
"2919","senators",8,3,0,0,11
"2920","shadows",7,4,0,0,11
"2921","shield",3,4,4,0,11
"2922","shoes",4,3,3,1,11
"2923","shop",5,5,1,0,11
"2924","sincerely",4,3,2,2,11
"2925","sinners",2,6,3,0,11
"2926","slaveholder’s",5,5,1,0,11
"2927","smoothly",5,2,3,1,11
"2928","sooner",8,3,0,0,11
"2929","sorrows",3,7,1,0,11
"2930","speaker",7,3,1,0,11
"2931","spending",4,4,3,0,11
"2932","sport",5,6,0,0,11
"2933","staggered",6,3,2,0,11
"2934","stained",4,3,4,0,11
"2935","sticks",4,4,3,0,11
"2936","stringent",5,6,0,0,11
"2937","sunshine",5,1,0,5,11
"2938","suppress",6,3,2,0,11
"2939","temple",6,1,0,4,11
"2940","temporary",7,4,0,0,11
"2941","tendency",7,2,2,0,11
"2942","testify",4,3,4,0,11
"2943","theodore",8,0,0,3,11
"2944","timid",8,2,1,0,11
"2945","tired",6,4,0,1,11
"2946","tour",6,1,0,4,11
"2947","tried",10,0,0,1,11
"2948","trowsers",5,6,0,0,11
"2949","tuesday",1,0,0,10,11
"2950","uncommon",6,3,2,0,11
"2951","unfriendly",7,3,1,0,11
"2952","victorious",6,5,0,0,11
"2953","vigilance",4,5,2,0,11
"2954","vigorous",8,3,0,0,11
"2955","virtually",6,4,1,0,11
"2956","votes",10,1,0,0,11
"2957","vow",5,5,1,0,11
"2958","wants",11,0,0,0,11
"2959","watching",6,4,1,0,11
"2960","waves",5,4,1,1,11
"2961","wishing",5,4,2,0,11
"2962","working",9,0,0,2,11
"2963","_a",0,8,2,0,10
"2964","_not_",0,10,0,0,10
"2965","‘",10,0,0,0,10
"2966","1845",0,3,7,0,10
"2967","abundance",4,3,3,0,10
"2968","abundant",5,4,1,0,10
"2969","accompany",8,1,0,1,10
"2970","accord",7,1,2,0,10
"2971","across",9,0,0,1,10
"2972","affairs",8,2,0,0,10
"2973","aged",6,4,0,0,10
"2974","angel",3,7,0,0,10
"2975","appalled",4,4,2,0,10
"2976","applause",6,2,2,0,10
"2977","arose",5,4,1,0,10
"2978","ascertained",4,5,1,0,10
"2979","asking",10,0,0,0,10
"2980","assassination",9,0,0,1,10
"2981","associations",6,3,0,1,10
"2982","attempts",4,5,0,1,10
"2983","attracted",7,2,0,1,10
"2984","aversion",7,3,0,0,10
"2985","awaited",6,4,0,0,10
"2986","awaken",5,5,0,0,10
"2987","awful",1,6,3,0,10
"2988","badly",5,4,1,0,10
"2989","baily",2,8,0,0,10
"2990","bargain",4,4,2,0,10
"2991","beset",4,5,1,0,10
"2992","blast",4,5,1,0,10
"2993","blessing",2,5,3,0,10
"2994","brown’s",10,0,0,0,10
"2995","build",5,2,1,2,10
"2996","busy",9,1,0,0,10
"2997","cairo",0,0,0,10,10
"2998","canaan",5,5,0,0,10
"2999","carolina",9,1,0,0,10
"3000","carriages",2,3,0,5,10
"3001","caste",4,6,0,0,10
"3002","catholic",5,1,1,3,10
"3003","caucasian",6,4,0,0,10
"3004","causes",10,0,0,0,10
"3005","causing",3,2,5,0,10
"3006","center",8,2,0,0,10
"3007","century",9,1,0,0,10
"3008","chained",5,4,1,0,10
"3009","charms",4,5,0,1,10
"3010","child’s",4,5,1,0,10
"3011","christmas",2,4,4,0,10
"3012","clearly",10,0,0,0,10
"3013","clothe",4,6,0,0,10
"3014","cobden",10,0,0,0,10
"3015","companions",5,5,0,0,10
"3016","comparative",5,4,0,1,10
"3017","competition",5,5,0,0,10
"3018","composed",7,2,0,1,10
"3019","conceived",6,4,0,0,10
"3020","condemnation",3,7,0,0,10
"3021","considerations",6,4,0,0,10
"3022","considering",9,0,0,1,10
"3023","contents",4,4,2,0,10
"3024","contradiction",7,1,1,1,10
"3025","controlling",5,5,0,0,10
"3026","convinced",7,3,0,0,10
"3027","copying",3,3,4,0,10
"3028","cotton",7,3,0,0,10
"3029","cowardice",6,3,1,0,10
"3030","creatures",2,6,2,0,10
"3031","creek",3,5,2,0,10
"3032","crushing",4,5,1,0,10
"3033","damage",5,5,0,0,10
"3034","damp",2,3,5,0,10
"3035","dancing",5,3,1,1,10
"3036","david",6,2,2,0,10
"3037","defence",7,0,3,0,10
"3038","delaware",5,4,1,0,10
"3039","delight",2,6,1,1,10
"3040","depend",5,4,1,0,10
"3041","destined",8,2,0,0,10
"3042","destroying",6,4,0,0,10
"3043","development",3,5,2,0,10
"3044","disagreeable",5,4,1,0,10
"3045","discharged",6,4,0,0,10
"3046","distinguish",4,5,1,0,10
"3047","doubtful",6,2,2,0,10
"3048","douglass_",0,1,9,0,10
"3049","douglass”",10,0,0,0,10
"3050","dr",0,10,0,0,10
"3051","draw",4,6,0,0,10
"3052","drinking",4,4,2,0,10
"3053","dry",5,4,1,0,10
"3054","dumb",3,7,0,0,10
"3055","earlier",6,3,1,0,10
"3056","earliest",3,5,2,0,10
"3057","employments",7,3,0,0,10
"3058","encouraging",7,3,0,0,10
"3059","entertain",4,5,1,0,10
"3060","errands",3,3,4,0,10
"3061","estimate",6,2,2,0,10
"3062","exhibited",4,5,0,1,10
"3063","exists",2,7,1,0,10
"3064","explained",6,4,0,0,10
"3065","exposing",5,5,0,0,10
"3066","extension",9,1,0,0,10
"3067","feeble",4,3,3,0,10
"3068","ferocious",5,4,1,0,10
"3069","fishing",5,4,1,0,10
"3070","flashed",2,3,4,1,10
"3071","flourish",5,5,0,0,10
"3072","foot",4,4,2,0,10
"3073","fourteen",5,4,1,0,10
"3074","frame",6,3,1,0,10
"3075","french",8,2,0,0,10
"3076","gallant",5,4,1,0,10
"3077","girls",3,5,1,1,10
"3078","governments",8,2,0,0,10
"3079","grain",3,3,4,0,10
"3080","grandfather",3,6,1,0,10
"3081","grandmother’s",6,4,0,0,10
"3082","graves",9,1,0,0,10
"3083","gross",3,5,2,0,10
"3084","grow",2,6,1,1,10
"3085","halloo",2,4,4,0,10
"3086","hastily",7,2,1,0,10
"3087","hide",3,5,2,0,10
"3088","hilles",10,0,0,0,10
"3089","humiliating",6,4,0,0,10
"3090","humility",6,4,0,0,10
"3091","hunter",6,4,0,0,10
"3092","illustrious",9,1,0,0,10
"3093","impunity",4,4,2,0,10
"3094","inevitable",4,2,4,0,10
"3095","inferred",7,2,1,0,10
"3096","inhuman",4,6,0,0,10
"3097","internal",3,6,0,1,10
"3098","invisible",4,4,2,0,10
"3099","irish",5,5,0,0,10
"3100","jake",3,6,1,0,10
"3101","journal",5,5,0,0,10
"3102","lake",6,2,1,1,10
"3103","lame",4,5,1,0,10
"3104","laugh",6,3,1,0,10
"3105","madness",6,3,1,0,10
"3106","mainly",10,0,0,0,10
"3107","mangled",3,4,3,0,10
"3108","manifest",5,5,0,0,10
"3109","mas",0,10,0,0,10
"3110","mason",3,5,2,0,10
"3111","military",10,0,0,0,10
"3112","mississippi",7,2,1,0,10
"3113","mistaken",6,3,1,0,10
"3114","modern",4,3,0,3,10
"3115","monster",2,7,1,0,10
"3116","multitudes",3,2,4,1,10
"3117","murdered",4,4,2,0,10
"3118","muttering",6,4,0,0,10
"3119","n y",10,0,0,0,10
"3120","nantucket",2,5,3,0,10
"3121","naples",0,0,0,10,10
"3122","narrowly",5,4,1,0,10
"3123","nerve",7,3,0,0,10
"3124","nice",3,4,0,3,10
"3125","noisy",4,4,0,2,10
"3126","nose",4,3,3,0,10
"3127","notes",4,5,1,0,10
"3128","o’connell",10,0,0,0,10
"3129","occurrence",5,3,2,0,10
"3130","offence",4,0,6,0,10
"3131","orators",6,4,0,0,10
"3132","pardon",5,5,0,0,10
"3133","parents",4,5,1,0,10
"3134","parted",10,0,0,0,10
"3135","parting",9,0,0,1,10
"3136","passions",4,6,0,0,10
"3137","per",9,0,0,1,10
"3138","phase",5,5,0,0,10
"3139","pillars",5,2,0,3,10
"3140","pinched",4,6,0,0,10
"3141","pine",5,3,1,1,10
"3142","placing",6,3,1,0,10
"3143","plight",5,5,0,0,10
"3144","plummer",3,5,2,0,10
"3145","poison",4,4,2,0,10
"3146","pomp",5,1,2,2,10
"3147","portrait",8,0,2,0,10
"3148","presentiment",4,6,0,0,10
"3149","pressing",5,3,1,1,10
"3150","pressure",4,4,0,2,10
"3151","prevailed",7,2,1,0,10
"3152","printing",5,5,0,0,10
"3153","proceeding",6,4,0,0,10
"3154","procure",7,3,0,0,10
"3155","professedly",4,4,2,0,10
"3156","propriety",5,4,1,0,10
"3157","raw",4,4,2,0,10
"3158","reckless",3,6,1,0,10
"3159","redress",4,5,1,0,10
"3160","reflection",4,4,2,0,10
"3161","regiments",9,0,1,0,10
"3162","relate",5,5,0,0,10
"3163","relationship",4,4,2,0,10
"3164","release",4,5,1,0,10
"3165","rent",8,2,0,0,10
"3166","report",7,3,0,0,10
"3167","representative",3,6,1,0,10
"3168","request",6,3,1,0,10
"3169","resembled",5,5,0,0,10
"3170","restore",7,3,0,0,10
"3171","reverence",3,4,3,0,10
"3172","revived",7,1,2,0,10
"3173","rigors",5,5,0,0,10
"3174","robbing",5,5,0,0,10
"3175","roots",4,4,2,0,10
"3176","sadness",3,3,4,0,10
"3177","sails",2,3,3,2,10
"3178","sandy’s",5,5,0,0,10
"3179","scarce",3,1,6,0,10
"3180","screams",4,5,1,0,10
"3181","sevier",2,8,0,0,10
"3182","seward",9,1,0,0,10
"3183","shields",9,1,0,0,10
"3184","shunned",3,5,2,0,10
"3185","sign",4,2,0,4,10
"3186","sixteen",4,3,2,1,10
"3187","sizes",5,5,0,0,10
"3188","snatched",4,5,1,0,10
"3189","snow",2,2,2,4,10
"3190","societies",9,1,0,0,10
"3191","solemnity",4,5,1,0,10
"3192","spare",5,4,1,0,10
"3193","spite",4,3,3,0,10
"3194","starboard",3,3,3,1,10
"3195","statesman",9,0,1,0,10
"3196","steadily",4,5,1,0,10
"3197","steamers",5,5,0,0,10
"3198","stillness",3,4,1,2,10
"3199","stirred",5,4,1,0,10
"3200","strict",5,4,1,0,10
"3201","suggestion",7,3,0,0,10
"3202","sundry",5,5,0,0,10
"3203","suspense",6,4,0,0,10
"3204","teachers",5,4,1,0,10
"3205","thanks",10,0,0,0,10
"3206","theory",3,5,2,0,10
"3207","thin",4,5,0,1,10
"3208","tobacco",3,5,2,0,10
"3209","tombs",4,2,0,4,10
"3210","tones",3,4,3,0,10
"3211","torment",3,3,4,0,10
"3212","travelers",5,5,0,0,10
"3213","trickery",4,4,2,0,10
"3214","try",9,0,0,1,10
"3215","undertake",5,3,1,1,10
"3216","venture",1,5,4,0,10
"3217","vessel",7,1,1,1,10
"3218","weary",6,4,0,0,10
"3219","weighed",5,3,2,0,10
"3220","whisper",4,5,1,0,10
"3221","widely",6,3,1,0,10
"3222","wilks",5,5,0,0,10
"3223","winthrop",10,0,0,0,10
"3224","wisely",8,2,0,0,10
"3225","witnesses",3,5,2,0,10
"3226","witnessing",3,6,1,0,10
"3227","woman’s",6,3,1,0,10
"3228","wretch",3,5,2,0,10
"3229","_liberator_",0,9,0,0,9
"3230","“”",9,0,0,0,9
"3231","“well",9,0,0,0,9
"3232","1838",0,3,6,0,9
"3233","abode",5,4,0,0,9
"3234","accepted",9,0,0,0,9
"3235","accused",4,2,3,0,9
"3236","aching",4,3,2,0,9
"3237","adams",7,1,0,1,9
"3238","addresses",6,2,0,1,9
"3239","adoption",7,2,0,0,9
"3240","afflicted",2,4,3,0,9
"3241","aft",3,3,3,0,9
"3242","agency",4,3,2,0,9
"3243","agreeable",5,1,1,2,9
"3244","aimed",3,5,1,0,9
"3245","albany",6,3,0,0,9
"3246","amiable",7,1,0,1,9
"3247","animated",3,4,2,0,9
"3248","answering",4,4,1,0,9
"3249","apprentices",3,4,2,0,9
"3250","approved",5,3,1,0,9
"3251","ardent",4,5,0,0,9
"3252","aristocracy",6,3,0,0,9
"3253","assert",6,1,2,0,9
"3254","asserted",5,4,0,0,9
"3255","atmosphere",7,2,0,0,9
"3256","atrocious",3,5,1,0,9
"3257","attainments",5,3,1,0,9
"3258","attitude",6,3,0,0,9
"3259","baggage",3,3,2,1,9
"3260","balance",5,4,0,0,9
"3261","battles",6,3,0,0,9
"3262","beam",5,3,1,0,9
"3263","bearer",5,2,2,0,9
"3264","beneficent",5,4,0,0,9
"3265","benevolence",4,4,1,0,9
"3266","betray",4,4,1,0,9
"3267","big",9,0,0,0,9
"3268","blanket",4,4,1,0,9
"3269","bless",3,4,2,0,9
"3270","bolt",5,3,1,0,9
"3271","branded",1,8,0,0,9
"3272","breaker",3,3,3,0,9
"3273","burst",1,6,2,0,9
"3274","cabinet",9,0,0,0,9
"3275","candlish",4,5,0,0,9
"3276","cannon",6,3,0,0,9
"3277","centuries",7,1,1,0,9
"3278","closing",5,3,1,0,9
"3279","commanding",4,2,2,1,9
"3280","compelling",4,4,1,0,9
"3281","comprehend",3,5,0,1,9
"3282","comprehensive",8,1,0,0,9
"3283","comrades",3,6,0,0,9
"3284","conception",2,3,3,1,9
"3285","confessed",5,4,0,0,9
"3286","conscious",3,5,1,0,9
"3287","contemplate",5,2,1,1,9
"3288","convicted",2,1,6,0,9
"3289","cooking",4,4,1,0,9
"3290","cordial",6,2,0,1,9
"3291","cordially",6,1,0,2,9
"3292","correspondence",6,3,0,0,9
"3293","counsel",5,3,1,0,9
"3294","courts",5,2,1,1,9
"3295","cutting",2,2,5,0,9
"3296","dawn",6,2,1,0,9
"3297","decide",5,2,2,0,9
"3298","declaration",4,3,2,0,9
"3299","deepen",3,4,2,0,9
"3300","deepest",6,2,1,0,9
"3301","delighted",6,3,0,0,9
"3302","deliverance",2,3,4,0,9
"3303","demon",2,4,3,0,9
"3304","den",3,4,2,0,9
"3305","deny",4,4,1,0,9
"3306","department",8,1,0,0,9
"3307","dependent",6,2,1,0,9
"3308","depth",3,5,1,0,9
"3309","despise",4,3,2,0,9
"3310","disadvantages",5,4,0,0,9
"3311","disappointment",6,3,0,0,9
"3312","disgraceful",4,5,0,0,9
"3313","disgust",3,4,2,0,9
"3314","displayed",6,3,0,0,9
"3315","divinity",4,5,0,0,9
"3316","dixon’s",2,5,2,0,9
"3317","domain",4,4,1,0,9
"3318","dorr",9,0,0,0,9
"3319","drag",2,6,1,0,9
"3320","dreadful",6,2,1,0,9
"3321","easter",3,3,2,1,9
"3322","educational",8,1,0,0,9
"3323","embarrassment",5,3,1,0,9
"3324","emphatic",8,1,0,0,9
"3325","enable",7,2,0,0,9
"3326","endeavored",5,2,1,1,9
"3327","enduring",7,1,0,1,9
"3328","enmity",5,4,0,0,9
"3329","entitled",5,2,2,0,9
"3330","especial",6,3,0,0,9
"3331","exhausted",7,2,0,0,9
"3332","expose",4,5,0,0,9
"3333","extravagant",6,3,0,0,9
"3334","extremity",6,3,0,0,9
"3335","fairbanks",5,2,2,0,9
"3336","faults",3,4,2,0,9
"3337","fertile",4,5,0,0,9
"3338","fewer",3,5,1,0,9
"3339","flowers",7,2,0,0,9
"3340","forehead",5,4,0,0,9
"3341","forgot",5,3,1,0,9
"3342","forts",9,0,0,0,9
"3343","freedman",9,0,0,0,9
"3344","fulfilled",7,1,1,0,9
"3345","generation",8,1,0,0,9
"3346","generously",5,4,0,0,9
"3347","gib",4,5,0,0,9
"3348","gifts",3,5,1,0,9
"3349","grandmamma",3,6,0,0,9
"3350","guests",7,1,0,1,9
"3351","habit",5,3,1,0,9
"3352","hang",5,4,0,0,9
"3353","haste",7,1,1,0,9
"3354","healing",4,5,0,0,9
"3355","heathen",0,4,3,2,9
"3356","heavily",3,3,3,0,9
"3357","hillsborough",3,3,3,0,9
"3358","hinder",3,2,4,0,9
"3359","horn",3,3,3,0,9
"3360","hound",1,8,0,0,9
"3361","humor",6,3,0,0,9
"3362","hunt",6,3,0,0,9
"3363","hunting",2,5,2,0,9
"3364","i’ll",0,5,4,0,9
"3365","iii",5,2,2,0,9
"3366","illustrated",3,5,1,0,9
"3367","impart",5,4,0,0,9
"3368","improve",6,2,1,0,9
"3369","indicated",9,0,0,0,9
"3370","individuality",5,4,0,0,9
"3371","influential",9,0,0,0,9
"3372","innocence",4,4,1,0,9
"3373","intending",5,4,0,0,9
"3374","intolerable",5,4,0,0,9
"3375","inviting",5,3,0,1,9
"3376","involved",5,3,1,0,9
"3377","irons",3,5,1,0,9
"3378","isolation",6,3,0,0,9
"3379","jacket",3,4,2,0,9
"3380","judging",4,5,0,0,9
"3381","lack",6,3,0,0,9
"3382","larboard",3,3,3,0,9
"3383","legitimate",4,4,1,0,9
"3384","lifted",5,4,0,0,9
"3385","limb",4,3,1,1,9
"3386","list",6,3,0,0,9
"3387","logical",6,3,0,0,9
"3388","lone",3,4,2,0,9
"3389","louisiana",6,2,1,0,9
"3390","malign",5,4,0,0,9
"3391","manage",2,4,2,1,9
"3392","marble",7,0,0,2,9
"3393","mastered",5,3,1,0,9
"3394","match",4,4,1,0,9
"3395","measured",5,3,1,0,9
"3396","mile",4,5,0,0,9
"3397","monthly",3,3,3,0,9
"3398","morals",3,4,2,0,9
"3399","mysterious",3,5,1,0,9
"3400","narrated",4,5,0,0,9
"3401","narration",4,4,1,0,9
"3402","nation’s",5,4,0,0,9
"3403","ned",1,4,4,0,9
"3404","occupation",4,5,0,0,9
"3405","onward",4,5,0,0,9
"3406","outraged",3,6,0,0,9
"3407","overseer’s",5,3,1,0,9
"3408","overtaken",3,4,2,0,9
"3409","overthrow",4,3,2,0,9
"3410","oyster",3,5,1,0,9
"3411","oysters",3,5,1,0,9
"3412","pack",5,4,0,0,9
"3413","paying",5,3,1,0,9
"3414","peaceful",7,2,0,0,9
"3415","perish",7,1,0,1,9
"3416","permanent",8,1,0,0,9
"3417","perpetrated",3,3,3,0,9
"3418","persisted",6,3,0,0,9
"3419","persuaded",3,4,2,0,9
"3420","planted",6,3,0,0,9
"3421","plea",5,3,1,0,9
"3422","politics",3,5,0,1,9
"3423","possibility",6,2,1,0,9
"3424","potatoes",4,5,0,0,9
"3425","previously",3,4,2,0,9
"3426","proverb",4,4,1,0,9
"3427","proves",3,5,1,0,9
"3428","purchased",6,3,0,0,9
"3429","rage",4,4,1,0,9
"3430","rare",1,4,3,1,9
"3431","readers",6,3,0,0,9
"3432","reasonable",7,2,0,0,9
"3433","recognize",3,5,1,0,9
"3434","recollections",6,2,1,0,9
"3435","refuge",5,2,2,0,9
"3436","rejected",4,3,2,0,9
"3437","relied",5,3,1,0,9
"3438","reluctant",4,4,1,0,9
"3439","resemblance",4,5,0,0,9
"3440","revolution",5,4,0,0,9
"3441","righteous",3,2,4,0,9
"3442","robber",3,4,2,0,9
"3443","saddened",3,3,3,0,9
"3444","sang",5,3,1,0,9
"3445","scuffle",3,3,3,0,9
"3446","sept",0,0,0,9,9
"3447","september",4,3,2,0,9
"3448","shades",5,3,1,0,9
"3449","shocked",5,3,1,0,9
"3450","shook",5,2,2,0,9
"3451","shooting",5,3,1,0,9
"3452","sins",3,6,0,0,9
"3453","slender",5,4,0,0,9
"3454","slept",4,5,0,0,9
"3455","slow",5,3,1,0,9
"3456","smiles",3,5,1,0,9
"3457","smooth",5,1,1,2,9
"3458","snatch",2,4,3,0,9
"3459","sorts",5,3,0,1,9
"3460","spelling",1,6,2,0,9
"3461","square",6,1,0,2,9
"3462","stagger",2,4,3,0,9
"3463","stead",4,5,0,0,9
"3464","steel",5,4,0,0,9
"3465","sterling",4,5,0,0,9
"3466","sternly",5,4,0,0,9
"3467","stewart",3,5,1,0,9
"3468","stream",1,3,2,3,9
"3469","strengthen",7,2,0,0,9
"3470","struggled",3,4,2,0,9
"3471","stumps",4,4,1,0,9
"3472","subjects",5,3,0,1,9
"3473","submitted",5,2,2,0,9
"3474","subsequent",7,1,1,0,9
"3475","substantial",7,2,0,0,9
"3476","supporting",3,5,1,0,9
"3477","suppressed",6,2,1,0,9
"3478","surprising",7,1,1,0,9
"3479","swallow",1,3,4,1,9
"3480","swine",2,6,1,0,9
"3481","tedious",5,3,1,0,9
"3482","tells",2,6,0,1,9
"3483","territories",9,0,0,0,9
"3484","test",5,4,0,0,9
"3485","thither",5,2,2,0,9
"3486","tolerably",7,2,0,0,9
"3487","tom’s",8,1,0,0,9
"3488","touch",5,2,0,2,9
"3489","tow",1,7,1,0,9
"3490","treason",8,1,0,0,9
"3491","trusted",7,2,0,0,9
"3492","tying",3,4,2,0,9
"3493","universal",5,2,2,0,9
"3494","university",9,0,0,0,9
"3495","unsafe",2,3,4,0,9
"3496","urge",7,1,1,0,9
"3497","usually",9,0,0,0,9
"3498","uttered",7,2,0,0,9
"3499","valley",4,1,1,3,9
"3500","valuation",2,3,4,0,9
"3501","volumes",5,2,1,1,9
"3502","ward",7,1,0,1,9
"3503","washing",2,3,3,1,9
"3504","watson",5,3,1,0,9
"3505","weeden",0,6,3,0,9
"3506","willingly",4,4,1,0,9
"3507","win",5,4,0,0,9
"3508","windows",5,3,1,0,9
"3509","wonders",4,2,0,3,9
"3510","wooden",4,4,1,0,9
"3511","workmen",4,3,1,1,9
"3512","yellow",6,2,1,0,9
"3513","_as",0,8,0,0,8
"3514","“go",8,0,0,0,8
"3515","1835",0,4,4,0,8
"3516","abandon",3,4,1,0,8
"3517","abby",8,0,0,0,8
"3518","accommodation",4,4,0,0,8
"3519","accompanied",5,2,1,0,8
"3520","accomplishment",4,2,1,1,8
"3521","accordance",3,5,0,0,8
"3522","achievements",5,3,0,0,8
"3523","acres",4,3,0,1,8
"3524","acts",5,3,0,0,8
"3525","actual",3,4,1,0,8
"3526","adding",4,4,0,0,8
"3527","affair",4,1,3,0,8
"3528","affect",2,2,4,0,8
"3529","affections",2,6,0,0,8
"3530","aggressive",8,0,0,0,8
"3531","alarmed",7,1,0,0,8
"3532","alluded",3,4,1,0,8
"3533","amendment",8,0,0,0,8
"3534","anderson",7,0,0,1,8
"3535","animal",4,3,0,1,8
"3536","annexation",8,0,0,0,8
"3537","anywhere",7,0,0,1,8
"3538","apart",8,0,0,0,8
"3539","appalling",2,3,3,0,8
"3540","appealing",3,5,0,0,8
"3541","appeals",5,2,1,0,8
"3542","appear",7,0,0,1,8
"3543","aristocratic",6,2,0,0,8
"3544","arrested",6,1,1,0,8
"3545","assemblage",4,2,0,2,8
"3546","assented",5,3,0,0,8
"3547","asserting",5,3,0,0,8
"3548","assigned",5,3,0,0,8
"3549","assisting",7,1,0,0,8
"3550","astonishment",4,3,1,0,8
"3551","asunder",5,3,0,0,8
"3552","attacks",4,3,1,0,8
"3553","attractions",4,1,0,3,8
"3554","authorities",3,5,0,0,8
"3555","balsam",3,5,0,0,8
"3556","banner",6,1,1,0,8
"3557","beheld",2,3,2,1,8
"3558","bell",5,0,2,1,8
"3559","beneficial",3,5,0,0,8
"3560","betrayer",3,3,2,0,8
"3561","bewildered",5,3,0,0,8
"3562","blind",4,3,1,0,8
"3563","bondley",4,4,0,0,8
"3564","bondmen",2,6,0,0,8
"3565","brand",2,5,1,0,8
"3566","brass",2,6,0,0,8
"3567","brings",4,3,1,0,8
"3568","bruised",3,5,0,0,8
"3569","bushel",1,4,3,0,8
"3570","canvass",7,0,0,1,8
"3571","caution",4,4,0,0,8
"3572","ceremonies",6,1,0,1,8
"3573","chimney",3,3,2,0,8
"3574","clark",7,0,0,1,8
"3575","clothed",3,4,1,0,8
"3576","coldest",3,2,3,0,8
"3577","colleges",8,0,0,0,8
"3578","committees",6,2,0,0,8
"3579","communication",5,2,1,0,8
"3580","comprehension",4,2,1,1,8
"3581","conceive",2,3,2,1,8
"3582","conductors",1,5,2,0,8
"3583","confession",5,3,0,0,8
"3584","confirmed",5,3,0,0,8
"3585","constitutional",6,2,0,0,8
"3586","contemptible",4,4,0,0,8
"3587","costly",3,1,0,4,8
"3588","counting",4,3,1,0,8
"3589","countries",5,3,0,0,8
"3590","covering",2,3,3,0,8
"3591","crawl",2,3,3,0,8
"3592","creditable",5,2,1,0,8
"3593","creed",3,4,0,1,8
"3594","cripple",5,2,1,0,8
"3595","cultivated",4,2,2,0,8
"3596","cure",3,5,0,0,8
"3597","cursed",4,3,1,0,8
"3598","customs",3,4,0,1,8
"3599","cutter",8,0,0,0,8
"3600","davis",6,0,0,2,8
"3601","deceived",4,2,2,0,8
"3602","decidedly",4,2,2,0,8
"3603","declare",4,4,0,0,8
"3604","demby",0,1,7,0,8
"3605","demonstration",5,2,1,0,8
"3606","denial",6,2,0,0,8
"3607","denouncing",5,3,0,0,8
"3608","denying",4,4,0,0,8
"3609","desirous",6,1,1,0,8
"3610","desperation",4,3,1,0,8
"3611","differences",6,1,1,0,8
"3612","discipline",3,4,1,0,8
"3613","disgusting",3,5,0,0,8
"3614","dismemberment",8,0,0,0,8
"3615","disregarded",3,4,1,0,8
"3616","dissipation",2,3,3,0,8
"3617","distinctions",5,3,0,0,8
"3618","distress",5,3,0,0,8
"3619","doctrines",6,1,0,1,8
"3620","dog",3,5,0,0,8
"3621","dominion",4,4,0,0,8
"3622","douglass’",8,0,0,0,8
"3623","duly",7,1,0,0,8
"3624","eighty",3,4,1,0,8
"3625","emergency",7,1,0,0,8
"3626","emotion",4,2,2,0,8
"3627","enactment",2,6,0,0,8
"3628","encourage",3,3,2,0,8
"3629","encouragement",4,3,1,0,8
"3630","endeavor",6,2,0,0,8
"3631","engage",2,5,1,0,8
"3632","enslave",4,3,1,0,8
"3633","entrance",4,3,1,0,8
"3634","exercises",2,5,1,0,8
"3635","exerted",5,3,0,0,8
"3636","expenses",4,2,2,0,8
"3637","experiences",5,3,0,0,8
"3638","fancied",5,3,0,0,8
"3639","father’s",4,1,3,0,8
"3640","federal",8,0,0,0,8
"3641","fellows",2,5,1,0,8
"3642","finds",7,0,0,1,8
"3643","finely",3,3,2,0,8
"3644","fitting",6,1,1,0,8
"3645","follows",8,0,0,0,8
"3646","folly",6,2,0,0,8
"3647","forbidding",4,4,0,0,8
"3648","forest",3,4,1,0,8
"3649","fort",7,0,0,1,8
"3650","fourth",2,6,0,0,8
"3651","framed",7,1,0,0,8
"3652","france",5,2,0,1,8
"3653","freed",6,2,0,0,8
"3654","freedmen’s",8,0,0,0,8
"3655","frost",3,4,1,0,8
"3656","galling",3,3,2,0,8
"3657","gaze",1,6,1,0,8
"3658","glaring",1,5,2,0,8
"3659","gleam",4,4,0,0,8
"3660","god’s",3,4,1,0,8
"3661","goes",7,0,0,1,8
"3662","golden",6,2,0,0,8
"3663","greeley",7,1,0,0,8
"3664","grim",2,4,2,0,8
"3665","groundless",6,2,0,0,8
"3666","happiest",3,4,1,0,8
"3667","harmony",4,4,0,0,8
"3668","hays",4,4,0,0,8
"3669","hearth",2,4,2,0,8
"3670","heavens",4,3,0,1,8
"3671","heights",4,0,0,4,8
"3672","helping",3,2,3,0,8
"3673","hero",5,3,0,0,8
"3674","hoe",1,4,1,2,8
"3675","hopeless",2,4,2,0,8
"3676","hostile",6,2,0,0,8
"3677","hottest",2,3,3,0,8
"3678","hypocrisy",2,5,1,0,8
"3679","immediate",8,0,0,0,8
"3680","implied",4,4,0,0,8
"3681","inches",4,3,1,0,8
"3682","indolent",4,4,0,0,8
"3683","infliction",3,4,0,1,8
"3684","inhumanity",1,4,3,0,8
"3685","instigator",4,4,0,0,8
"3686","jenkins",3,3,2,0,8
"3687","journals",5,3,0,0,8
"3688","jury",6,2,0,0,8
"3689","kelley",8,0,0,0,8
"3690","king",1,4,1,2,8
"3691","kneel",3,3,2,0,8
"3692","knocked",2,4,2,0,8
"3693","lad",4,4,0,0,8
"3694","lean",5,2,1,0,8
"3695","lectures",7,1,0,0,8
"3696","liable",2,2,4,0,8
"3697","lift",6,2,0,0,8
"3698","limited",6,2,0,0,8
"3699","lincoln’s",8,0,0,0,8
"3700","loaded",3,3,1,1,8
"3701","looks",7,0,0,1,8
"3702","luck",1,5,0,2,8
"3703","magic",4,4,0,0,8
"3704","man”",8,0,0,0,8
"3705","manifestation",2,3,3,0,8
"3706","marvelous",3,5,0,0,8
"3707","mastery",4,4,0,0,8
"3708","maxim",1,4,3,0,8
"3709","meanest",2,2,4,0,8
"3710","mending",2,4,2,0,8
"3711","merry",1,6,0,1,8
"3712","missiles",4,3,1,0,8
"3713","mobbed",7,1,0,0,8
"3714","model",4,3,1,0,8
"3715","moses",4,1,0,3,8
"3716","mush",3,4,1,0,8
"3717","mysteries",3,5,0,0,8
"3718","neglected",3,4,1,0,8
"3719","noblest",6,1,1,0,8
"3720","noticed",4,3,0,1,8
"3721","oaths",3,2,3,0,8
"3722","occupy",5,3,0,0,8
"3723","odds",6,1,1,0,8
"3724","oppose",3,4,0,1,8
"3725","oppressor",2,4,2,0,8
"3726","organization",6,2,0,0,8
"3727","painfully",5,3,0,0,8
"3728","pamphlet",3,5,0,0,8
"3729","partial",4,3,1,0,8
"3730","peculiarly",3,3,2,0,8
"3731","penalty",3,3,2,0,8
"3732","perry",5,3,0,0,8
"3733","persecution",4,3,1,0,8
"3734","perseverance",4,2,2,0,8
"3735","personally",6,2,0,0,8
"3736","piled",5,3,0,0,8
"3737","planting",2,5,1,0,8
"3738","played",2,6,0,0,8
"3739","possessing",3,4,1,0,8
"3740","powerfully",3,3,1,1,8
"3741","praying",2,5,1,0,8
"3742","preference",3,5,0,0,8
"3743","preparation",6,2,0,0,8
"3744","preservation",4,3,1,0,8
"3745","preserved",6,0,1,1,8
"3746","professed",5,2,1,0,8
"3747","proslavery",8,0,0,0,8
"3748","prudence",2,4,2,0,8
"3749","publication",5,3,0,0,8
"3750","publicly",5,3,0,0,8
"3751","punishing",4,3,1,0,8
"3752","range",4,3,0,1,8
"3753","rascal",3,5,0,0,8
"3754","recruiting",7,0,1,0,8
"3755","regiment",8,0,0,0,8
"3756","reluctantly",3,3,2,0,8
"3757","remind",2,4,1,1,8
"3758","reminding",3,3,1,1,8
"3759","removing",5,2,1,0,8
"3760","repeatedly",6,2,0,0,8
"3761","republicans",6,2,0,0,8
"3762","repulsive",4,4,0,0,8
"3763","restless",3,3,2,0,8
"3764","retained",5,3,0,0,8
"3765","rivalry",4,4,0,0,8
"3766","route",3,3,2,0,8
"3767","sabbathschool",8,0,0,0,8
"3768","salvation",4,3,1,0,8
"3769","sank",3,2,3,0,8
"3770","science",5,1,0,2,8
"3771","scoundrel",3,5,0,0,8
"3772","scriptures",3,5,0,0,8
"3773","seeming",8,0,0,0,8
"3774","sensitive",3,4,1,0,8
"3775","sermon",4,2,0,2,8
"3776","shirts",2,3,3,0,8
"3777","situated",2,2,1,3,8
"3778","size",2,4,2,0,8
"3779","smoke",1,0,1,6,8
"3780","socalled",8,0,0,0,8
"3781","solitary",4,3,0,1,8
"3782","speaks",1,5,0,2,8
"3783","species",5,3,0,0,8
"3784","specimen",2,4,2,0,8
"3785","speedy",4,2,1,1,8
"3786","stanton",7,0,0,1,8
"3787","starvation",4,3,1,0,8
"3788","starving",4,4,0,0,8
"3789","stearns",8,0,0,0,8
"3790","stepped",3,4,1,0,8
"3791","sting",3,3,2,0,8
"3792","stockings",2,3,3,0,8
"3793","strengthened",5,3,0,0,8
"3794","stunned",4,3,1,0,8
"3795","stupendous",5,1,0,2,8
"3796","submission",5,3,0,0,8
"3797","succor",3,4,1,0,8
"3798","suit",4,2,2,0,8
"3799","sunbeams",3,3,1,1,8
"3800","sundays",3,2,3,0,8
"3801","supporters",4,4,0,0,8
"3802","surname",3,5,0,0,8
"3803","talent",4,3,0,1,8
"3804","tents",4,4,0,0,8
"3805","testimonial",4,3,1,0,8
"3806","theology",6,2,0,0,8
"3807","thereafter",8,0,0,0,8
"3808","third",8,0,0,0,8
"3809","thread",2,5,0,1,8
"3810","thursday",0,0,0,8,8
"3811","tide",4,4,0,0,8
"3812","top",3,1,0,4,8
"3813","tore",4,3,1,0,8
"3814","tormentor",2,6,0,0,8
"3815","tormentors",2,5,1,0,8
"3816","traits",3,1,3,1,8
"3817","transformed",4,3,1,0,8
"3818","treating",4,3,1,0,8
"3819","tribute",6,2,0,0,8
"3820","trodden",2,4,2,0,8
"3821","tumult",7,1,0,0,8
"3822","tyranny",2,6,0,0,8
"3823","uncultivated",4,3,1,0,8
"3824","underground",5,2,0,1,8
"3825","undertook",3,3,2,0,8
"3826","unfrequently",5,3,0,0,8
"3827","unhappily",5,3,0,0,8
"3828","unloading",3,3,2,0,8
"3829","unmanageable",2,2,4,0,8
"3830","unsuccessful",5,3,0,0,8
"3831","unusually",4,4,0,0,8
"3832","unutterable",2,2,4,0,8
"3833","unwilling",4,4,0,0,8
"3834","usage",5,3,0,0,8
"3835","utterances",8,0,0,0,8
"3836","vanity",4,4,0,0,8
"3837","viewing",2,3,1,2,8
"3838","vii",4,2,2,0,8
"3839","viii",4,2,2,0,8
"3840","vividly",4,3,1,0,8
"3841","waiters",6,2,0,0,8
"3842","walks",6,2,0,0,8
"3843","waste",4,1,0,3,8
"3844","wayland",3,0,0,5,8
"3845","weakness",3,5,0,0,8
"3846","wealthy",4,4,0,0,8
"3847","wednesday",0,0,0,8,8
"3848","weekly",6,1,1,0,8
"3849","wept",3,5,0,0,8
"3850","whaling",5,3,0,0,8
"3851","wheel",4,3,1,0,8
"3852","whig",5,3,0,0,8
"3853","whirlwind",7,1,0,0,8
"3854","window",5,2,1,0,8
"3855","wing",2,3,2,1,8
"3856","withal",5,3,0,0,8
"3857","writer",7,0,1,0,8
"3858","yesterday",3,2,0,3,8
"3859","_columbian",0,7,0,0,7
"3860","_we",0,7,0,0,7
"3861","“yes",7,0,0,0,7
"3862","abilities",3,4,0,0,7
"3863","ablest",6,1,0,0,7
"3864","abuses",3,4,0,0,7
"3865","accursed",1,5,1,0,7
"3866","addressing",4,2,1,0,7
"3867","adorned",4,2,0,1,7
"3868","adverse",5,2,0,0,7
"3869","advocated",6,1,0,0,7
"3870","aims",4,3,0,0,7
"3871","altar",2,4,1,0,7
"3872","ancient",0,1,1,5,7
"3873","anna",2,1,4,0,7
"3874","answers",3,4,0,0,7
"3875","anybody",6,0,0,1,7
"3876","applaud",3,3,1,0,7
"3877","apply",5,1,1,0,7
"3878","applying",2,5,0,0,7
"3879","argued",2,3,2,0,7
"3880","arise",4,3,0,0,7
"3881","arising",4,3,0,0,7
"3882","arraigned",4,2,1,0,7
"3883","arrangements",3,3,0,1,7
"3884","artificial",5,2,0,0,7
"3885","asa",7,0,0,0,7
"3886","ash",0,7,0,0,7
"3887","assaults",3,3,1,0,7
"3888","assistant",7,0,0,0,7
"3889","association",4,1,1,1,7
"3890","atlantic",4,2,1,0,7
"3891","authorized",4,3,0,0,7
"3892","availed",4,1,2,0,7
"3893","avenue",2,3,1,1,7
"3894","averse",3,4,0,0,7
"3895","awake",3,2,0,2,7
"3896","bar",3,4,0,0,7
"3897","barbarism",6,1,0,0,7
"3898","bears",2,5,0,0,7
"3899","beecher",6,1,0,0,7
"3900","beef",3,2,2,0,7
"3901","behaved",4,2,1,0,7
"3902","blacksmith’s",4,2,1,0,7
"3903","blame",5,2,0,0,7
"3904","blasphemy",2,4,1,0,7
"3905","blasted",2,5,0,0,7
"3906","blowing",2,2,1,2,7
"3907","boiling",3,3,1,0,7
"3908","boots",6,1,0,0,7
"3909","boundless",5,2,0,0,7
"3910","bow",2,2,0,3,7
"3911","breathed",3,2,2,0,7
"3912","bull",3,3,1,0,7
"3913","burdens",3,2,2,0,7
"3914","burnt",3,2,1,1,7
"3915","butter",4,3,0,0,7
"3916","calmly",4,2,0,1,7
"3917","can’t",3,3,1,0,7
"3918","caprice",2,5,0,0,7
"3919","captured",7,0,0,0,7
"3920","carpenter",6,1,0,0,7
"3921","catching",3,3,1,0,7
"3922","cautiously",4,3,0,0,7
"3923","celebrated",2,3,1,1,7
"3924","central",5,2,0,0,7
"3925","charity",5,2,0,0,7
"3926","charmed",4,3,0,0,7
"3927","chattels",3,4,0,0,7
"3928","cheek",2,4,1,0,7
"3929","circles",3,4,0,0,7
"3930","circulation",5,2,0,0,7
"3931","cleveland",7,0,0,0,7
"3932","clifford",2,5,0,0,7
"3933","colonization",5,2,0,0,7
"3934","commend",5,1,0,1,7
"3935","commerce",4,2,0,1,7
"3936","concealed",3,3,0,1,7
"3937","concealment",4,3,0,0,7
"3938","conciliation",4,2,1,0,7
"3939","confided",4,2,1,0,7
"3940","conform",4,2,1,0,7
"3941","consultation",2,3,2,0,7
"3942","consulted",3,2,2,0,7
"3943","consumed",1,4,2,0,7
"3944","contemplating",3,3,0,1,7
"3945","continuance",2,4,1,0,7
"3946","coöperation",7,0,0,0,7
"3947","correct",3,3,1,0,7
"3948","cox",3,4,0,0,7
"3949","crossing",3,1,1,2,7
"3950","cultivation",4,2,1,0,7
"3951","cup",2,3,2,0,7
"3952","damning",1,6,0,0,7
"3953","debt",5,1,1,0,7
"3954","deliberately",1,5,1,0,7
"3955","democrat",6,1,0,0,7
"3956","deplorable",0,6,1,0,7
"3957","deportment",3,4,0,0,7
"3958","describing",1,5,1,0,7
"3959","desert",2,3,0,2,7
"3960","deserved",3,3,1,0,7
"3961","devices",5,2,0,0,7
"3962","devouring",2,5,0,0,7
"3963","dignified",6,1,0,0,7
"3964","dining",3,2,0,2,7
"3965","dirt",4,2,1,0,7
"3966","dirty",2,2,3,0,7
"3967","discharge",3,3,1,0,7
"3968","displeasure",4,3,0,0,7
"3969","dispose",5,2,0,0,7
"3970","distressed",4,2,1,0,7
"3971","documents",4,1,2,0,7
"3972","dragging",3,4,0,0,7
"3973","driver’s",2,3,2,0,7
"3974","eagerly",3,4,0,0,7
"3975","earn",5,2,0,0,7
"3976","edinburgh",4,3,0,0,7
"3977","edited",4,3,0,0,7
"3978","efficient",4,2,1,0,7
"3979","egyptian",0,1,0,6,7
"3980","eighteen",4,2,0,1,7
"3981","elder",5,1,0,1,7
"3982","elected",6,1,0,0,7
"3983","elegant",6,1,0,0,7
"3984","embarrass",2,3,2,0,7
"3985","eminence",4,3,0,0,7
"3986","emotions",2,3,2,0,7
"3987","employer",5,1,1,0,7
"3988","enacted",2,4,1,0,7
"3989","endowments",4,3,0,0,7
"3990","enforce",5,2,0,0,7
"3991","enjoyment",3,3,1,0,7
"3992","establishing",5,2,0,0,7
"3993","estimation",4,3,0,0,7
"3994","exchanged",5,2,0,0,7
"3995","exclusion",7,0,0,0,7
"3996","exclusively",4,3,0,0,7
"3997","exertion",3,4,0,0,7
"3998","exhibit",3,3,0,1,7
"3999","experiment",6,0,1,0,7
"4000","extensive",3,2,1,1,7
"4001","faces",5,0,0,2,7
"4002","faculties",1,6,0,0,7
"4003","faculty",3,2,2,0,7
"4004","faint",3,2,2,0,7
"4005","familiar",4,2,1,0,7
"4006","fellowcitizens",7,0,0,0,7
"4007","fellowmen",5,1,1,0,7
"4008","fifteenth",7,0,0,0,7
"4009","filling",4,3,0,0,7
"4010","fireplace",3,3,1,0,7
"4011","fires",2,5,0,0,7
"4012","fitness",5,2,0,0,7
"4013","flag",6,1,0,0,7
"4014","flash",3,3,1,0,7
"4015","flock",2,4,1,0,7
"4016","flog",3,4,0,0,7
"4017","flying",2,3,2,0,7
"4018","forbade",3,2,2,0,7
"4019","foreman",3,3,1,0,7
"4020","founded",4,2,0,1,7
"4021","fullness",7,0,0,0,7
"4022","game",4,3,0,0,7
"4023","gardner’s",0,0,7,0,7
"4024","garrisonians",2,5,0,0,7
"4025","generations",5,2,0,0,7
"4026","gladness",4,3,0,0,7
"4027","graham",3,2,2,0,7
"4028","grains",3,4,0,0,7
"4029","grapple",4,3,0,0,7
"4030","grossest",1,1,5,0,7
"4031","growth",1,5,0,1,7
"4032","guard",5,1,1,0,7
"4033","guarded",4,3,0,0,7
"4034","guilt",3,4,0,0,7
"4035","hanson",3,4,0,0,7
"4036","harder",3,1,3,0,7
"4037","harshly",4,3,0,0,7
"4038","hat",3,3,1,0,7
"4039","healthy",4,3,0,0,7
"4040","hearers",5,2,0,0,7
"4041","heirs",3,4,0,0,7
"4042","heroes",6,1,0,0,7
"4043","hidden",3,3,0,1,7
"4044","honestly",3,4,0,0,7
"4045","horace",7,0,0,0,7
"4046","horseback",2,4,1,0,7
"4047","hudson",7,0,0,0,7
"4048","hurled",5,2,0,0,7
"4049","ills",3,2,2,0,7
"4050","imagination",3,1,3,0,7
"4051","imparted",4,3,0,0,7
"4052","impartial",5,1,1,0,7
"4053","inattention",3,3,1,0,7
"4054","incapable",3,3,1,0,7
"4055","including",6,1,0,0,7
"4056","inconsistent",4,2,1,0,7
"4057","indignant",5,1,1,0,7
"4058","indispensable",1,1,5,0,7
"4059","individuals",7,0,0,0,7
"4060","inevitably",6,1,0,0,7
"4061","infancy",2,3,2,0,7
"4062","infant",2,4,1,0,7
"4063","inferiority",4,2,1,0,7
"4064","infinite",5,2,0,0,7
"4065","inform",3,4,0,0,7
"4066","injured",4,3,0,0,7
"4067","injuring",3,4,0,0,7
"4068","inquire",2,5,0,0,7
"4069","insecurity",3,3,1,0,7
"4070","insight",3,3,1,0,7
"4071","interference",4,3,0,0,7
"4072","interposed",4,2,1,0,7
"4073","intimation",4,2,1,0,7
"4074","introducing",4,3,0,0,7
"4075","investigation",3,2,2,0,7
"4076","irishmen",3,3,1,0,7
"4077","irresponsible",2,3,2,0,7
"4078","isolated",3,4,0,0,7
"4079","issued",4,2,1,0,7
"4080","jaws",1,3,3,0,7
"4081","joined",4,2,1,0,7
"4082","kingdom",3,3,1,0,7
"4083","lamb",4,2,1,0,7
"4084","lasting",4,3,0,0,7
"4085","laughed",3,3,1,0,7
"4086","lawyers",6,1,0,0,7
"4087","laying",4,3,0,0,7
"4088","leather",6,1,0,0,7
"4089","lee",7,0,0,0,7
"4090","liabilities",3,2,2,0,7
"4091","liberties",5,2,0,0,7
"4092","life_",0,6,1,0,7
"4093","lightly",4,3,0,0,7
"4094","likelihoods",4,3,0,0,7
"4095","lingered",4,2,1,0,7
"4096","lions",1,3,3,0,7
"4097","listener",4,1,1,1,7
"4098","local",4,3,0,0,7
"4099","locality",5,2,0,0,7
"4100","locks",3,3,0,1,7
"4101","loft",3,2,2,0,7
"4102","lord’s",2,5,0,0,7
"4103","loudly",2,1,3,1,7
"4104","luxuries",3,2,1,1,7
"4105","magistrate",5,2,0,0,7
"4106","magnificent",3,3,0,1,7
"4107","malicious",4,3,0,0,7
"4108","marshals",7,0,0,0,7
"4109","martin",5,0,1,1,7
"4110","marvelously",4,3,0,0,7
"4111","masterclass",7,0,0,0,7
"4112","men”",7,0,0,0,7
"4113","merciful",2,3,2,0,7
"4114","mills",3,3,0,1,7
"4115","misfortune",4,3,0,0,7
"4116","moderate",6,1,0,0,7
"4117","modes",6,1,0,0,7
"4118","mostly",7,0,0,0,7
"4119","mutually",2,3,2,0,7
"4120","nathaniel",5,2,0,0,7
"4121","neglect",3,2,2,0,7
"4122","nobody",7,0,0,0,7
"4123","norris",7,0,0,0,7
"4124","noted",6,1,0,0,7
"4125","nurse",3,4,0,0,7
"4126","obedient",4,2,1,0,7
"4127","offensive",5,2,0,0,7
"4128","one’s",3,4,0,0,7
"4129","opening",5,0,0,2,7
"4130","opponents",5,2,0,0,7
"4131","organized",5,1,1,0,7
"4132","overcome",2,2,3,0,7
"4133","particulars",4,3,0,0,7
"4134","passenger",5,2,0,0,7
"4135","patiently",4,3,0,0,7
"4136","peaceable",5,1,1,0,7
"4137","penetrate",3,4,0,0,7
"4138","perils",4,2,1,0,7
"4139","perished",4,2,1,0,7
"4140","picked",4,2,1,0,7
"4141","plantations",2,4,1,0,7
"4142","poet",4,2,1,0,7
"4143","pointed",7,0,0,0,7
"4144","porter",7,0,0,0,7
"4145","possibilities",5,1,0,1,7
"4146","precaution",3,3,1,0,7
"4147","predicted",4,1,2,0,7
"4148","preparing",2,2,2,1,7
"4149","proceedings",5,2,0,0,7
"4150","professing",4,1,2,0,7
"4151","proportion",3,1,2,1,7
"4152","protections",2,2,3,0,7
"4153","protestant",2,3,0,2,7
"4154","provide",4,3,0,0,7
"4155","pursuing",3,2,2,0,7
"4156","quit",5,2,0,0,7
"4157","radical",5,2,0,0,7
"4158","realized",6,1,0,0,7
"4159","recognizing",6,1,0,0,7
"4160","refer",5,2,0,0,7
"4161","reference",4,2,1,0,7
"4162","refined",4,3,0,0,7
"4163","reflecting",3,3,1,0,7
"4164","region",3,2,1,1,7
"4165","repentance",2,5,0,0,7
"4166","reported",5,1,1,0,7
"4167","requisition",6,1,0,0,7
"4168","residing",4,2,1,0,7
"4169","resisting",3,4,0,0,7
"4170","resolute",4,3,0,0,7
"4171","respectability",4,3,0,0,7
"4172","restraint",2,5,0,0,7
"4173","resulting",2,4,1,0,7
"4174","revenge",4,3,0,0,7
"4175","revenue",6,1,0,0,7
"4176","reverse",2,3,1,1,7
"4177","richly",2,2,1,2,7
"4178","risen",4,2,0,1,7
"4179","robbery",4,2,1,0,7
"4180","rolled",3,3,0,1,7
"4181","rolling",3,2,1,1,7
"4182","rudely",4,3,0,0,7
"4183","ruined",2,4,1,0,7
"4184","ruins",0,0,0,7,7
"4185","rulers",5,1,1,0,7
"4186","runs",2,3,1,1,7
"4187","sacrifice",6,0,1,0,7
"4188","sail",3,1,2,1,7
"4189","sailed",2,1,2,2,7
"4190","saints",1,2,2,2,7
"4191","salary",5,1,0,1,7
"4192","saloon",3,3,0,1,7
"4193","salt",3,4,0,0,7
"4194","sarah",4,2,0,1,7
"4195","says",7,0,0,0,7
"4196","scourge",5,2,0,0,7
"4197","scream",2,3,2,0,7
"4198","secession",7,0,0,0,7
"4199","securing",2,4,1,0,7
"4200","selection",5,1,1,0,7
"4201","selling",3,3,0,1,7
"4202","separating",4,2,1,0,7
"4203","servility",4,2,1,0,7
"4204","setting",2,2,3,0,7
"4205","settlement",5,2,0,0,7
"4206","shattered",3,2,1,1,7
"4207","sights",2,4,0,1,7
"4208","simplicity",2,3,2,0,7
"4209","sir”",7,0,0,0,7
"4210","slaughter",5,2,0,0,7
"4211","slave_",0,7,0,0,7
"4212","soldier",7,0,0,0,7
"4213","sole",4,2,1,0,7
"4214","somebody",7,0,0,0,7
"4215","song",3,3,1,0,7
"4216","sophia",4,2,1,0,7
"4217","stake",2,4,1,0,7
"4218","steady",3,3,0,1,7
"4219","stolen",2,3,2,0,7
"4220","stones",3,1,2,1,7
"4221","stormy",5,2,0,0,7
"4222","strife",7,0,0,0,7
"4223","studied",3,4,0,0,7
"4224","subsided",3,3,1,0,7
"4225","suggest",1,3,2,1,7
"4226","sundown",3,4,0,0,7
"4227","sung",2,4,1,0,7
"4228","sunk",3,3,1,0,7
"4229","supposing",3,3,0,1,7
"4230","supposition",5,1,1,0,7
"4231","surpassed",3,2,1,1,7
"4232","surround",3,3,1,0,7
"4233","surrounding",4,2,0,1,7
"4234","suspect",2,4,1,0,7
"4235","swamps",3,3,1,0,7
"4236","swarm",3,2,1,1,7
"4237","syracuse",7,0,0,0,7
"4238","telegraph",6,1,0,0,7
"4239","temporal",3,4,0,0,7
"4240","tempted",3,3,1,0,7
"4241","thereof",2,4,1,0,7
"4242","thoroughly",7,0,0,0,7
"4243","threatening",4,1,2,0,7
"4244","throng",3,2,1,1,7
"4245","thumb",1,5,1,0,7
"4246","ticket",4,2,0,1,7
"4247","tidings",2,3,1,1,7
"4248","tilled",1,2,2,2,7
"4249","treasured",3,4,0,0,7
"4250","treasures",2,2,1,2,7
"4251","tricks",3,4,0,0,7
"4252","triumphant",5,2,0,0,7
"4253","trough",3,2,2,0,7
"4254","trying",6,0,0,1,7
"4255","tyrant’s",4,3,0,0,7
"4256","unceasing",4,3,0,0,7
"4257","unconscious",4,2,1,0,7
"4258","undersigned",5,1,1,0,7
"4259","undertaken",5,2,0,0,7
"4260","unfortunate",5,1,1,0,7
"4261","universe",3,2,1,1,7
"4262","unnecessary",4,2,1,0,7
"4263","unto",7,0,0,0,7
"4264","uttering",2,2,3,0,7
"4265","venice",0,0,0,7,7
"4266","vice",2,3,1,1,7
"4267","vicissitudes",4,3,0,0,7
"4268","vigorously",5,2,0,0,7
"4269","vile",4,3,0,0,7
"4270","vivid",2,3,1,1,7
"4271","warmly",4,2,1,0,7
"4272","wasted",3,3,1,0,7
"4273","webster’s",3,3,1,0,7
"4274","whippings",2,3,2,0,7
"4275","wings",3,3,1,0,7
"4276","withhold",5,2,0,0,7
"4277","wives",1,5,1,0,7
"4278","year’s",3,2,2,0,7
"4279","yonder",2,3,2,0,7
"4280","zeal",7,0,0,0,7
"4281","_life",0,5,1,0,6
"4282","_mr",0,0,6,0,6
"4283","_no",0,6,0,0,6
"4284","_slavery_",0,6,0,0,6
"4285","_who_",0,6,0,0,6
"4286","’s",6,0,0,0,6
"4287","“free",6,0,0,0,6
"4288","“let",6,0,0,0,6
"4289","“mr",6,0,0,0,6
"4290","“uncle”",6,0,0,0,6
"4291","1",0,3,3,0,6
"4292","1833",0,3,3,0,6
"4293","1834",0,4,2,0,6
"4294","1836",0,6,0,0,6
"4295","1841",0,3,3,0,6
"4296","abandoned",5,1,0,0,6
"4297","abhorred",2,3,1,0,6
"4298","abject",4,2,0,0,6
"4299","abolish",5,1,0,0,6
"4300","accumulating",2,3,1,0,6
"4301","adjudged",4,1,1,0,6
"4302","adversity",3,3,0,0,6
"4303","advertisements",1,5,0,0,6
"4304","advised",4,0,2,0,6
"4305","advocacy",5,1,0,0,6
"4306","affecting",3,2,1,0,6
"4307","affords",2,3,0,1,6
"4308","ague",2,3,1,0,6
"4309","alexander",5,1,0,0,6
"4310","allies",2,3,1,0,6
"4311","allotted",3,3,0,0,6
"4312","allowing",2,3,1,0,6
"4313","amusement",1,3,0,2,6
"4314","annapolis",3,1,2,0,6
"4315","anniversary",4,2,0,0,6
"4316","announcing",5,1,0,0,6
"4317","anthony’s",4,2,0,0,6
"4318","appears",3,2,1,0,6
"4319","arriving",2,4,0,0,6
"4320","asleep",2,3,1,0,6
"4321","assets",6,0,0,0,6
"4322","assigns",2,4,0,0,6
"4323","associates",3,3,0,0,6
"4324","assurances",5,1,0,0,6
"4325","assure",5,1,0,0,6
"4326","attempting",3,3,0,0,6
"4327","attraction",1,4,1,0,6
"4328","attributed",2,2,2,0,6
"4329","authors",2,4,0,0,6
"4330","awakening",2,4,0,0,6
"4331","awkwardness",3,2,1,0,6
"4332","baby",2,2,2,0,6
"4333","backs",5,0,0,1,6
"4334","ballot",6,0,0,0,6
"4335","barefooted",3,0,2,1,6
"4336","bassett",6,0,0,0,6
"4337","beams",3,3,0,0,6
"4338","begging",3,0,1,2,6
"4339","bellows",5,0,0,1,6
"4340","benefactor",3,2,1,0,6
"4341","benefactors",5,1,0,0,6
"4342","betsey",3,2,1,0,6
"4343","binding",4,1,1,0,6
"4344","birthright",3,3,0,0,6
"4345","blaze",2,4,0,0,6
"4346","boasting",2,4,0,0,6
"4347","boldness",3,3,0,0,6
"4348","bone",2,4,0,0,6
"4349","boot",2,2,2,0,6
"4350","box",2,3,1,0,6
"4351","boyish",1,5,0,0,6
"4352","bradburn",6,0,0,0,6
"4353","breadth",3,3,0,0,6
"4354","breckenridge",6,0,0,0,6
"4355","brighter",4,2,0,0,6
"4356","broader",3,3,0,0,6
"4357","burial",3,2,1,0,6
"4358","calhoun",4,2,0,0,6
"4359","calk",2,2,2,0,6
"4360","campaign",6,0,0,0,6
"4361","campmeeting",6,0,0,0,6
"4362","capitol",5,1,0,0,6
"4363","captain’s",5,1,0,0,6
"4364","casks",3,2,1,0,6
"4365","cat",1,4,1,0,6
"4366","cathedral",0,0,0,6,6
"4367","censure",2,4,0,0,6
"4368","chalmers",3,3,0,0,6
"4369","charleston",6,0,0,0,6
"4370","charm",1,4,0,1,6
"4371","charming",3,1,0,2,6
"4372","cheering",2,3,1,0,6
"4373","cherish",4,1,1,0,6
"4374","chill",3,2,1,0,6
"4375","chilling",2,4,0,0,6
"4376","christiana",6,0,0,0,6
"4377","clad",3,2,0,1,6
"4378","clever",1,3,1,1,6
"4379","closet",3,2,1,0,6
"4380","coarseness",3,3,0,0,6
"4381","columbian",5,0,1,0,6
"4382","comic",2,4,0,0,6
"4383","commencement",3,1,2,0,6
"4384","committing",3,3,0,0,6
"4385","complacency",5,1,0,0,6
"4386","complied",6,0,0,0,6
"4387","comply",2,2,1,1,6
"4388","condemn",3,3,0,0,6
"4389","confederate",6,0,0,0,6
"4390","confiding",4,2,0,0,6
"4391","congregation",1,5,0,0,6
"4392","conquered",3,2,1,0,6
"4393","consider",6,0,0,0,6
"4394","constable",2,1,3,0,6
"4395","constitute",2,4,0,0,6
"4396","contained",4,1,1,0,6
"4397","contradict",5,1,0,0,6
"4398","contributed",4,2,0,0,6
"4399","convenient",3,3,0,0,6
"4400","coolness",1,3,2,0,6
"4401","count",3,2,1,0,6
"4402","counter",4,2,0,0,6
"4403","cradle",3,1,2,0,6
"4404","craft",1,3,2,0,6
"4405","crowned",2,2,1,1,6
"4406","cruelly",3,2,1,0,6
"4407","crying",2,1,3,0,6
"4408","culture",0,6,0,0,6
"4409","cursing",2,3,1,0,6
"4410","dank",2,2,2,0,6
"4411","darken",2,1,2,1,6
"4412","darker",2,1,2,1,6
"4413","darkest",1,3,2,0,6
"4414","darted",3,3,0,0,6
"4415","dawning",3,3,0,0,6
"4416","daybreak",3,3,0,0,6
"4417","daylight",3,2,1,0,6
"4418","december",2,4,0,0,6
"4419","defenders",3,3,0,0,6
"4420","deficiencies",3,3,0,0,6
"4421","deficient",5,1,0,0,6
"4422","degrees",3,2,1,0,6
"4423","delegation",6,0,0,0,6
"4424","delivery",5,1,0,0,6
"4425","demanding",4,2,0,0,6
"4426","depressed",3,2,1,0,6
"4427","derision",2,4,0,0,6
"4428","descent",5,0,1,0,6
"4429","desk",4,2,0,0,6
"4430","destructive",2,3,1,0,6
"4431","dictionary",2,3,1,0,6
"4432","diligently",2,2,2,0,6
"4433","dimensions",3,2,1,0,6
"4434","dine",3,2,0,1,6
"4435","disappeared",5,1,0,0,6
"4436","discontented",3,2,1,0,6
"4437","discussed",5,1,0,0,6
"4438","dispel",3,3,0,0,6
"4439","disturbing",3,3,0,0,6
"4440","dome",4,1,0,1,6
"4441","dose",2,2,2,0,6
"4442","downing",6,0,0,0,6
"4443","draft",6,0,0,0,6
"4444","dress",2,2,1,1,6
"4445","dwell",2,4,0,0,6
"4446","dwelling",1,4,0,1,6
"4447","eating",2,4,0,0,6
"4448","editorial",3,3,0,0,6
"4449","effected",5,0,1,0,6
"4450","elegantly",4,1,0,1,6
"4451","elevate",3,3,0,0,6
"4452","eleven",3,2,1,0,6
"4453","eliza",1,4,1,0,6
"4454","ell",1,4,1,0,6
"4455","embers",1,3,2,0,6
"4456","embrace",2,2,2,0,6
"4457","endless",3,3,0,0,6
"4458","enforcement",2,3,1,0,6
"4459","engagement",3,0,3,0,6
"4460","englishman",3,2,0,1,6
"4461","enlightenment",5,0,1,0,6
"4462","enlist",5,1,0,0,6
"4463","enormous",1,2,2,1,6
"4464","entangled",3,2,1,0,6
"4465","epithets",4,2,0,0,6
"4466","equals",2,2,1,1,6
"4467","esq",3,1,2,0,6
"4468","exciting",5,1,0,0,6
"4469","exclamation",3,3,0,0,6
"4470","exercised",4,2,0,0,6
"4471","exhort",3,3,0,0,6
"4472","expectation",2,3,0,1,6
"4473","expecting",3,1,1,1,6
"4474","expired",4,1,1,0,6
"4475","exposition",3,3,0,0,6
"4476","expressive",4,2,0,0,6
"4477","extending",3,3,0,0,6
"4478","extremely",4,2,0,0,6
"4479","fat",3,3,0,0,6
"4480","fervent",3,3,0,0,6
"4481","fierceness",2,1,3,0,6
"4482","firstclass",6,0,0,0,6
"4483","fishermen",2,3,1,0,6
"4484","flee",5,1,0,0,6
"4485","fletcher",0,0,0,6,6
"4486","flew",3,2,1,0,6
"4487","foes",4,1,1,0,6
"4488","footed",0,4,1,1,6
"4489","formal",5,1,0,0,6
"4490","fourteenth",6,0,0,0,6
"4491","fowls",1,4,1,0,6
"4492","frauds",0,2,4,0,6
"4493","freedom’s",2,3,1,0,6
"4494","friendless",3,3,0,0,6
"4495","frown",4,2,0,0,6
"4496","fullest",2,4,0,0,6
"4497","fund",3,3,0,0,6
"4498","gale",2,3,1,0,6
"4499","gardener",3,1,2,0,6
"4500","gardens",0,0,1,5,6
"4501","gashes",3,2,1,0,6
"4502","gentlemanly",4,2,0,0,6
"4503","geography",2,4,0,0,6
"4504","gift",5,0,1,0,6
"4505","gigantic",4,2,0,0,6
"4506","goaded",3,2,1,0,6
"4507","gorgeous",2,3,0,1,6
"4508","grandly",4,0,0,2,6
"4509","gratified",4,1,1,0,6
"4510","gratify",3,2,1,0,6
"4511","grip",3,2,0,1,6
"4512","guest",4,1,0,1,6
"4513","guide",2,3,0,1,6
"4514","hail",2,3,1,0,6
"4515","halls",3,1,0,2,6
"4516","happen",2,4,0,0,6
"4517","hardy",4,1,1,0,6
"4518","harry",2,4,0,0,6
"4519","heartless",2,4,0,0,6
"4520","heel",3,2,1,0,6
"4521","helplessness",2,3,1,0,6
"4522","herb",3,3,0,0,6
"4523","hereafter",6,0,0,0,6
"4524","hideous",1,2,3,0,6
"4525","highways",2,3,1,0,6
"4526","hook",1,2,2,1,6
"4527","hopeful",4,2,0,0,6
"4528","horizon",3,2,0,1,6
"4529","host",3,3,0,0,6
"4530","hotels",5,1,0,0,6
"4531","howard",6,0,0,0,6
"4532","hushed",2,3,1,0,6
"4533","hymn",1,2,3,0,6
"4534","hypocrites",1,1,4,0,6
"4535","illness",1,3,1,1,6
"4536","illustrations",2,3,1,0,6
"4537","imprisonment",4,2,0,0,6
"4538","impudent",3,2,1,0,6
"4539","incendiary",2,4,0,0,6
"4540","incredible",3,3,0,0,6
"4541","indies",6,0,0,0,6
"4542","individually",2,4,0,0,6
"4543","industrial",6,0,0,0,6
"4544","inestimable",3,3,0,0,6
"4545","informing",2,2,2,0,6
"4546","inherited",4,2,0,0,6
"4547","initiated",3,3,0,0,6
"4548","injure",2,3,1,0,6
"4549","inmates",1,3,1,1,6
"4550","innocently",2,4,0,0,6
"4551","inquiries",1,3,2,0,6
"4552","insolent",4,2,0,0,6
"4553","instructed",4,1,1,0,6
"4554","instructive",4,2,0,0,6
"4555","intemperance",3,3,0,0,6
"4556","introduce",4,2,0,0,6
"4557","invincible",2,3,1,0,6
"4558","irishman",2,3,1,0,6
"4559","irreligious",3,2,1,0,6
"4560","issues",2,4,0,0,6
"4561","jim",2,4,0,0,6
"4562","jones",5,1,0,0,6
"4563","joyful",3,2,1,0,6
"4564","joys",2,4,0,0,6
"4565","keenly",3,3,0,0,6
"4566","kemp",3,3,0,0,6
"4567","key",4,2,0,0,6
"4568","kicked",2,3,1,0,6
"4569","kindhearted",6,0,0,0,6
"4570","knee",2,3,0,1,6
"4571","lands",2,2,1,1,6
"4572","lately",6,0,0,0,6
"4573","latent",3,3,0,0,6
"4574","latitude",4,1,0,1,6
"4575","laziness",3,3,0,0,6
"4576","leads",2,4,0,0,6
"4577","leap",2,3,1,0,6
"4578","lectured",3,2,0,1,6
"4579","legislature",2,4,0,0,6
"4580","liberated",5,1,0,0,6
"4581","library",1,1,1,3,6
"4582","lingering",2,3,1,0,6
"4583","livelihood",4,2,0,0,6
"4584","lively",2,3,1,0,6
"4585","loaned",4,1,0,1,6
"4586","loathing",2,2,2,0,6
"4587","lofty",4,0,1,1,6
"4588","lowest",1,3,2,0,6
"4589","lucretia’s",3,3,0,0,6
"4590","maintenance",4,2,0,0,6
"4591","majestic",3,2,0,1,6
"4592","manifested",2,3,1,0,6
"4593","master”",6,0,0,0,6
"4594","meanwhile",6,0,0,0,6
"4595","mechanical",2,2,1,1,6
"4596","medicine",4,2,0,0,6
"4597","merchant",4,1,0,1,6
"4598","million",4,2,0,0,6
"4599","minded",1,2,3,0,6
"4600","minute",2,1,3,0,6
"4601","misunderstanding",2,2,2,0,6
"4602","mitchell",4,2,0,0,6
"4603","mobocratic",5,1,0,0,6
"4604","mockery",3,3,0,0,6
"4605","mourners",3,3,0,0,6
"4606","mournful",3,2,0,1,6
"4607","mud",1,4,1,0,6
"4608","murderers",5,0,1,0,6
"4609","nakedness",2,2,2,0,6
"4610","nearest",2,2,2,0,6
"4611","neatly",2,2,1,1,6
"4612","necessities",2,3,1,0,6
"4613","nobly",3,2,0,1,6
"4614","noon",1,1,2,2,6
"4615","november",5,1,0,0,6
"4616","oak",1,3,2,0,6
"4617","obdurate",0,3,3,0,6
"4618","official",5,1,0,0,6
"4619","oration",2,4,0,0,6
"4620","orator_",0,6,0,0,6
"4621","orders",6,0,0,0,6
"4622","ostler",3,3,0,0,6
"4623","outcast",1,1,4,0,6
"4624","overwhelmed",3,2,1,0,6
"4625","ox”",6,0,0,0,6
"4626","pace",2,4,0,0,6
"4627","packed",3,2,0,1,6
"4628","paradise",2,3,1,0,6
"4629","parent",3,2,1,0,6
"4630","parliament",5,1,0,0,6
"4631","parlor",2,4,0,0,6
"4632","participate",4,1,1,0,6
"4633","participation",3,2,1,0,6
"4634","pavements",4,2,0,0,6
"4635","peaceably",2,3,1,0,6
"4636","peculiarities",1,5,0,0,6
"4637","pecuniary",5,1,0,0,6
"4638","peel",6,0,0,0,6
"4639","pennington",2,2,2,0,6
"4640","perpetual",4,1,1,0,6
"4641","persevering",2,2,2,0,6
"4642","piercing",2,3,0,1,6
"4643","pitied",3,3,0,0,6
"4644","pitt",2,4,0,0,6
"4645","planning",1,2,2,1,6
"4646","playmates",3,3,0,0,6
"4647","plot",4,2,0,0,6
"4648","popes",0,0,0,6,6
"4649","preëminently",6,0,0,0,6
"4650","preferences",3,3,0,0,6
"4651","preferring",2,4,0,0,6
"4652","premises",3,2,1,0,6
"4653","preparatory",4,2,0,0,6
"4654","presume",2,3,1,0,6
"4655","presumed",5,1,0,0,6
"4656","presumption",4,2,0,0,6
"4657","pretended",2,3,1,0,6
"4658","prevented",1,3,2,0,6
"4659","primary",3,3,0,0,6
"4660","prior",3,0,3,0,6
"4661","pro",0,6,0,0,6
"4662","process",2,4,0,0,6
"4663","proclaimed",4,2,0,0,6
"4664","pronounced",5,1,0,0,6
"4665","prophecy",4,1,1,0,6
"4666","proscribed",3,3,0,0,6
"4667","publish",4,1,1,0,6
"4668","pupils",4,2,0,0,6
"4669","quaker",5,1,0,0,6
"4670","qualification",5,1,0,0,6
"4671","quantity",2,3,1,0,6
"4672","queen",2,2,0,2,6
"4673","quote",2,3,1,0,6
"4674","rational",3,2,0,1,6
"4675","rear",4,1,0,1,6
"4676","reared",2,4,0,0,6
"4677","reciprocal",3,3,0,0,6
"4678","recollection",3,2,1,0,6
"4679","record",4,1,1,0,6
"4680","recorded",0,4,2,0,6
"4681","reduce",4,1,1,0,6
"4682","reform",3,2,1,0,6
"4683","regarding",6,0,0,0,6
"4684","regrets",2,3,0,1,6
"4685","regulations",3,3,0,0,6
"4686","remembering",5,1,0,0,6
"4687","rendering",6,0,0,0,6
"4688","renewed",4,2,0,0,6
"4689","representing",4,2,0,0,6
"4690","requirements",4,2,0,0,6
"4691","requiring",2,3,1,0,6
"4692","rescue",5,1,0,0,6
"4693","resolve",2,4,0,0,6
"4694","respectful",5,1,0,0,6
"4695","response",3,1,2,0,6
"4696","resulted",3,2,1,0,6
"4697","retain",5,1,0,0,6
"4698","revivals",1,1,4,0,6
"4699","revolutionary",2,2,2,0,6
"4700","rigby",1,3,2,0,6
"4701","rigor",3,3,0,0,6
"4702","roasting",3,3,0,0,6
"4703","robbers",2,3,1,0,6
"4704","rocks",2,1,0,3,6
"4705","rowena",2,3,1,0,6
"4706","ruling",4,2,0,0,6
"4707","savings",6,0,0,0,6
"4708","sayings",4,2,0,0,6
"4709","scarred",2,3,1,0,6
"4710","sealed",3,3,0,0,6
"4711","searching",1,4,0,1,6
"4712","secluded",3,3,0,0,6
"4713","secrets",3,3,0,0,6
"4714","securely",4,2,0,0,6
"4715","seize",2,2,2,0,6
"4716","selfrespect",6,0,0,0,6
"4717","sentence",2,2,1,1,6
"4718","servile",3,2,1,0,6
"4719","servitude",4,2,0,0,6
"4720","settle",4,2,0,0,6
"4721","seventeen",1,4,1,0,6
"4722","sex",4,1,1,0,6
"4723","shaped",2,2,0,2,6
"4724","shapes",2,2,1,1,6
"4725","shining",2,3,1,0,6
"4726","shops",3,3,0,0,6
"4727","shortest",3,2,1,0,6
"4728","shouted",5,0,1,0,6
"4729","shouts",3,2,1,0,6
"4730","showing",5,0,0,1,6
"4731","shows",6,0,0,0,6
"4732","significance",5,1,0,0,6
"4733","silly",3,3,0,0,6
"4734","simultaneously",4,2,0,0,6
"4735","slavemaster",4,2,0,0,6
"4736","slavery_",0,6,0,0,6
"4737","slavery”",6,0,0,0,6
"4738","slowly",4,1,0,1,6
"4739","smiled",2,2,2,0,6
"4740","smitten",2,4,0,0,6
"4741","snakish",2,4,0,0,6
"4742","solicited",5,1,0,0,6
"4743","soliciting",4,2,0,0,6
"4744","somber",3,3,0,0,6
"4745","somewhere",6,0,0,0,6
"4746","sore",3,2,1,0,6
"4747","sounded",5,1,0,0,6
"4748","soundly",3,3,0,0,6
"4749","sovereignty",6,0,0,0,6
"4750","splended",0,0,0,6,6
"4751","springs",2,4,0,0,6
"4752","spy",3,3,0,0,6
"4753","stables",3,3,0,0,6
"4754","staggering",3,3,0,0,6
"4755","stalwart",5,1,0,0,6
"4756","stations",3,3,0,0,6
"4757","statuary",1,1,0,4,6
"4758","steamboat",3,2,1,0,6
"4759","sternness",3,3,0,0,6
"4760","stool",2,2,2,0,6
"4761","strain",3,0,3,0,6
"4762","stricken",2,2,2,0,6
"4763","stroke",1,1,4,0,6
"4764","subscribers",3,3,0,0,6
"4765","sunlight",2,2,0,2,6
"4766","sunny",4,2,0,0,6
"4767","sunrise",2,2,2,0,6
"4768","superiors",3,2,1,0,6
"4769","surrender",6,0,0,0,6
"4770","surroundings",5,0,0,1,6
"4771","sweeping",3,3,0,0,6
"4772","swift",3,2,1,0,6
"4773","swim",2,3,1,0,6
"4774","switches",3,1,2,0,6
"4775","sympathies",1,4,1,0,6
"4776","sympathizing",2,4,0,0,6
"4777","talking",2,2,1,1,6
"4778","tame",3,2,1,0,6
"4779","tax",5,0,0,1,6
"4780","tearing",0,4,2,0,6
"4781","they’ll",0,0,6,0,6
"4782","thief",2,1,3,0,6
"4783","thirteen",2,4,0,0,6
"4784","thorns",3,2,0,1,6
"4785","threaten",1,2,2,1,6
"4786","thrill",3,1,2,0,6
"4787","thrilled",3,3,0,0,6
"4788","thrilling",4,0,2,0,6
"4789","throne",3,3,0,0,6
"4790","thunder",2,3,1,0,6
"4791","thy",1,2,3,0,6
"4792","timidity",3,3,0,0,6
"4793","tomb",2,2,1,1,6
"4794","tomorrow",0,1,0,5,6
"4795","totally",2,2,2,0,6
"4796","towering",3,2,0,1,6
"4797","traffickers",3,3,0,0,6
"4798","trains",3,3,0,0,6
"4799","treachery",4,2,0,0,6
"4800","tremble",1,4,1,0,6
"4801","trembled",2,2,2,0,6
"4802","trifle",4,1,1,0,6
"4803","triumphed",4,2,0,0,6
"4804","trousers",0,0,6,0,6
"4805","trustees",6,0,0,0,6
"4806","truthful",2,3,1,0,6
"4807","tub",3,2,1,0,6
"4808","tyrants",2,3,1,0,6
"4809","ultimate",5,1,0,0,6
"4810","ultimately",6,0,0,0,6
"4811","unbroken",3,2,1,0,6
"4812","uncertainty",3,3,0,0,6
"4813","unending",2,3,1,0,6
"4814","unfit",2,3,1,0,6
"4815","unfortunately",5,0,0,1,6
"4816","uniform",5,1,0,0,6
"4817","unpopular",5,1,0,0,6
"4818","uphold",3,3,0,0,6
"4819","upper",4,2,0,0,6
"4820","useless",4,2,0,0,6
"4821","vanquished",4,2,0,0,6
"4822","variety",4,2,0,0,6
"4823","vexed",4,2,0,0,6
"4824","vicepresident",6,0,0,0,6
"4825","violation",3,3,0,0,6
"4826","vital",3,3,0,0,6
"4827","vocal",4,2,0,0,6
"4828","waked",3,2,1,0,6
"4829","walled",1,2,1,2,6
"4830","walter",3,2,1,0,6
"4831","wandering",4,2,0,0,6
"4832","warn",0,5,1,0,6
"4833","warned",4,1,1,0,6
"4834","wavering",3,3,0,0,6
"4835","ways",5,0,0,1,6
"4836","weapons",3,3,0,0,6
"4837","wearing",3,2,0,1,6
"4838","weathers",2,3,1,0,6
"4839","welcomed",4,1,0,1,6
"4840","whereof",3,3,0,0,6
"4841","withdrew",4,2,0,0,6
"4842","woldfolk",3,3,0,0,6
"4843","wonderfully",3,1,1,1,6
"4844","wondrous",3,2,0,1,6
"4845","workers",4,2,0,0,6
"4846","xii",4,2,0,0,6
"4847","xiii",4,2,0,0,6
"4848","xiv",4,2,0,0,6
"4849","xix",4,2,0,0,6
"4850","xvi",4,2,0,0,6
"4851","xvii",4,2,0,0,6
"4852","xviii",4,2,0,0,6
"4853","yards",2,3,1,0,6
"4854","yearly",2,2,2,0,6
"4855","younger",6,0,0,0,6
"4856","youthful",1,4,1,0,6
"4857","_free_",0,5,0,0,5
"4858","_in",0,5,0,0,5
"4859","_man_",0,4,1,0,5
"4860","_master_",0,5,0,0,5
"4861","_my",0,4,1,0,5
"4862","_possible_",0,5,0,0,5
"4863","_they_",0,4,1,0,5
"4864","_to",0,5,0,0,5
"4865","’",5,0,0,0,5
"4866","“good",5,0,0,0,5
"4867","“now",5,0,0,0,5
"4868","“selfmade",5,0,0,0,5
"4869","“send",5,0,0,0,5
"4870","“take",5,0,0,0,5
"4871","1850",0,5,0,0,5
"4872","1855",0,4,1,0,5
"4873","2",0,3,2,0,5
"4874","5",0,5,0,0,5
"4875","abolishing",2,2,1,0,5
"4876","abolitionism",2,2,1,0,5
"4877","abounding",3,1,0,1,5
"4878","abundantly",3,2,0,0,5
"4879","accomplishing",2,2,1,0,5
"4880","accosted",2,3,0,0,5
"4881","accounts",3,2,0,0,5
"4882","accuser",3,2,0,0,5
"4883","aches",2,2,1,0,5
"4884","achievement",3,1,1,0,5
"4885","actions",1,1,3,0,5
"4886","actuary",5,0,0,0,5
"4887","administer",3,1,1,0,5
"4888","administered",3,2,0,0,5
"4889","admirably",2,2,1,0,5
"4890","advisedly",2,2,1,0,5
"4891","affirm",2,2,1,0,5
"4892","afresh",2,2,1,0,5
"4893","ahead",1,1,3,0,5
"4894","aiding",1,2,2,0,5
"4895","airs",1,1,3,0,5
"4896","alphabet",2,2,1,0,5
"4897","alternative",2,2,1,0,5
"4898","amalgamation",3,2,0,0,5
"4899","amazement",2,3,0,0,5
"4900","amendments",5,0,0,0,5
"4901","amply",2,3,0,0,5
"4902","amusing",3,2,0,0,5
"4903","anger",2,2,1,0,5
"4904","annihilate",1,3,1,0,5
"4905","anthonys",4,1,0,0,5
"4906","anticipate",2,3,0,0,5
"4907","apparel",2,3,0,0,5
"4908","appendix",2,1,2,0,5
"4909","appetite",2,3,0,0,5
"4910","appreciation",5,0,0,0,5
"4911","aptitude",3,2,0,0,5
"4912","architectural",1,1,0,3,5
"4913","arlington",5,0,0,0,5
"4914","array",2,2,1,0,5
"4915","arresting",2,3,0,0,5
"4916","artful",1,1,3,0,5
"4917","artfully",2,2,1,0,5
"4918","articles",3,2,0,0,5
"4919","ashcake",5,0,0,0,5
"4920","assaulted",3,2,0,0,5
"4921","assertion",4,0,1,0,5
"4922","attach",2,3,0,0,5
"4923","attain",2,2,1,0,5
"4924","attentions",3,2,0,0,5
"4925","attribute",3,2,0,0,5
"4926","auctioneer’s",0,4,1,0,5
"4927","augustus",2,1,2,0,5
"4928","auspices",3,1,1,0,5
"4929","awaiting",2,2,0,1,5
"4930","awhile",1,2,2,0,5
"4931","babe",1,3,0,1,5
"4932","bald",2,2,1,0,5
"4933","balls",3,2,0,0,5
"4934","battered",3,2,0,0,5
"4935","beg",3,2,0,0,5
"4936","bending",2,2,1,0,5
"4937","benignant",2,3,0,0,5
"4938","betook",2,1,0,2,5
"4939","bird",2,3,0,0,5
"4940","birthday",3,0,2,0,5
"4941","bitterly",4,1,0,0,5
"4942","blacksmith",4,1,0,0,5
"4943","blades",2,1,2,0,5
"4944","blank",2,3,0,0,5
"4945","blessed",2,2,1,0,5
"4946","blindness",2,2,1,0,5
"4947","bloodshed",4,1,0,0,5
"4948","blotted",1,3,1,0,5
"4949","bonney",0,5,0,0,5
"4950","borrowed",3,2,0,0,5
"4951","bosoms",2,2,1,0,5
"4952","bounds",2,3,0,0,5
"4953","brain",3,2,0,0,5
"4954","breathe",2,3,0,0,5
"4955","breathing",3,2,0,0,5
"4956","briers",2,2,1,0,5
"4957","brotherly",3,2,0,0,5
"4958","brutalizing",1,3,1,0,5
"4959","bullet",4,1,0,0,5
"4960","buying",2,2,1,0,5
"4961","cabins",3,2,0,0,5
"4962","calker",1,3,1,0,5
"4963","campground",5,0,0,0,5
"4964","canal",1,0,0,4,5
"4965","candidate",4,1,0,0,5
"4966","candidates",5,0,0,0,5
"4967","captors",3,2,0,0,5
"4968","cares",2,3,0,0,5
"4969","castigation",3,2,0,0,5
"4970","ceaseless",3,1,1,0,5
"4971","chairman",4,1,0,0,5
"4972","characterize",1,4,0,0,5
"4973","characterized",2,2,1,0,5
"4974","charges",2,3,0,0,5
"4975","chased",2,2,1,0,5
"4976","chastisement",1,4,0,0,5
"4977","check",3,1,1,0,5
"4978","cheer",3,1,1,0,5
"4979","cheered",4,1,0,0,5
"4980","chiefly",4,1,0,0,5
"4981","cholera",2,3,0,0,5
"4982","choose",2,2,1,0,5
"4983","circuit",2,3,0,0,5
"4984","citizenship",5,0,0,0,5
"4985","clamor",4,1,0,0,5
"4986","climate",2,1,0,2,5
"4987","cloth",1,3,1,0,5
"4988","clotted",1,1,3,0,5
"4989","collars",2,2,1,0,5
"4990","column",3,1,0,1,5
"4991","combination",2,2,1,0,5
"4992","combine",2,1,2,0,5
"4993","comer",3,2,0,0,5
"4994","commissioners",5,0,0,0,5
"4995","commonest",2,3,0,0,5
"4996","compare",2,2,1,0,5
"4997","comparison",1,2,1,1,5
"4998","compassion",2,3,0,0,5
"4999","competitors",2,2,1,0,5
"5000","complain",3,2,0,0,5
"5001","complaining",2,3,0,0,5
"5002","compliance",2,1,2,0,5
"5003","compliment",5,0,0,0,5
"5004","comprehended",3,2,0,0,5
"5005","confirmation",4,1,0,0,5
"5006","congratulate",4,0,0,1,5
"5007","connections",3,1,1,0,5
"5008","conscientious",3,2,0,0,5
"5009","consistent",3,2,0,0,5
"5010","consolation",1,3,1,0,5
"5011","consoling",2,3,0,0,5
"5012","conspicuous",4,0,1,0,5
"5013","consternation",3,2,0,0,5
"5014","contended",2,3,0,0,5
"5015","continually",1,2,2,0,5
"5016","continues",0,3,1,1,5
"5017","contribute",2,3,0,0,5
"5018","controversy",3,2,0,0,5
"5019","conversations",3,2,0,0,5
"5020","convert",2,2,0,1,5
"5021","convey",2,2,1,0,5
"5022","coolly",3,1,0,1,5
"5023","correctness",2,2,1,0,5
"5024","corrupt",0,3,2,0,5
"5025","counted",4,1,0,0,5
"5026","courageous",5,0,0,0,5
"5027","coward",3,2,0,0,5
"5028","cows",2,2,1,0,5
"5029","crawled",2,2,1,0,5
"5030","criminal",3,2,0,0,5
"5031","crippled",3,2,0,0,5
"5032","crisis",5,0,0,0,5
"5033","crow",1,4,0,0,5
"5034","crowds",2,1,0,2,5
"5035","crush",2,3,0,0,5
"5036","cuff",2,3,0,0,5
"5037","cunard",2,3,0,0,5
"5038","curb",1,2,1,1,5
"5039","damned",1,1,3,0,5
"5040","dash",1,2,2,0,5
"5041","dawned",3,2,0,0,5
"5042","days’",5,0,0,0,5
"5043","dearest",1,2,2,0,5
"5044","decay",1,2,0,2,5
"5045","deceiving",1,1,3,0,5
"5046","decency",1,3,1,0,5
"5047","declarations",0,3,2,0,5
"5048","decline",2,1,0,2,5
"5049","defective",5,0,0,0,5
"5050","defender",3,1,1,0,5
"5051","defending",4,1,0,0,5
"5052","defensive",4,1,0,0,5
"5053","defiant",3,2,0,0,5
"5054","delayed",5,0,0,0,5
"5055","deliberate",3,2,0,0,5
"5056","demonstrated",2,2,1,0,5
"5057","dense",1,2,2,0,5
"5058","depart",5,0,0,0,5
"5059","departing",2,3,0,0,5
"5060","depositors",5,0,0,0,5
"5061","depravity",2,1,2,0,5
"5062","descend",1,3,1,0,5
"5063","deserted",4,1,0,0,5
"5064","desolation",2,3,0,0,5
"5065","detect",1,2,2,0,5
"5066","detestable",3,2,0,0,5
"5067","detested",2,3,0,0,5
"5068","develop",2,3,0,0,5
"5069","device",4,1,0,0,5
"5070","devising",3,0,2,0,5
"5071","devotional",1,2,2,0,5
"5072","devotions",2,2,1,0,5
"5073","dies",0,3,2,0,5
"5074","differing",1,3,0,1,5
"5075","dined",1,1,1,2,5
"5076","disappear",4,0,1,0,5
"5077","disasters",4,1,0,0,5
"5078","disastrously",3,2,0,0,5
"5079","disconsolate",3,2,0,0,5
"5080","disparagement",3,2,0,0,5
"5081","dissatisfied",2,2,1,0,5
"5082","divest",3,1,1,0,5
"5083","dividing",2,3,0,0,5
"5084","divines",2,3,0,0,5
"5085","dizziness",2,2,1,0,5
"5086","domicile",2,3,0,0,5
"5087","donkeys",0,0,0,5,5
"5088","doom",2,2,1,0,5
"5089","dorsey",5,0,0,0,5
"5090","drunkenness",1,4,0,0,5
"5091","dublin",2,2,1,0,5
"5092","dug",3,2,0,0,5
"5093","duration",3,1,1,0,5
"5094","eagle",3,1,0,1,5
"5095","easiest",3,2,0,0,5
"5096","edmund",2,1,0,2,5
"5097","educate",3,2,0,0,5
"5098","efficiency",5,0,0,0,5
"5099","elastic",1,4,0,0,5
"5100","elasticity",2,2,1,0,5
"5101","elect",5,0,0,0,5
"5102","electric",3,2,0,0,5
"5103","emphasis",3,2,0,0,5
"5104","empty",4,1,0,0,5
"5105","encounter",3,2,0,0,5
"5106","endeavors",2,1,1,1,5
"5107","enfranchised",5,0,0,0,5
"5108","englishmen",2,3,0,0,5
"5109","enlistments",5,0,0,0,5
"5110","enormity",2,3,0,0,5
"5111","enraged",1,1,3,0,5
"5112","enslavers",1,2,2,0,5
"5113","enterprising",4,1,0,0,5
"5114","entreated",2,3,0,0,5
"5115","erect",2,2,1,0,5
"5116","errors",2,3,0,0,5
"5117","evenings",1,2,2,0,5
"5118","excellence",0,4,1,0,5
"5119","excite",3,2,0,0,5
"5120","exclaiming",2,3,0,0,5
"5121","exile",3,2,0,0,5
"5122","expedient",2,2,1,0,5
"5123","expended",4,1,0,0,5
"5124","expenditure",1,4,0,0,5
"5125","extinction",5,0,0,0,5
"5126","extinguish",2,3,0,0,5
"5127","extracts",1,4,0,0,5
"5128","extremest",3,2,0,0,5
"5129","fangs",2,2,1,0,5
"5130","fanning",1,2,2,0,5
"5131","february",4,0,0,1,5
"5132","feels",1,4,0,0,5
"5133","fellowship",2,1,1,1,5
"5134","finance",5,0,0,0,5
"5135","flat",2,3,0,0,5
"5136","flattering",3,2,0,0,5
"5137","flocked",2,2,1,0,5
"5138","floggings",3,2,0,0,5
"5139","flourishing",3,1,0,1,5
"5140","flower",3,2,0,0,5
"5141","foolish",1,4,0,0,5
"5142","forbes",5,0,0,0,5
"5143","forbid",2,3,0,0,5
"5144","forbidden",3,2,0,0,5
"5145","fox",3,2,0,0,5
"5146","frank",3,1,1,0,5
"5147","fraternity",1,4,0,0,5
"5148","freesoil",5,0,0,0,5
"5149","freestate",5,0,0,0,5
"5150","furnish",4,1,0,0,5
"5151","furniture",4,1,0,0,5
"5152","gallows",4,1,0,0,5
"5153","gardner",0,0,5,0,5
"5154","garments",2,3,0,0,5
"5155","gay",5,0,0,0,5
"5156","german",4,1,0,0,5
"5157","gesture",2,1,1,1,5
"5158","ghosts",2,2,1,0,5
"5159","giddings",5,0,0,0,5
"5160","girl’s",2,2,1,0,5
"5161","gives",5,0,0,0,5
"5162","grandmammy",0,5,0,0,5
"5163","gratifying",4,1,0,0,5
"5164","grieved",3,2,0,0,5
"5165","guinea",1,4,0,0,5
"5166","gulf",2,3,0,0,5
"5167","gum",2,2,1,0,5
"5168","gun",2,2,1,0,5
"5169","hand”",5,0,0,0,5
"5170","handled",4,1,0,0,5
"5171","handy",1,2,2,0,5
"5172","harassed",2,2,1,0,5
"5173","hardening",1,4,0,0,5
"5174","hardship",2,2,1,0,5
"5175","hastened",4,1,0,0,5
"5176","haunted",1,4,0,0,5
"5177","hazard",0,3,2,0,5
"5178","hellblack",5,0,0,0,5
"5179","henceforth",3,1,1,0,5
"5180","henrietta",0,3,2,0,5
"5181","herald",4,1,0,0,5
"5182","hiding",2,2,1,0,5
"5183","hindrance",5,0,0,0,5
"5184","honey",1,3,0,1,5
"5185","honors",5,0,0,0,5
"5186","horned",2,2,0,1,5
"5187","horns",2,2,1,0,5
"5188","horribly",1,1,3,0,5
"5189","house”",5,0,0,0,5
"5190","household",3,2,0,0,5
"5191","howling",2,1,0,2,5
"5192","humbled",2,3,0,0,5
"5193","humbly",2,2,1,0,5
"5194","hung",2,3,0,0,5
"5195","husbands",2,2,1,0,5
"5196","hutchinson",3,2,0,0,5
"5197","icy",2,2,1,0,5
"5198","ike",1,4,0,0,5
"5199","illinois",3,2,0,0,5
"5200","immeasurable",3,2,0,0,5
"5201","immortal",2,3,0,0,5
"5202","imprisoned",3,2,0,0,5
"5203","inaugurated",4,1,0,0,5
"5204","incidental",2,2,1,0,5
"5205","incomparably",3,1,1,0,5
"5206","inconsistencies",1,2,2,0,5
"5207","incur",0,3,2,0,5
"5208","indignity",4,1,0,0,5
"5209","indulged",1,1,3,0,5
"5210","ineffable",3,1,1,0,5
"5211","ingersoll",5,0,0,0,5
"5212","injunction",3,2,0,0,5
"5213","ink",2,2,1,0,5
"5214","inseparable",3,2,0,0,5
"5215","instruments",1,4,0,0,5
"5216","insulted",3,2,0,0,5
"5217","insults",2,3,0,0,5
"5218","insure",3,2,0,0,5
"5219","intentions",4,1,0,0,5
"5220","intermediate",3,2,0,0,5
"5221","interposition",1,3,1,0,5
"5222","interruptions",3,1,1,0,5
"5223","intimate",2,3,0,0,5
"5224","invariably",1,3,1,0,5
"5225","invention",2,3,0,0,5
"5226","invoke",1,4,0,0,5
"5227","jackets",2,2,1,0,5
"5228","jacob",0,2,3,0,5
"5229","jefferson",3,1,0,1,5
"5230","jennie",5,0,0,0,5
"5231","joist",1,2,2,0,5
"5232","judicial",2,1,2,0,5
"5233","jumped",2,2,1,0,5
"5234","june",3,0,0,2,5
"5235","justification",2,2,1,0,5
"5236","kindred",2,1,1,1,5
"5237","kneeling",1,2,0,2,5
"5238","lacerated",1,2,2,0,5
"5239","ladder",1,3,1,0,5
"5240","later",5,0,0,0,5
"5241","launched",2,1,1,1,5
"5242","lawless",4,1,0,0,5
"5243","lawn",2,3,0,0,5
"5244","leaf",2,2,1,0,5
"5245","leg",2,3,0,0,5
"5246","liberate",4,1,0,0,5
"5247","liberation",5,0,0,0,5
"5248","life”",5,0,0,0,5
"5249","lifting",4,1,0,0,5
"5250","lion",2,0,3,0,5
"5251","loading",3,1,1,0,5
"5252","loaf",2,3,0,0,5
"5253","locked",4,1,0,0,5
"5254","machine",1,4,0,0,5
"5255","machinery",5,0,0,0,5
"5256","mad",4,1,0,0,5
"5257","majesty",2,3,0,0,5
"5258","male",3,1,1,0,5
"5259","mammy",3,2,0,0,5
"5260","man_",0,5,0,0,5
"5261","managers",4,0,1,0,5
"5262","managing",3,1,1,0,5
"5263","markets",1,3,0,1,5
"5264","massive",3,0,0,2,5
"5265","matched",1,3,1,0,5
"5266","mcclellan",5,0,0,0,5
"5267","measuring",3,2,0,0,5
"5268","melted",2,1,2,0,5
"5269","mentally",3,2,0,0,5
"5270","mercifully",2,3,0,0,5
"5271","merits",4,1,0,0,5
"5272","messengers",4,1,0,0,5
"5273","mexico",2,3,0,0,5
"5274","mild",2,3,0,0,5
"5275","ministry",4,1,0,0,5
"5276","mirth",2,3,0,0,5
"5277","mischief",2,2,1,0,5
"5278","missionaries",0,2,2,1,5
"5279","mistresses",1,4,0,0,5
"5280","mobs",5,0,0,0,5
"5281","momentous",3,2,0,0,5
"5282","monarchical",2,3,0,0,5
"5283","money”",5,0,0,0,5
"5284","monopoly",4,1,0,0,5
"5285","mortification",2,3,0,0,5
"5286","mott",5,0,0,0,5
"5287","mount",2,2,1,0,5
"5288","mourn",2,2,1,0,5
"5289","mourner",2,2,1,0,5
"5290","mourning",2,2,1,0,5
"5291","muscular",2,2,0,1,5
"5292","musket",2,1,2,0,5
"5293","narrating",2,2,1,0,5
"5294","nat",3,2,0,0,5
"5295","navy",5,0,0,0,5
"5296","needs",5,0,0,0,5
"5297","negrobreaker",5,0,0,0,5
"5298","nerves",2,3,0,0,5
"5299","net",2,3,0,0,5
"5300","nets",1,4,0,0,5
"5301","nile",0,0,0,5,5
"5302","noises",3,2,0,0,5
"5303","nominal",4,1,0,0,5
"5304","nonsense",3,2,0,0,5
"5305","numbered",4,1,0,0,5
"5306","obligation",4,1,0,0,5
"5307","obscurity",4,1,0,0,5
"5308","observing",2,3,0,0,5
"5309","obstacle",3,2,0,0,5
"5310","occasioned",4,0,1,0,5
"5311","occupies",2,3,0,0,5
"5312","occupying",2,2,1,0,5
"5313","offences",3,0,2,0,5
"5314","offers",3,1,0,1,5
"5315","officer",3,1,0,1,5
"5316","oldest",4,0,0,1,5
"5317","omit",3,2,0,0,5
"5318","omitted",3,1,1,0,5
"5319","operations",3,1,1,0,5
"5320","opposing",3,2,0,0,5
"5321","originally",3,1,1,0,5
"5322","owed",2,2,1,0,5
"5323","ownership",2,2,1,0,5
"5324","paced",3,2,0,0,5
"5325","pale",3,2,0,0,5
"5326","paris",1,1,0,3,5
"5327","parley",4,1,0,0,5
"5328","partiality",2,2,1,0,5
"5329","passages",3,1,1,0,5
"5330","passionate",2,2,1,0,5
"5331","patrick",1,2,2,0,5
"5332","pattern",2,3,0,0,5
"5333","pause",2,3,0,0,5
"5334","pelted",5,0,0,0,5
"5335","peoria",5,0,0,0,5
"5336","perfection",2,1,0,2,5
"5337","perplexed",1,2,2,0,5
"5338","persistent",4,1,0,0,5
"5339","personality",3,2,0,0,5
"5340","petition",2,3,0,0,5
"5341","pharisees",0,0,5,0,5
"5342","phrase",3,2,0,0,5
"5343","pig",2,2,1,0,5
"5344","pile",3,2,0,0,5
"5345","pillsbury",5,0,0,0,5
"5346","pirate",1,2,2,0,5
"5347","pistol",2,2,1,0,5
"5348","pitch",1,3,1,0,5
"5349","piteous",1,4,0,0,5
"5350","planned",2,2,1,0,5
"5351","plausible",2,3,0,0,5
"5352","pleading",3,0,2,0,5
"5353","pleasures",2,3,0,0,5
"5354","pledged",1,3,1,0,5
"5355","poets",0,5,0,0,5
"5356","postoffice",5,0,0,0,5
"5357","potomac",4,1,0,0,5
"5358","pound",3,2,0,0,5
"5359","preached",1,4,0,0,5
"5360","preacher’s",5,0,0,0,5
"5361","preceding",4,1,0,0,5
"5362","precincts",2,3,0,0,5
"5363","preface",0,3,2,0,5
"5364","presentation",4,1,0,0,5
"5365","presents",5,0,0,0,5
"5366","pretext",4,1,0,0,5
"5367","preventing",2,3,0,0,5
"5368","prince",2,2,0,1,5
"5369","procuring",4,1,0,0,5
"5370","products",1,1,2,1,5
"5371","prof",4,0,0,1,5
"5372","professor",2,2,1,0,5
"5373","proffered",3,2,0,0,5
"5374","profound",3,2,0,0,5
"5375","profusion",3,2,0,0,5
"5376","propensities",2,3,0,0,5
"5377","protracted",4,1,0,0,5
"5378","puffing",2,2,1,0,5
"5379","pull",1,1,2,1,5
"5380","pulled",2,2,1,0,5
"5381","purely",3,2,0,0,5
"5382","purity",1,3,1,0,5
"5383","purse",1,3,1,0,5
"5384","pursuers",2,2,1,0,5
"5385","pushed",3,1,0,1,5
"5386","quarrel",0,3,2,0,5
"5387","quicken",1,3,1,0,5
"5388","quickened",1,3,1,0,5
"5389","rail",0,4,1,0,5
"5390","rally",3,2,0,0,5
"5391","ranked",1,1,3,0,5
"5392","reaction",5,0,0,0,5
"5393","reap",3,2,0,0,5
"5394","recall",3,1,0,1,5
"5395","recent",1,4,0,0,5
"5396","reconstruction",5,0,0,0,5
"5397","redeemed",4,1,0,0,5
"5398","relates",0,2,3,0,5
"5399","released",2,2,1,0,5
"5400","relies",0,5,0,0,5
"5401","relish",3,1,1,0,5
"5402","rely",2,2,1,0,5
"5403","reminded",2,2,1,0,5
"5404","remorseless",1,4,0,0,5
"5405","rend",3,2,0,0,5
"5406","repelled",3,1,1,0,5
"5407","resemble",3,2,0,0,5
"5408","retaliation",4,0,1,0,5
"5409","reunion",2,3,0,0,5
"5410","reveals",1,4,0,0,5
"5411","rewarded",3,1,0,1,5
"5412","richardson",1,2,0,2,5
"5413","rides",2,2,0,1,5
"5414","rightful",2,3,0,0,5
"5415","roar",2,1,2,0,5
"5416","rocked",3,1,1,0,5
"5417","roman",0,0,0,5,5
"5418","row",2,1,0,2,5
"5419","russell",4,1,0,0,5
"5420","ruthless",2,1,2,0,5
"5421","sacrament",0,5,0,0,5
"5422","sagacity",2,2,1,0,5
"5423","samaritan",3,2,0,0,5
"5424","san",2,0,0,3,5
"5425","sanction",0,3,2,0,5
"5426","sand",0,1,0,4,5
"5427","saving",3,1,1,0,5
"5428","saxon",0,5,0,0,5
"5429","scantily",1,4,0,0,5
"5430","scanty",1,2,1,1,5
"5431","scars",2,3,0,0,5
"5432","schoolhouse",5,0,0,0,5
"5433","schooling",2,3,0,0,5
"5434","scope",2,2,1,0,5
"5435","score",2,3,0,0,5
"5436","scott",5,0,0,0,5
"5437","scribes",0,0,5,0,5
"5438","seal",2,2,1,0,5
"5439","searched",3,1,1,0,5
"5440","seasons",2,2,1,0,5
"5441","seemingly",2,2,1,0,5
"5442","sees",4,0,0,1,5
"5443","semi",0,5,0,0,5
"5444","senatorial",3,2,0,0,5
"5445","sensations",3,2,0,0,5
"5446","separately",1,1,3,0,5
"5447","serviceable",1,3,1,0,5
"5448","serving",4,1,0,0,5
"5449","severed",2,3,0,0,5
"5450","shameless",2,3,0,0,5
"5451","sharing",3,2,0,0,5
"5452","sherman",5,0,0,0,5
"5453","sickened",1,3,1,0,5
"5454","sided",3,1,1,0,5
"5455","silenced",3,2,0,0,5
"5456","silently",2,2,0,1,5
"5457","sincere",2,2,1,0,5
"5458","sink",2,1,1,1,5
"5459","sinking",2,3,0,0,5
"5460","sinner",1,4,0,0,5
"5461","sitting",2,2,0,1,5
"5462","skirts",2,2,0,1,5
"5463","slave”",5,0,0,0,5
"5464","slightly",5,0,0,0,5
"5465","smart",2,2,1,0,5
"5466","snake",1,3,1,0,5
"5467","solemnly",2,2,1,0,5
"5468","solitude",2,2,0,1,5
"5469","sorry",5,0,0,0,5
"5470","spaces",2,1,1,1,5
"5471","spacious",4,1,0,0,5
"5472","spared",2,3,0,0,5
"5473","spell",1,2,2,0,5
"5474","spiritless",3,2,0,0,5
"5475","splendor",2,3,0,0,5
"5476","spoil",4,1,0,0,5
"5477","sprung",3,2,0,0,5
"5478","stared",3,2,0,0,5
"5479","stars",4,1,0,0,5
"5480","startled",3,1,0,1,5
"5481","stationed",3,1,0,1,5
"5482","statute",2,2,1,0,5
"5483","staying",2,1,2,0,5
"5484","stimulated",4,1,0,0,5
"5485","stooping",2,2,1,0,5
"5486","stores",3,1,0,1,5
"5487","stories",2,1,1,1,5
"5488","stout",3,2,0,0,5
"5489","strained",3,2,0,0,5
"5490","stretched",2,2,1,0,5
"5491","strove",1,1,3,0,5
"5492","structures",0,0,0,5,5
"5493","stump",3,1,1,0,5
"5494","stung",2,2,1,0,5
"5495","stunning",2,2,1,0,5
"5496","subjecting",1,3,1,0,5
"5497","subscriber",3,1,1,0,5
"5498","subsist",2,1,2,0,5
"5499","suggestions",3,2,0,0,5
"5500","suppressing",4,1,0,0,5
"5501","surely",2,2,1,0,5
"5502","surface",3,1,0,1,5
"5503","surrendered",4,1,0,0,5
"5504","surveying",3,2,0,0,5
"5505","swamp",0,3,2,0,5
"5506","sympathized",2,2,1,0,5
"5507","talents",1,3,1,0,5
"5508","tea",5,0,0,0,5
"5509","tearful",1,2,2,0,5
"5510","tempt",2,3,0,0,5
"5511","thence",3,0,0,2,5
"5512","therefor",2,2,0,1,5
"5513","thieves",3,2,0,0,5
"5514","thinker",3,2,0,0,5
"5515","tiger",2,1,2,0,5
"5516","tilt",2,2,1,0,5
"5517","tolerated",4,1,0,0,5
"5518","tommy”",5,0,0,0,5
"5519","tonight",2,3,0,0,5
"5520","tops",2,2,0,1,5
"5521","total",2,1,2,0,5
"5522","touches",2,3,0,0,5
"5523","towlinen",5,0,0,0,5
"5524","traced",1,3,1,0,5
"5525","traces",2,2,1,0,5
"5526","tracy",5,0,0,0,5
"5527","trader",1,2,2,0,5
"5528","tragic",3,2,0,0,5
"5529","transition",2,3,0,0,5
"5530","tray",1,3,1,0,5
"5531","treacherous",2,2,1,0,5
"5532","treading",1,3,1,0,5
"5533","trimmed",2,3,0,0,5
"5534","trumpet",4,1,0,0,5
"5535","trustworthy",3,2,0,0,5
"5536","tumultuous",3,1,0,1,5
"5537","turner",3,2,0,0,5
"5538","turning",5,0,0,0,5
"5539","turningpoint",5,0,0,0,5
"5540","tutor",3,2,0,0,5
"5541","tyrannical",1,4,0,0,5
"5542","uncertain",4,1,0,0,5
"5543","undoubtedly",2,2,1,0,5
"5544","uneasy",2,2,1,0,5
"5545","unexpected",1,2,2,0,5
"5546","unexpectedly",2,2,1,0,5
"5547","unlawful",2,2,1,0,5
"5548","unobserved",3,2,0,0,5
"5549","untied",2,3,0,0,5
"5550","unveiling",4,0,0,1,5
"5551","using",5,0,0,0,5
"5552","variously",2,3,0,0,5
"5553","verily",2,2,1,0,5
"5554","villainy",3,2,0,0,5
"5555","vindicated",2,2,0,1,5
"5556","vindictive",2,3,0,0,5
"5557","violently",2,3,0,0,5
"5558","virtues",3,2,0,0,5
"5559","viz",5,0,0,0,5
"5560","volunteer",1,3,1,0,5
"5561","voted",4,1,0,0,5
"5562","voting",3,2,0,0,5
"5563","vulgar",3,2,0,0,5
"5564","wake",1,3,1,0,5
"5565","wales",2,3,0,0,5
"5566","warmth",4,1,0,0,5
"5567","waugh",2,3,0,0,5
"5568","wavered",3,2,0,0,5
"5569","weeping",2,3,0,0,5
"5570","well”",5,0,0,0,5
"5571","wet",3,1,1,0,5
"5572","whereabouts",2,2,1,0,5
"5573","whips",1,2,2,0,5
"5574","whittier",1,3,1,0,5
"5575","wholesale",1,1,3,0,5
"5576","wielded",3,1,1,0,5
"5577","wilderness",4,1,0,0,5
"5578","winder",1,2,2,0,5
"5579","winged",1,3,1,0,5
"5580","wires",4,1,0,0,5
"5581","worthless",3,2,0,0,5
"5582","wrestling",1,2,2,0,5
"5583","wrists",3,2,0,0,5
"5584","writings",5,0,0,0,5
"5585","yield",3,2,0,0,5
"5586","youngest",5,0,0,0,5
"5587","_far",0,4,0,0,4
"5588","_frederick",0,1,3,0,4
"5589","_him_",0,4,0,0,4
"5590","_me_",0,4,0,0,4
"5591","_only_",0,4,0,0,4
"5592","_root_",0,1,3,0,4
"5593","_what_",0,4,0,0,4
"5594","_white_",0,4,0,0,4
"5595","“’s",4,0,0,0,4
"5596","“don’t",4,0,0,0,4
"5597","“great",4,0,0,0,4
"5598","“life",4,0,0,0,4
"5599","“rochester",4,0,0,0,4
"5600","“sally",4,0,0,0,4
"5601","3",0,2,2,0,4
"5602","4",0,2,2,0,4
"5603","aaron",4,0,0,0,4
"5604","aback",1,2,1,0,4
"5605","abominable",1,2,1,0,4
"5606","acceptable",1,2,1,0,4
"5607","accident",1,1,2,0,4
"5608","accompanying",3,1,0,0,4
"5609","accusation",1,2,1,0,4
"5610","acquirements",1,3,0,0,4
"5611","adhered",3,1,0,0,4
"5612","adjoining",2,2,0,0,4
"5613","adjust",3,1,0,0,4
"5614","advancing",3,1,0,0,4
"5615","affectionately",2,2,0,0,4
"5616","aggression",2,2,0,0,4
"5617","agreement",3,1,0,0,4
"5618","alabaster",2,2,0,0,4
"5619","alacrity",3,1,0,0,4
"5620","alliciana",1,2,1,0,4
"5621","aloud",2,2,0,0,4
"5622","altered",2,2,0,0,4
"5623","amalfi",0,0,0,4,4
"5624","anchor",2,1,0,1,4
"5625","annihilated",1,2,1,0,4
"5626","annually",2,1,1,0,4
"5627","anticorn",4,0,0,0,4
"5628","apartments",2,2,0,0,4
"5629","apostles",3,1,0,0,4
"5630","appointments",3,0,0,1,4
"5631","appropriate",3,0,0,1,4
"5632","approve",2,2,0,0,4
"5633","arch",2,1,0,1,4
"5634","ardor",3,0,1,0,4
"5635","arises",1,2,1,0,4
"5636","arming",4,0,0,0,4
"5637","arrayed",2,2,0,0,4
"5638","ascertaining",0,2,1,1,4
"5639","aspires",1,3,0,0,4
"5640","ass",2,1,1,0,4
"5641","assailants",3,1,0,0,4
"5642","assassins",3,1,0,0,4
"5643","assemble",2,2,0,0,4
"5644","assing",4,0,0,0,4
"5645","associate",2,2,0,0,4
"5646","astonishing",1,2,1,0,4
"5647","atoned",2,2,0,0,4
"5648","attachments",2,2,0,0,4
"5649","attacked",3,1,0,0,4
"5650","attainable",2,2,0,0,4
"5651","attaining",2,2,0,0,4
"5652","attendants",2,1,1,0,4
"5653","attentively",2,1,1,0,4
"5654","attested",2,2,0,0,4
"5655","autobiography",2,2,0,0,4
"5656","autumn",2,1,0,1,4
"5657","auxiliaries",2,2,0,0,4
"5658","aversions",2,2,0,0,4
"5659","avignon",0,0,0,4,4
"5660","b f",4,0,0,0,4
"5661","back”",4,0,0,0,4
"5662","baked",2,2,0,0,4
"5663","bareheaded",3,0,1,0,4
"5664","bark",2,2,0,0,4
"5665","barns",2,2,0,0,4
"5666","barrier",1,1,2,0,4
"5667","baskets",1,1,1,1,4
"5668","battlefield",4,0,0,0,4
"5669","bayonets",4,0,0,0,4
"5670","beautifully",1,1,0,2,4
"5671","beck",2,1,1,0,4
"5672","beings",4,0,0,0,4
"5673","belt",2,1,0,1,4
"5674","bereavement",4,0,0,0,4
"5675","berth",2,2,0,0,4
"5676","bestow",2,1,1,0,4
"5677","bestowed",2,2,0,0,4
"5678","bettering",1,2,1,0,4
"5679","betwixt",1,1,2,0,4
"5680","bibles",1,2,1,0,4
"5681","bigger",1,3,0,0,4
"5682","bills",2,2,0,0,4
"5683","biscuits",2,1,1,0,4
"5684","bit",1,2,0,1,4
"5685","blackest",2,2,0,0,4
"5686","blacksmiths",1,3,0,0,4
"5687","blight",2,2,0,0,4
"5688","blighting",1,1,2,0,4
"5689","boasted",1,3,0,0,4
"5690","boded",2,2,0,0,4
"5691","bodily",2,2,0,0,4
"5692","boldest",2,1,1,0,4
"5693","boldly",1,3,0,0,4
"5694","boon",2,2,0,0,4
"5695","borgo",0,0,0,4,4
"5696","bounded",3,1,0,0,4
"5697","boy’s",1,3,0,0,4
"5698","boyhood",1,3,0,0,4
"5699","brandy",2,1,1,0,4
"5700","breastbone",2,0,2,0,4
"5701","breezes",2,2,0,0,4
"5702","brooded",1,3,0,0,4
"5703","brownthe",4,0,0,0,4
"5704","brows",2,2,0,0,4
"5705","builder",0,3,1,0,4
"5706","bullets",3,1,0,0,4
"5707","burn",0,4,0,0,4
"5708","bury",2,1,1,0,4
"5709","bush",1,2,1,0,4
"5710","bustle",3,1,0,0,4
"5711","buyers",0,4,0,0,4
"5712","buzzards",2,2,0,0,4
"5713","calculation",3,0,0,1,4
"5714","caldwell",2,1,1,0,4
"5715","campbell’s",0,4,0,0,4
"5716","cap",1,1,1,1,4
"5717","capricious",2,2,0,0,4
"5718","captive",1,3,0,0,4
"5719","caressing",2,2,0,0,4
"5720","cash",2,2,0,0,4
"5721","catalogue",0,4,0,0,4
"5722","catchers",2,2,0,0,4
"5723","certify",1,1,2,0,4
"5724","chafed",2,2,0,0,4
"5725","chagrin",1,3,0,0,4
"5726","chambersburg",4,0,0,0,4
"5727","chapel",0,3,0,1,4
"5728","chapters",2,2,0,0,4
"5729","charitable",2,1,1,0,4
"5730","charter",4,0,0,0,4
"5731","chasm",4,0,0,0,4
"5732","chastisements",1,2,1,0,4
"5733","chatham",3,1,0,0,4
"5734","cheerfulness",2,1,0,1,4
"5735","cherishing",2,2,0,0,4
"5736","chilled",3,1,0,0,4
"5737","chimneys",2,2,0,0,4
"5738","china",3,1,0,0,4
"5739","chopping",1,2,1,0,4
"5740","claimants",3,1,0,0,4
"5741","claimed",3,0,1,0,4
"5742","classleaders",4,0,0,0,4
"5743","clearness",2,2,0,0,4
"5744","clerk",2,1,1,0,4
"5745","clerks",3,1,0,0,4
"5746","climax",1,1,2,0,4
"5747","club",2,2,0,0,4
"5748","coaches",2,1,1,0,4
"5749","coarsest",1,3,0,0,4
"5750","code",0,2,2,0,4
"5751","coffin",2,1,1,0,4
"5752","collect",3,1,0,0,4
"5753","collectively",2,2,0,0,4
"5754","combat",1,3,0,0,4
"5755","combe",4,0,0,0,4
"5756","combining",1,2,1,0,4
"5757","commander",4,0,0,0,4
"5758","commands",1,1,1,1,4
"5759","commented",3,1,0,0,4
"5760","commonly",2,1,1,0,4
"5761","commons",3,1,0,0,4
"5762","companion",1,3,0,0,4
"5763","competent",3,1,0,0,4
"5764","complying",3,1,0,0,4
"5765","compressed",2,1,1,0,4
"5766","confused",2,2,0,0,4
"5767","conjecture",2,1,1,0,4
"5768","conquer",3,1,0,0,4
"5769","consciences",1,3,0,0,4
"5770","consequent",3,1,0,0,4
"5771","consequently",4,0,0,0,4
"5772","conservative",3,1,0,0,4
"5773","considerate",2,2,0,0,4
"5774","consigned",2,1,0,1,4
"5775","consisting",2,2,0,0,4
"5776","conspiracy",4,0,0,0,4
"5777","consul",1,0,0,3,4
"5778","consulting",1,2,1,0,4
"5779","contend",2,0,2,0,4
"5780","contracted",2,1,1,0,4
"5781","contracts",1,1,2,0,4
"5782","contributions",3,1,0,0,4
"5783","convent",0,0,0,4,4
"5784","conventional",1,3,0,0,4
"5785","conversing",2,1,1,0,4
"5786","conveyances",4,0,0,0,4
"5787","cooled",2,2,0,0,4
"5788","coopers",1,3,0,0,4
"5789","copied",2,2,0,0,4
"5790","copybooks",4,0,0,0,4
"5791","cornfield",1,0,2,1,4
"5792","corpse",2,2,0,0,4
"5793","council",4,0,0,0,4
"5794","councils",3,1,0,0,4
"5795","counsels",1,3,0,0,4
"5796","counterpart",2,2,0,0,4
"5797","counties",2,2,0,0,4
"5798","courageously",3,1,0,0,4
"5799","courtship",3,1,0,0,4
"5800","covers",2,1,1,0,4
"5801","cow",1,3,0,0,4
"5802","cowhide",3,1,0,0,4
"5803","crafty",1,3,0,0,4
"5804","cravat",4,0,0,0,4
"5805","creation",1,1,2,0,4
"5806","creator",0,2,1,1,4
"5807","critical",4,0,0,0,4
"5808","crowning",2,2,0,0,4
"5809","crumbs",2,2,0,0,4
"5810","damn",0,0,4,0,4
"5811","dance",0,4,0,0,4
"5812","danced",2,1,1,0,4
"5813","dat",2,2,0,0,4
"5814","dat’s",2,2,0,0,4
"5815","dates",1,2,1,0,4
"5816","dazzling",1,1,0,2,4
"5817","dearly",3,1,0,0,4
"5818","debasing",2,1,1,0,4
"5819","decade",4,0,0,0,4
"5820","deceive",0,0,4,0,4
"5821","deciding",2,2,0,0,4
"5822","decks",2,1,1,0,4
"5823","declaring",4,0,0,0,4
"5824","declined",4,0,0,0,4
"5825","decoration",4,0,0,0,4
"5826","deference",1,2,1,0,4
"5827","defiance",2,0,2,0,4
"5828","deficiency",1,2,1,0,4
"5829","delegate",4,0,0,0,4
"5830","deliberation",2,0,2,0,4
"5831","delusion",1,3,0,0,4
"5832","delusive",3,1,0,0,4
"5833","demonstrating",2,1,1,0,4
"5834","demonstrations",2,1,1,0,4
"5835","denies",2,1,1,0,4
"5836","denunciations",1,2,1,0,4
"5837","deplored",1,3,0,0,4
"5838","deposited",3,1,0,0,4
"5839","descriptions",3,1,0,0,4
"5840","desires",0,3,1,0,4
"5841","detain",4,0,0,0,4
"5842","detained",2,1,1,0,4
"5843","detection",1,1,2,0,4
"5844","determine",1,3,0,0,4
"5845","detestation",0,3,1,0,4
"5846","devote",3,1,0,0,4
"5847","devoting",2,2,0,0,4
"5848","devour",1,1,2,0,4
"5849","devout",1,2,0,1,4
"5850","differed",3,1,0,0,4
"5851","digest",1,3,0,0,4
"5852","digging",1,3,0,0,4
"5853","disciple",1,3,0,0,4
"5854","disclose",1,3,0,0,4
"5855","discretion",2,2,0,0,4
"5856","discuss",3,1,0,0,4
"5857","disgrace",0,2,2,0,4
"5858","disgusted",3,1,0,0,4
"5859","disloyal",3,1,0,0,4
"5860","dispelled",2,1,0,1,4
"5861","dispensation",3,1,0,0,4
"5862","dispute",3,1,0,0,4
"5863","disturb",3,1,0,0,4
"5864","disunion",2,2,0,0,4
"5865","doubly",3,1,0,0,4
"5866","doubting",2,2,0,0,4
"5867","dove",1,2,1,0,4
"5868","downfall",3,0,1,0,4
"5869","downtrodden",3,1,0,0,4
"5870","dreaming",2,1,1,0,4
"5871","dred",4,0,0,0,4
"5872","dried",1,3,0,0,4
"5873","drivers",1,2,1,0,4
"5874","drowned",1,1,2,0,4
"5875","drunkard",1,1,2,0,4
"5876","ducks",2,2,0,0,4
"5877","dusty",4,0,0,0,4
"5878","dwellings",1,2,1,0,4
"5879","earthquake",2,1,1,0,4
"5880","easier",2,1,0,1,4
"5881","eaten",2,2,0,0,4
"5882","editorials",3,1,0,0,4
"5883","editors",2,2,0,0,4
"5884","elaborate",2,2,0,0,4
"5885","elbow",3,1,0,0,4
"5886","elbowed",2,2,0,0,4
"5887","elector",4,0,0,0,4
"5888","elevating",2,2,0,0,4
"5889","eli",1,1,2,0,4
"5890","eligible",3,1,0,0,4
"5891","elm",0,4,0,0,4
"5892","elmwood",4,0,0,0,4
"5893","eloquently",1,2,0,1,4
"5894","emaciated",1,2,1,0,4
"5895","emerald",2,2,0,0,4
"5896","emigration",4,0,0,0,4
"5897","emphatically",1,2,1,0,4
"5898","encountering",2,1,1,0,4
"5899","endangered",1,3,0,0,4
"5900","ending",3,0,0,1,4
"5901","endowed",0,3,1,0,4
"5902","energetic",2,1,1,0,4
"5903","engagements",3,1,0,0,4
"5904","enlisted",3,1,0,0,4
"5905","enthusiastic",2,1,1,0,4
"5906","era",2,2,0,0,4
"5907","escapes",2,2,0,0,4
"5908","essence",2,2,0,0,4
"5909","eternity",2,2,0,0,4
"5910","etiquette",3,1,0,0,4
"5911","everlasting",1,2,1,0,4
"5912","evidences",3,1,0,0,4
"5913","exacting",2,2,0,0,4
"5914","exactly",4,0,0,0,4
"5915","examine",2,2,0,0,4
"5916","exceeded",2,0,1,1,4
"5917","exceeding",1,2,1,0,4
"5918","exceptional",2,2,0,0,4
"5919","exchange",2,1,1,0,4
"5920","excused",3,1,0,0,4
"5921","exemption",2,2,0,0,4
"5922","exertions",4,0,0,0,4
"5923","extenuation",3,1,0,0,4
"5924","factory",2,1,1,0,4
"5925","fails",1,3,0,0,4
"5926","famine",2,2,0,0,4
"5927","fared",3,1,0,0,4
"5928","fashionable",2,1,1,0,4
"5929","fasten",2,1,1,0,4
"5930","faster",0,2,2,0,4
"5931","fastest",1,1,2,0,4
"5932","fatherinlaw",4,0,0,0,4
"5933","favoring",3,1,0,0,4
"5934","feast",1,2,1,0,4
"5935","felons",3,1,0,0,4
"5936","ferociously",2,2,0,0,4
"5937","fetter",1,3,0,0,4
"5938","fidelity",4,0,0,0,4
"5939","fieldhand",4,0,0,0,4
"5940","fiends",2,1,1,0,4
"5941","file",3,0,1,0,4
"5942","filth",1,1,1,1,4
"5943","fists",1,2,1,0,4
"5944","flinty",2,1,1,0,4
"5945","flood",3,1,0,0,4
"5946","flow",2,1,1,0,4
"5947","flowing",1,2,0,1,4
"5948","fluent",2,1,1,0,4
"5949","foam",1,2,0,1,4
"5950","foe",2,1,1,0,4
"5951","folks",1,3,0,0,4
"5952","followers",1,1,1,1,4
"5953","fondly",3,1,0,0,4
"5954","forbids",2,1,1,0,4
"5955","foretaste",2,2,0,0,4
"5956","forfeited",3,1,0,0,4
"5957","formidable",3,1,0,0,4
"5958","forthwith",0,0,4,0,4
"5959","fortifications",3,0,0,1,4
"5960","fortnight",2,2,0,0,4
"5961","fortunes",3,1,0,0,4
"5962","foundry",4,0,0,0,4
"5963","fowl",1,2,0,1,4
"5964","freddy",0,3,1,0,4
"5965","fremont",4,0,0,0,4
"5966","fright",2,1,1,0,4
"5967","frolic",2,2,0,0,4
"5968","frowned",2,2,0,0,4
"5969","fundamental",2,2,0,0,4
"5970","funds",3,1,0,0,4
"5971","funny",2,1,1,0,4
"5972","gag",0,4,0,0,4
"5973","gains",2,1,0,1,4
"5974","garnet",4,0,0,0,4
"5975","gathering",1,2,1,0,4
"5976","gazing",1,2,1,0,4
"5977","geese",2,2,0,0,4
"5978","genealogical",2,2,0,0,4
"5979","generosity",3,1,0,0,4
"5980","genial",1,3,0,0,4
"5981","genteel",2,2,0,0,4
"5982","gently",2,2,0,0,4
"5983","giant’s",2,2,0,0,4
"5984","gigs",2,1,1,0,4
"5985","glances",2,2,0,0,4
"5986","glare",2,1,1,0,4
"5987","glittering",3,1,0,0,4
"5988","glossy",1,2,1,0,4
"5989","go”",4,0,0,0,4
"5990","goads",3,1,0,0,4
"5991","goose",2,2,0,0,4
"5992","governors",4,0,0,0,4
"5993","graces",2,2,0,0,4
"5994","grade",1,2,1,0,4
"5995","grandest",2,2,0,0,4
"5996","granting",3,1,0,0,4
"5997","greeted",3,1,0,0,4
"5998","greeting",2,1,0,1,4
"5999","groan",2,2,0,0,4
"6000","guarantees",3,1,0,0,4
"6001","guarding",2,1,1,0,4
"6002","hailed",3,0,1,0,4
"6003","hale",3,1,0,0,4
"6004","halfway",3,1,0,0,4
"6005","ham",0,1,3,0,4
"6006","handcuffed",1,1,2,0,4
"6007","handicraft",1,3,0,0,4
"6008","handspike",2,0,2,0,4
"6009","hanging",2,1,0,1,4
"6010","hardest",1,3,0,0,4
"6011","harmless",3,1,0,0,4
"6012","harriet",1,2,1,0,4
"6013","harrowing",1,3,0,0,4
"6014","hasten",3,1,0,0,4
"6015","hayti",4,0,0,0,4
"6016","hazardous",2,1,1,0,4
"6017","hazards",1,1,2,0,4
"6018","heartfelt",3,1,0,0,4
"6019","hearty",1,1,0,2,4
"6020","heavier",2,2,0,0,4
"6021","heaving",1,2,1,0,4
"6022","heed",3,1,0,0,4
"6023","heedless",2,2,0,0,4
"6024","hemmed",1,1,2,0,4
"6025","heretofore",1,2,1,0,4
"6026","herring",1,3,0,0,4
"6027","hesitated",3,1,0,0,4
"6028","hesitating",3,1,0,0,4
"6029","hid",1,2,1,0,4
"6030","hides",1,2,1,0,4
"6031","highland",4,0,0,0,4
"6032","highway",1,2,0,1,4
"6033","hindered",2,2,0,0,4
"6034","historical",3,0,0,1,4
"6035","hoarse",3,1,0,0,4
"6036","hoes",1,2,1,0,4
"6037","hole",1,2,1,0,4
"6038","holiday",1,2,0,1,4
"6039","holiest",2,2,0,0,4
"6040","hoping",1,1,2,0,4
"6041","hopper",3,0,1,0,4
"6042","hospitably",2,1,1,0,4
"6043","howe",4,0,0,0,4
"6044","howitt",4,0,0,0,4
"6045","humiliation",4,0,0,0,4
"6046","humphreys",2,2,0,0,4
"6047","hurrying",1,2,0,1,4
"6048","identified",1,3,0,0,4
"6049","idleness",1,3,0,0,4
"6050","ignored",4,0,0,0,4
"6051","ii",0,2,2,0,4
"6052","illustrating",1,3,0,0,4
"6053","imbued",2,2,0,0,4
"6054","imperfect",2,2,0,0,4
"6055","imperfectly",2,2,0,0,4
"6056","imperious",2,2,0,0,4
"6057","import",1,3,0,0,4
"6058","impose",2,1,1,0,4
"6059","impropriety",2,1,1,0,4
"6060","improvident",1,3,0,0,4
"6061","improving",2,2,0,0,4
"6062","imps",2,2,0,0,4
"6063","impudently",1,2,1,0,4
"6064","inapt",1,3,0,0,4
"6065","inaugural",3,1,0,0,4
"6066","incentive",2,2,0,0,4
"6067","incurred",2,2,0,0,4
"6068","incurring",1,2,1,0,4
"6069","indecent",3,1,0,0,4
"6070","indescribable",1,2,1,0,4
"6071","indication",2,2,0,0,4
"6072","indolence",2,2,0,0,4
"6073","inducement",3,1,0,0,4
"6074","industriously",3,1,0,0,4
"6075","ineffaceably",2,2,0,0,4
"6076","infamy",2,2,0,0,4
"6077","inflict",2,1,1,0,4
"6078","influenced",2,2,0,0,4
"6079","inherent",2,2,0,0,4
"6080","inheritance",3,1,0,0,4
"6081","iniquity",1,2,1,0,4
"6082","initials",1,3,0,0,4
"6083","inquiring",1,3,0,0,4
"6084","insect",2,1,1,0,4
"6085","inserted",2,2,0,0,4
"6086","inspiring",2,1,1,0,4
"6087","instincts",2,2,0,0,4
"6088","instituted",2,2,0,0,4
"6089","integrity",4,0,0,0,4
"6090","intend",1,2,1,0,4
"6091","intent",1,1,2,0,4
"6092","invested",3,1,0,0,4
"6093","inveterate",3,1,0,0,4
"6094","ironed",2,2,0,0,4
"6095","irresistible",2,1,0,1,4
"6096","isle",2,2,0,0,4
"6097","israel",2,2,0,0,4
"6098","italy",0,0,0,4,4
"6099","iv",0,2,2,0,4
"6100","ix",0,2,2,0,4
"6101","j w",4,0,0,0,4
"6102","jack",1,1,2,0,4
"6103","jepson",0,2,2,0,4
"6104","jepson’s",0,2,2,0,4
"6105","judgments",3,1,0,0,4
"6106","keeper",1,2,1,0,4
"6107","kissing",0,0,0,4,4
"6108","knocking",2,1,1,0,4
"6109","lanman",1,2,1,0,4
"6110","launch",2,2,0,0,4
"6111","lawful",2,2,0,0,4
"6112","lawson’s",1,3,0,0,4
"6113","lazy",1,2,1,0,4
"6114","leaden",3,1,0,0,4
"6115","leadership",4,0,0,0,4
"6116","leaned",2,2,0,0,4
"6117","learns",1,3,0,0,4
"6118","legally",3,1,0,0,4
"6119","legislatures",2,2,0,0,4
"6120","liars",2,2,0,0,4
"6121","license",1,3,0,0,4
"6122","lifelong",4,0,0,0,4
"6123","lighted",2,2,0,0,4
"6124","likes",1,2,0,1,4
"6125","limit",2,2,0,0,4
"6126","link",3,1,0,0,4
"6127","linked",2,1,1,0,4
"6128","literal",1,3,0,0,4
"6129","loathed",2,1,1,0,4
"6130","location",4,0,0,0,4
"6131","lock",2,1,0,1,4
"6132","lonely",3,1,0,0,4
"6133","longed",3,1,0,0,4
"6134","lovely",2,2,0,0,4
"6135","lovers",1,3,0,0,4
"6136","loyalist",4,0,0,0,4
"6137","loyalty",3,1,0,0,4
"6138","lyceum",3,1,0,0,4
"6139","magnify",2,2,0,0,4
"6140","maid",1,3,0,0,4
"6141","maintaining",3,1,0,0,4
"6142","maledictions",2,2,0,0,4
"6143","manliness",2,1,1,0,4
"6144","manumitted",2,2,0,0,4
"6145","map",3,1,0,0,4
"6146","marched",2,1,1,0,4
"6147","marching",4,0,0,0,4
"6148","margin",2,2,0,0,4
"6149","maria",4,0,0,0,4
"6150","marring",1,3,0,0,4
"6151","master’s”",4,0,0,0,4
"6152","matthews",1,0,3,0,4
"6153","maul",2,2,0,0,4
"6154","mayor",2,2,0,0,4
"6155","mcgowan",4,0,0,0,4
"6156","meantime",3,1,0,0,4
"6157","mechanic",4,0,0,0,4
"6158","meditated",1,2,0,1,4
"6159","men’s",1,1,2,0,4
"6160","message",4,0,0,0,4
"6161","michigan",4,0,0,0,4
"6162","milly",1,3,0,0,4
"6163","mistressher",4,0,0,0,4
"6164","moderately",2,2,0,0,4
"6165","molasses",0,2,2,0,4
"6166","moment’s",1,2,1,0,4
"6167","monotony",2,2,0,0,4
"6168","mood",2,2,0,0,4
"6169","morris",4,0,0,0,4
"6170","mortal",2,2,0,0,4
"6171","mounted",3,1,0,0,4
"6172","mouths",2,1,1,0,4
"6173","mulatto",0,2,2,0,4
"6174","mules",3,1,0,0,4
"6175","murders",1,2,1,0,4
"6176","murmurs",2,2,0,0,4
"6177","mustered",2,1,1,0,4
"6178","nails",2,2,0,0,4
"6179","nameless",2,2,0,0,4
"6180","nebraska",4,0,0,0,4
"6181","necessaries",1,2,1,0,4
"6182","nerved",1,1,2,0,4
"6183","nicholson",1,2,1,0,4
"6184","noah",2,1,1,0,4
"6185","nominally",1,3,0,0,4
"6186","nomination",4,0,0,0,4
"6187","nook",2,2,0,0,4
"6188","notable",2,2,0,0,4
"6189","noteworthy",4,0,0,0,4
"6190","nudity",1,3,0,0,4
"6191","nursing",2,2,0,0,4
"6192","obeying",2,2,0,0,4
"6193","obstacles",1,2,1,0,4
"6194","offend",2,2,0,0,4
"6195","offices",2,1,1,0,4
"6196","oftener",3,0,1,0,4
"6197","oftenest",2,2,0,0,4
"6198","olden",4,0,0,0,4
"6199","ontario",4,0,0,0,4
"6200","oppressors",2,1,1,0,4
"6201","oracular",2,2,0,0,4
"6202","ordinarily",1,2,1,0,4
"6203","organizations",0,4,0,0,4
"6204","organizing",4,0,0,0,4
"6205","ormuz",0,0,0,4,4
"6206","outburst",3,1,0,0,4
"6207","outlived",2,1,1,0,4
"6208","overhauled",1,2,1,0,4
"6209","overlooked",2,2,0,0,4
"6210","overpowered",2,1,1,0,4
"6211","overpowering",2,2,0,0,4
"6212","overseership",0,1,3,0,4
"6213","overshadowing",1,3,0,0,4
"6214","owning",1,2,1,0,4
"6215","painted",2,2,0,0,4
"6216","paintings",0,0,0,4,4
"6217","palpable",1,2,1,0,4
"6218","panted",2,2,0,0,4
"6219","parallel",2,2,0,0,4
"6220","parried",2,2,0,0,4
"6221","partially",3,1,0,0,4
"6222","patting",2,2,0,0,4
"6223","paul",0,0,0,4,4
"6224","peering",1,3,0,0,4
"6225","penalties",2,2,0,0,4
"6226","penetrated",2,2,0,0,4
"6227","pens",2,1,0,1,4
"6228","performing",4,0,0,0,4
"6229","perpetuation",3,1,0,0,4
"6230","perplexing",1,2,1,0,4
"6231","persistently",2,0,0,2,4
"6232","persuade",2,2,0,0,4
"6233","persuasion",3,1,0,0,4
"6234","persuasive",4,0,0,0,4
"6235","pertaining",1,2,1,0,4
"6236","peter",1,1,1,1,4
"6237","petitions",2,1,1,0,4
"6238","petty",2,2,0,0,4
"6239","phases",2,2,0,0,4
"6240","philanthropic",2,2,0,0,4
"6241","philosophical",3,1,0,0,4
"6242","philpot",0,2,2,0,4
"6243","pierced",1,2,0,1,4
"6244","pillar",1,2,0,1,4
"6245","pit",2,1,1,0,4
"6246","pittsfield",3,1,0,0,4
"6247","plantation_",0,4,0,0,4
"6248","pledge",1,2,1,0,4
"6249","plotting",3,1,0,0,4
"6250","plow",1,2,0,1,4
"6251","plowing",0,2,0,2,4
"6252","plundering",2,1,1,0,4
"6253","pollution",0,2,2,0,4
"6254","portico",3,1,0,0,4
"6255","ports",2,2,0,0,4
"6256","positively",2,2,0,0,4
"6257","postponed",2,2,0,0,4
"6258","potent",3,1,0,0,4
"6259","pouring",1,2,1,0,4
"6260","powerless",3,1,0,0,4
"6261","practices",1,3,0,0,4
"6262","preparations",2,2,0,0,4
"6263","presidency",4,0,0,0,4
"6264","prevail",3,1,0,0,4
"6265","prevalence",2,2,0,0,4
"6266","priceless",2,2,0,0,4
"6267","principal",3,0,1,0,4
"6268","priscilla",0,3,1,0,4
"6269","privately",2,2,0,0,4
"6270","privileged",1,2,1,0,4
"6271","probabilities",1,3,0,0,4
"6272","production",2,0,1,1,4
"6273","profane",0,1,3,0,4
"6274","proficiency",2,2,0,0,4
"6275","profit",2,2,0,0,4
"6276","profligate",1,2,1,0,4
"6277","profounder",2,2,0,0,4
"6278","profoundly",1,1,2,0,4
"6279","project",4,0,0,0,4
"6280","projectors",2,2,0,0,4
"6281","prominence",4,0,0,0,4
"6282","prompted",1,1,2,0,4
"6283","promptness",2,2,0,0,4
"6284","propose",4,0,0,0,4
"6285","propositions",3,1,0,0,4
"6286","proprietor",4,0,0,0,4
"6287","proudly",2,1,0,1,4
"6288","providing",2,2,0,0,4
"6289","provisions",3,1,0,0,4
"6290","prudent",2,2,0,0,4
"6291","purchasers",1,3,0,0,4
"6292","purposely",2,2,0,0,4
"6293","purvis",4,0,0,0,4
"6294","putnam",0,0,0,4,4
"6295","puzzling",2,2,0,0,4
"6296","quakers",3,1,0,0,4
"6297","qualified",2,1,1,0,4
"6298","rabbits",2,2,0,0,4
"6299","raiment",1,3,0,0,4
"6300","ransom",2,2,0,0,4
"6301","rapture",1,1,2,0,4
"6302","rapturous",0,2,2,0,4
"6303","rascality",2,2,0,0,4
"6304","realize",2,1,1,0,4
"6305","rearing",1,3,0,0,4
"6306","rebellious",3,0,1,0,4
"6307","recommend",2,1,1,0,4
"6308","recommended",3,1,0,0,4
"6309","reconciled",2,2,0,0,4
"6310","redeem",1,3,0,0,4
"6311","reformers",1,2,1,0,4
"6312","regenerated",3,1,0,0,4
"6313","regretting",1,2,1,0,4
"6314","rejoicing",2,2,0,0,4
"6315","rekindled",2,1,1,0,4
"6316","relative",1,2,1,0,4
"6317","relatives",2,2,0,0,4
"6318","relegion",0,0,0,4,4
"6319","relying",1,2,1,0,4
"6320","remembrance",2,1,1,0,4
"6321","remotest",3,1,0,0,4
"6322","rending",0,2,2,0,4
"6323","repair",1,2,0,1,4
"6324","repaired",3,1,0,0,4
"6325","repent",2,2,0,0,4
"6326","republicanism",1,3,0,0,4
"6327","reputed",2,2,0,0,4
"6328","resides",1,3,0,0,4
"6329","respective",4,0,0,0,4
"6330","responded",4,0,0,0,4
"6331","rested",1,2,0,1,4
"6332","restraints",2,2,0,0,4
"6333","retreat",3,1,0,0,4
"6334","revealing",1,2,1,0,4
"6335","reverend",3,0,1,0,4
"6336","riches",2,1,1,0,4
"6337","ridicule",1,2,1,0,4
"6338","rife",2,2,0,0,4
"6339","righteousness",2,2,0,0,4
"6340","ringing",2,2,0,0,4
"6341","rival",2,1,0,1,4
"6342","rivet",2,2,0,0,4
"6343","rods",1,1,2,0,4
"6344","roughly",3,1,0,0,4
"6345","rub",2,1,1,0,4
"6346","rum",2,1,1,0,4
"6347","ruthlessly",2,2,0,0,4
"6348","sacredness",1,2,1,0,4
"6349","saddest",3,1,0,0,4
"6350","saddled",2,2,0,0,4
"6351","sailing",1,2,1,0,4
"6352","sailors",2,2,0,0,4
"6353","saith",2,1,1,0,4
"6354","sally",1,2,1,0,4
"6355","salts",2,1,1,0,4
"6356","sanguinary",4,0,0,0,4
"6357","saplings",2,2,0,0,4
"6358","scandal",2,2,0,0,4
"6359","scholar",4,0,0,0,4
"6360","scientific",2,1,0,1,4
"6361","secede",4,0,0,0,4
"6362","secretaries",3,1,0,0,4
"6363","seedling",2,2,0,0,4
"6364","seeks",2,2,0,0,4
"6365","senseless",3,1,0,0,4
"6366","sentences",3,1,0,0,4
"6367","serpent",2,2,0,0,4
"6368","session",4,0,0,0,4
"6369","settlers",2,2,0,0,4
"6370","severest",0,1,3,0,4
"6371","shaken",3,0,0,1,4
"6372","shaking",3,1,0,0,4
"6373","sham",1,3,0,0,4
"6374","shaping",2,2,0,0,4
"6375","shed",4,0,0,0,4
"6376","sheet",3,1,0,0,4
"6377","sheltered",3,1,0,0,4
"6378","sheridan",1,2,1,0,4
"6379","sheriff",2,1,1,0,4
"6380","shine",1,2,1,0,4
"6381","ship’s",2,2,0,0,4
"6382","shipping",1,2,1,0,4
"6383","shocks",2,2,0,0,4
"6384","shoots",2,2,0,0,4
"6385","shortly",2,2,0,0,4
"6386","shout",3,1,0,0,4
"6387","shrieks",1,1,2,0,4
"6388","shrug",2,2,0,0,4
"6389","shuddering",2,2,0,0,4
"6390","shun",1,3,0,0,4
"6391","shutting",0,3,1,0,4
"6392","sickly",2,1,1,0,4
"6393","simultaneous",2,2,0,0,4
"6394","sinews",2,2,0,0,4
"6395","sinful",1,3,0,0,4
"6396","sketch",1,3,0,0,4
"6397","skillful",3,0,0,1,4
"6398","slash",1,2,1,0,4
"6399","slavea",4,0,0,0,4
"6400","slaves’",4,0,0,0,4
"6401","slavish",1,3,0,0,4
"6402","sleepless",2,1,1,0,4
"6403","smite",2,1,1,0,4
"6404","snakes",1,1,2,0,4
"6405","soberly",2,1,1,0,4
"6406","sojourner",2,2,0,0,4
"6407","sores",1,2,1,0,4
"6408","soul’s",1,2,1,0,4
"6409","sour",2,2,0,0,4
"6410","spark",2,1,1,0,4
"6411","spontaneous",2,2,0,0,4
"6412","spree",2,2,0,0,4
"6413","springfield",4,0,0,0,4
"6414","springing",2,1,1,0,4
"6415","spur",2,2,0,0,4
"6416","stating",1,3,0,0,4
"6417","stealer",0,1,3,0,4
"6418","stealers",0,2,2,0,4
"6419","stings",1,2,1,0,4
"6420","stir",3,1,0,0,4
"6421","stirring",1,2,1,0,4
"6422","stray",3,1,0,0,4
"6423","strikes",2,2,0,0,4
"6424","structure",0,1,0,3,4
"6425","stupid",1,2,1,0,4
"6426","subordinate",2,2,0,0,4
"6427","suiting",1,2,1,0,4
"6428","summary",2,2,0,0,4
"6429","summer’s",2,1,1,0,4
"6430","summons",2,1,1,0,4
"6431","sums",4,0,0,0,4
"6432","sunder",1,2,1,0,4
"6433","sunset",3,0,1,0,4
"6434","superiority",2,2,0,0,4
"6435","surge",1,2,1,0,4
"6436","surpass",1,2,0,1,4
"6437","survive",4,0,0,0,4
"6438","suspended",1,1,1,1,4
"6439","swagger",2,2,0,0,4
"6440","swan",2,2,0,0,4
"6441","swearing",1,2,1,0,4
"6442","swell",1,3,0,0,4
"6443","sympathize",1,2,1,0,4
"6444","systematic",2,2,0,0,4
"6445","taber",3,0,1,0,4
"6446","tainted",2,2,0,0,4
"6447","tale",0,3,1,0,4
"6448","tales",2,1,1,0,4
"6449","tantalizing",2,2,0,0,4
"6450","tastes",1,3,0,0,4
"6451","tattered",1,3,0,0,4
"6452","taxed",2,1,0,1,4
"6453","taxes",4,0,0,0,4
"6454","temptation",1,2,1,0,4
"6455","tempting",3,1,0,0,4
"6456","tendrils",2,2,0,0,4
"6457","territorial",4,0,0,0,4
"6458","tested",1,1,2,0,4
"6459","text",2,2,0,0,4
"6460","thank",4,0,0,0,4
"6461","thanksgiving",2,1,1,0,4
"6462","theater",4,0,0,0,4
"6463","thee",1,3,0,0,4
"6464","thereunto",2,2,0,0,4
"6465","thinly",2,2,0,0,4
"6466","thirsty",1,1,2,0,4
"6467","thomas’s",0,2,2,0,4
"6468","thorny",2,2,0,0,4
"6469","throwing",1,1,2,0,4
"6470","tigers",2,2,0,0,4
"6471","timbers",2,2,0,0,4
"6472","tolerable",1,3,0,0,4
"6473","tolerate",3,1,0,0,4
"6474","tongues",1,1,0,2,4
"6475","tony",1,1,2,0,4
"6476","tormented",1,2,1,0,4
"6477","tortured",2,1,0,1,4
"6478","trace",0,1,2,1,4
"6479","trades",4,0,0,0,4
"6480","traffic",0,4,0,0,4
"6481","trampled",1,3,0,0,4
"6482","transacted",2,2,0,0,4
"6483","transpired",2,2,0,0,4
"6484","travels",2,1,1,0,4
"6485","treasure",3,1,0,0,4
"6486","treasury",3,1,0,0,4
"6487","tremont",4,0,0,0,4
"6488","trifling",2,2,0,0,4
"6489","truer",2,2,0,0,4
"6490","truths",2,1,1,0,4
"6491","tumble",1,3,0,0,4
"6492","type",2,2,0,0,4
"6493","unacquainted",1,1,2,0,4
"6494","unarmed",2,1,1,0,4
"6495","unavailing",2,2,0,0,4
"6496","uncles",2,2,0,0,4
"6497","uncomfortable",2,2,0,0,4
"6498","unconcerned",2,2,0,0,4
"6499","uncounted",3,1,0,0,4
"6500","underwent",1,1,2,0,4
"6501","undisguised",2,2,0,0,4
"6502","unequal",2,2,0,0,4
"6503","unfold",1,2,1,0,4
"6504","unhesitatingly",1,1,2,0,4
"6505","unique",1,3,0,0,4
"6506","unite",2,2,0,0,4
"6507","unmitigated",2,2,0,0,4
"6508","unrelenting",1,2,1,0,4
"6509","unscrupulous",2,2,0,0,4
"6510","unshaken",1,2,1,0,4
"6511","untiring",1,1,2,0,4
"6512","unwelcome",3,1,0,0,4
"6513","uprightness",3,1,0,0,4
"6514","upset",1,1,2,0,4
"6515","vague",1,1,2,0,4
"6516","variance",3,1,0,0,4
"6517","varied",1,2,0,1,4
"6518","varieties",3,1,0,0,4
"6519","vehemence",4,0,0,0,4
"6520","venerable",3,0,0,1,4
"6521","ventures",1,2,1,0,4
"6522","verging",3,1,0,0,4
"6523","vermont",4,0,0,0,4
"6524","vi",0,2,2,0,4
"6525","vicinity",1,2,0,1,4
"6526","vicious",1,2,1,0,4
"6527","vigor",4,0,0,0,4
"6528","villages",1,2,1,0,4
"6529","vindicate",1,2,1,0,4
"6530","violated",1,3,0,0,4
"6531","visage",2,2,0,0,4
"6532","vulgarity",2,2,0,0,4
"6533","wanton",3,1,0,0,4
"6534","war”",4,0,0,0,4
"6535","warmhearted",3,0,1,0,4
"6536","watchman",2,1,1,0,4
"6537","waxed",2,2,0,0,4
"6538","weaken",3,1,0,0,4
"6539","week’s",1,1,2,0,4
"6540","whatsoever",2,2,0,0,4
"6541","wheelwrights",1,3,0,0,4
"6542","whispered",1,2,1,0,4
"6543","whit",2,1,0,1,4
"6544","widespread",4,0,0,0,4
"6545","widow",3,1,0,0,4
"6546","wield",3,1,0,0,4
"6547","wielding",1,3,0,0,4
"6548","wine",3,1,0,0,4
"6549","winning",2,1,1,0,4
"6550","wiry",2,2,0,0,4
"6551","withheld",2,1,1,0,4
"6552","withholding",3,1,0,0,4
"6553","wolf",2,2,0,0,4
"6554","wolfish",2,2,0,0,4
"6555","wont",2,2,0,0,4
"6556","woolen",3,1,0,0,4
"6557","workmanship",3,1,0,0,4
"6558","worm",1,3,0,0,4
"6559","writers",3,1,0,0,4
"6560","xi",0,2,2,0,4
"6561","xxi",2,2,0,0,4
"6562","yes",3,0,0,1,4
"6563","yielded",4,0,0,0,4
"6564","zealous",3,1,0,0,4
"6565","_black_",0,3,0,0,3
"6566","_class",0,3,0,0,3
"6567","_color_",0,3,0,0,3
"6568","_he_",0,3,0,0,3
"6569","_may_",0,2,1,0,3
"6570","_new",0,2,1,0,3
"6571","_one_",0,3,0,0,3
"6572","_right_",0,3,0,0,3
"6573","_she_",0,3,0,0,3
"6574","_slave_",0,3,0,0,3
"6575","_slavery",0,2,1,0,3
"6576","_too",0,3,0,0,3
"6577","_what",0,3,0,0,3
"6578","_you",0,2,1,0,3
"6579","“come",3,0,0,0,3
"6580","“give",3,0,0,0,3
"6581","“inch”",3,0,0,0,3
"6582","“kill",3,0,0,0,3
"6583","“little",3,0,0,0,3
"6584","“make",3,0,0,0,3
"6585","“neither",3,0,0,0,3
"6586","“new",3,0,0,0,3
"6587","“oh",3,0,0,0,3
"6588","“tell",3,0,0,0,3
"6589","“uncle",3,0,0,0,3
"6590","“well”",3,0,0,0,3
"6591","10",0,3,0,0,3
"6592","11",0,3,0,0,3
"6593","1852",0,3,0,0,3
"6594","1854",0,3,0,0,3
"6595","6",0,3,0,0,3
"6596","8",0,3,0,0,3
"6597","abel",1,2,0,0,3
"6598","abhor",1,1,1,0,3
"6599","abhorrent",1,2,0,0,3
"6600","acceptance",2,1,0,0,3
"6601","accepting",3,0,0,0,3
"6602","accidental",2,1,0,0,3
"6603","accompaniments",0,3,0,0,3
"6604","accountable",1,1,1,0,3
"6605","accounted",2,1,0,0,3
"6606","accumulated",2,1,0,0,3
"6607","accuracy",2,1,0,0,3
"6608","accurate",0,1,2,0,3
"6609","accurately",2,1,0,0,3
"6610","accusations",2,1,0,0,3
"6611","ached",3,0,0,0,3
"6612","acquire",2,1,0,0,3
"6613","acquitted",2,1,0,0,3
"6614","actors",2,1,0,0,3
"6615","actually",3,0,0,0,3
"6616","adapting",1,2,0,0,3
"6617","adds",0,3,0,0,3
"6618","adjutant",3,0,0,0,3
"6619","adorn",1,2,0,0,3
"6620","adultery",0,0,3,0,3
"6621","advances",1,2,0,0,3
"6622","affinities",1,2,0,0,3
"6623","afraid”",3,0,0,0,3
"6624","agitate",2,1,0,0,3
"6625","agonizing",1,2,0,0,3
"6626","agree",1,2,0,0,3
"6627","agreeably",3,0,0,0,3
"6628","aided",2,1,0,0,3
"6629","aisles",2,1,0,0,3
"6630","akin",2,1,0,0,3
"6631","albeit",1,2,0,0,3
"6632","alert",2,1,0,0,3
"6633","alida",3,0,0,0,3
"6634","allender",2,1,0,0,3
"6635","amazing",3,0,0,0,3
"6636","amy",3,0,0,0,3
"6637","anchored",2,1,0,0,3
"6638","andover",3,0,0,0,3
"6639","anew",0,1,2,0,3
"6640","angelina",3,0,0,0,3
"6641","anglo",0,3,0,0,3
"6642","animate",1,1,1,0,3
"6643","annals",2,1,0,0,3
"6644","annoyance",1,2,0,0,3
"6645","annoyances",2,1,0,0,3
"6646","anticipated",2,1,0,0,3
"6647","antics",1,2,0,0,3
"6648","anxieties",1,2,0,0,3
"6649","anxiously",2,1,0,0,3
"6650","anywise",3,0,0,0,3
"6651","apiece",2,1,0,0,3
"6652","apostrophe",1,1,1,0,3
"6653","appearing",2,1,0,0,3
"6654","appreciated",3,0,0,0,3
"6655","arbitrary",1,2,0,0,3
"6656","ardently",1,1,1,0,3
"6657","arduous",1,2,0,0,3
"6658","arisen",3,0,0,0,3
"6659","arousing",3,0,0,0,3
"6660","arsenal",3,0,0,0,3
"6661","arsenals",3,0,0,0,3
"6662","article",1,2,0,0,3
"6663","arts",3,0,0,0,3
"6664","ascribe",2,1,0,0,3
"6665","ashore",2,1,0,0,3
"6666","asks",3,0,0,0,3
"6667","assailant",1,2,0,0,3
"6668","assassin",3,0,0,0,3
"6669","assembling",2,0,0,1,3
"6670","associated",3,0,0,0,3
"6671","assumption",3,0,0,0,3
"6672","astounded",2,1,0,0,3
"6673","asylum",1,0,2,0,3
"6674","atone",1,2,0,0,3
"6675","atrocity",1,1,1,0,3
"6676","attacking",2,1,0,0,3
"6677","attends",1,2,0,0,3
"6678","attired",2,1,0,0,3
"6679","attitudes",1,2,0,0,3
"6680","attractive",3,0,0,0,3
"6681","attributes",3,0,0,0,3
"6682","attributing",2,1,0,0,3
"6683","auction",1,2,0,0,3
"6684","avarice",1,2,0,0,3
"6685","avidity",1,2,0,0,3
"6686","await",2,1,0,0,3
"6687","awe",1,2,0,0,3
"6688","awkwardly",1,2,0,0,3
"6689","aye",0,3,0,0,3
"6690","backslidden",1,2,0,0,3
"6691","bacon",2,1,0,0,3
"6692","badge",2,1,0,0,3
"6693","bailey’s",0,1,2,0,3
"6694","balanced",2,1,0,0,3
"6695","ballotbox",3,0,0,0,3
"6696","bands",0,2,1,0,3
"6697","bargains",1,2,0,0,3
"6698","barney’s",1,1,1,0,3
"6699","barouches",1,1,1,0,3
"6700","barrel",1,2,0,0,3
"6701","barrels",1,2,0,0,3
"6702","barren",0,0,0,3,3
"6703","basket",1,1,1,0,3
"6704","beal",1,1,1,0,3
"6705","beckoning",1,1,1,0,3
"6706","befall",0,2,1,0,3
"6707","befallen",1,1,1,0,3
"6708","begins",2,1,0,0,3
"6709","bells",1,1,0,1,3
"6710","bench",1,2,0,0,3
"6711","bend",2,1,0,0,3
"6712","benj",3,0,0,0,3
"6713","benjamin",2,0,0,1,3
"6714","bethel",2,1,0,0,3
"6715","betraying",1,1,1,0,3
"6716","bets",1,1,1,0,3
"6717","betty",0,3,0,0,3
"6718","beware",0,3,0,0,3
"6719","bewildering",2,1,0,0,3
"6720","bid",1,2,0,0,3
"6721","billy",1,2,0,0,3
"6722","biscuit",0,2,1,0,3
"6723","bishops",1,1,0,1,3
"6724","bitten",1,1,1,0,3
"6725","blackall",3,0,0,0,3
"6726","blacker",1,2,0,0,3
"6727","bled",2,1,0,0,3
"6728","bleed",1,1,1,0,3
"6729","blest",1,2,0,0,3
"6730","blood”",3,0,0,0,3
"6731","blown",1,1,1,0,3
"6732","blunder",3,0,0,0,3
"6733","boarding",0,1,1,1,3
"6734","boards",2,1,0,0,3
"6735","bogs",1,1,1,0,3
"6736","boiled",0,2,1,0,3
"6737","boisterous",2,1,0,0,3
"6738","bondly",0,0,3,0,3
"6739","bordered",2,1,0,0,3
"6740","bottom",1,2,0,0,3
"6741","bowed",2,1,0,0,3
"6742","bowie",0,3,0,0,3
"6743","boxing",1,1,1,0,3
"6744","brakemen",1,2,0,0,3
"6745","branch",1,2,0,0,3
"6746","bravery",3,0,0,0,3
"6747","breaker_",0,3,0,0,3
"6748","breeding",0,3,0,0,3
"6749","broadway",2,1,0,0,3
"6750","brood",1,2,0,0,3
"6751","brooms",1,1,1,0,3
"6752","brush",2,1,0,0,3
"6753","brutalized",1,2,0,0,3
"6754","brutally",1,2,0,0,3
"6755","buckingham",3,0,0,0,3
"6756","bullies",1,2,0,0,3
"6757","bully",2,1,0,0,3
"6758","burleigh",2,1,0,0,3
"6759","burying",0,3,0,0,3
"6760","button",1,1,1,0,3
"6761","cakes",1,0,2,0,3
"6762","california",2,1,0,0,3
"6763","callous",1,1,1,0,3
"6764","campmeetings",1,1,0,1,3
"6765","camps",3,0,0,0,3
"6766","candle",2,1,0,0,3
"6767","candor",2,0,1,0,3
"6768","cape",1,2,0,0,3
"6769","capitals",2,1,0,0,3
"6770","card",1,2,0,0,3
"6771","carelessness",0,1,2,0,3
"6772","carries",1,2,0,0,3
"6773","carts",0,1,0,2,3
"6774","casting",2,1,0,0,3
"6775","catholics",2,0,0,1,3
"6776","causeway",2,1,0,0,3
"6777","ceases",1,1,1,0,3
"6778","ceasing",1,1,1,0,3
"6779","celebration",2,1,0,0,3
"6780","celebrations",2,0,0,1,3
"6781","cellars",2,1,0,0,3
"6782","certificate",1,0,2,0,3
"6783","chairs",2,1,0,0,3
"6784","chalk",1,1,1,0,3
"6785","chambers",1,1,1,0,3
"6786","chanced",2,1,0,0,3
"6787","chandler",0,0,0,3,3
"6788","channel",1,2,0,0,3
"6789","charging",2,1,0,0,3
"6790","charley",0,0,0,3,3
"6791","charred",1,2,0,0,3
"6792","checked",1,2,0,0,3
"6793","cheerfully",3,0,0,0,3
"6794","cheers",0,3,0,0,3
"6795","cheese",1,1,0,1,3
"6796","chestnut",3,0,0,0,3
"6797","chicago",2,1,0,0,3
"6798","chickens",2,1,0,0,3
"6799","childhood’s",0,3,0,0,3
"6800","chisel",1,1,1,0,3
"6801","choosing",1,1,1,0,3
"6802","choptank",1,2,0,0,3
"6803","chorus",1,1,1,0,3
"6804","chose",2,1,0,0,3
"6805","chronicle",3,0,0,0,3
"6806","cipher",2,1,0,0,3
"6807","cited",1,1,1,0,3
"6808","clarkson",3,0,0,0,3
"6809","classic",1,0,0,2,3
"6810","classified",2,1,0,0,3
"6811","classleader",2,1,0,0,3
"6812","cleanly",1,1,1,0,3
"6813","clearer",1,1,1,0,3
"6814","cleave",1,2,0,0,3
"6815","climes",2,1,0,0,3
"6816","coachmen",2,1,0,0,3
"6817","coat",3,0,0,0,3
"6818","cocked",1,1,1,0,3
"6819","coldhearted",2,1,0,0,3
"6820","collar",1,1,1,0,3
"6821","collecting",1,2,0,0,3
"6822","colonel’s",1,0,2,0,3
"6823","comforted",1,2,0,0,3
"6824","coming”",3,0,0,0,3
"6825","commencing",1,1,1,0,3
"6826","commensurate",1,1,1,0,3
"6827","commercial",2,1,0,0,3
"6828","commissioned",3,0,0,0,3
"6829","communion",0,1,2,0,3
"6830","companies",2,1,0,0,3
"6831","company”",3,0,0,0,3
"6832","compels",2,0,1,0,3
"6833","compensated",1,2,0,0,3
"6834","complained",2,0,1,0,3
"6835","complement",1,2,0,0,3
"6836","completed",2,1,0,0,3
"6837","complicity",3,0,0,0,3
"6838","compose",1,1,1,0,3
"6839","comprised",2,1,0,0,3
"6840","concede",3,0,0,0,3
"6841","conceded",0,2,1,0,3
"6842","concerns",1,2,0,0,3
"6843","concert",1,1,1,0,3
"6844","concessions",3,0,0,0,3
"6845","conclusive",3,0,0,0,3
"6846","condemning",2,1,0,0,3
"6847","confederacy",2,1,0,0,3
"6848","confide",1,1,1,0,3
"6849","confronted",2,1,0,0,3
"6850","congratulations",2,1,0,0,3
"6851","congressional",3,0,0,0,3
"6852","conjurer",2,1,0,0,3
"6853","consign",3,0,0,0,3
"6854","consistency",2,1,0,0,3
"6855","consolations",1,2,0,0,3
"6856","consoled",1,1,1,0,3
"6857","conspirators",2,1,0,0,3
"6858","constructing",0,2,0,1,3
"6859","contemplation",1,2,0,0,3
"6860","contemptuously",2,1,0,0,3
"6861","contrasted",1,2,0,0,3
"6862","contribution",3,0,0,0,3
"6863","contrivances",2,1,0,0,3
"6864","controlled",2,1,0,0,3
"6865","converse",2,1,0,0,3
"6866","conversed",3,0,0,0,3
"6867","converting",1,1,1,0,3
"6868","conveyance",1,1,1,0,3
"6869","cooks",2,1,0,0,3
"6870","coons",1,1,1,0,3
"6871","cooper",2,1,0,0,3
"6872","coöperate",3,0,0,0,3
"6873","cord",2,0,1,0,3
"6874","cordiality",2,1,0,0,3
"6875","corners",2,1,0,0,3
"6876","cornmeal",2,1,0,0,3
"6877","corrected",1,1,1,0,3
"6878","corresponding",3,0,0,0,3
"6879","counteract",2,1,0,0,3
"6880","counters",3,0,0,0,3
"6881","countless",1,1,1,0,3
"6882","couple",2,1,0,0,3
"6883","coupled",1,2,0,0,3
"6884","coupling",2,1,0,0,3
"6885","courted",1,2,0,0,3
"6886","covent",3,0,0,0,3
"6887","coworker",3,0,0,0,3
"6888","coworkers",3,0,0,0,3
"6889","cowskins",1,2,0,0,3
"6890","crabs",1,2,0,0,3
"6891","crack",1,1,1,0,3
"6892","cracked",1,1,1,0,3
"6893","craftiness",1,2,0,0,3
"6894","craggy",1,1,1,0,3
"6895","cramped",1,1,0,1,3
"6896","crash",1,2,0,0,3
"6897","create",1,2,0,0,3
"6898","creating",2,0,1,0,3
"6899","crew",1,2,0,0,3
"6900","criminality",1,2,0,0,3
"6901","crop",1,2,0,0,3
"6902","crossed",2,1,0,0,3
"6903","crown",1,1,1,0,3
"6904","cuba",2,1,0,0,3
"6905","culminated",2,1,0,0,3
"6906","cunningly",1,1,1,0,3
"6907","curry",1,1,1,0,3
"6908","curtain",2,1,0,0,3
"6909","curtis",1,1,1,0,3
"6910","daggers",2,1,0,0,3
"6911","damaging",2,0,0,1,3
"6912","darkey",1,2,0,0,3
"6913","dart",1,1,1,0,3
"6914","dated",2,1,0,0,3
"6915","deaden",1,2,0,0,3
"6916","deaf",2,1,0,0,3
"6917","dealer",0,1,2,0,3
"6918","dealers",0,2,1,0,3
"6919","dealings",1,2,0,0,3
"6920","deathbed",3,0,0,0,3
"6921","deaths",1,2,0,0,3
"6922","debater",2,1,0,0,3
"6923","deceased",3,0,0,0,3
"6924","deceptions",1,1,1,0,3
"6925","declining",1,1,1,0,3
"6926","dedicated",2,1,0,0,3
"6927","deepened",1,2,0,0,3
"6928","deepening",1,2,0,0,3
"6929","deer",2,1,0,0,3
"6930","defenceless",3,0,0,0,3
"6931","defied",3,0,0,0,3
"6932","deformed",2,1,0,0,3
"6933","defy",2,1,0,0,3
"6934","degrade",2,0,0,1,3
"6935","dehumanizing",0,1,2,0,3
"6936","dejected",1,2,0,0,3
"6937","deliverer",2,1,0,0,3
"6938","delivering",3,0,0,0,3
"6939","deluded",2,1,0,0,3
"6940","dem",0,3,0,0,3
"6941","democrats",3,0,0,0,3
"6942","demonstrate",1,2,0,0,3
"6943","densely",1,1,0,1,3
"6944","dependence",2,1,0,0,3
"6945","depends",2,1,0,0,3
"6946","depot",2,1,0,0,3
"6947","descendants",0,1,2,0,3
"6948","descriptive",1,2,0,0,3
"6949","deserve",3,0,0,0,3
"6950","designated",2,1,0,0,3
"6951","detailing",1,1,1,0,3
"6952","detected",2,1,0,0,3
"6953","detest",0,2,1,0,3
"6954","developed",1,2,0,0,3
"6955","dews",1,1,1,0,3
"6956","dexterity",2,1,0,0,3
"6957","dictate",2,0,1,0,3
"6958","digressing",1,1,1,0,3
"6959","dilapidated",1,1,1,0,3
"6960","diminished",2,1,0,0,3
"6961","directing",1,2,0,0,3
"6962","directness",1,2,0,0,3
"6963","disappointing",1,0,1,1,3
"6964","discourage",2,1,0,0,3
"6965","discouraged",2,1,0,0,3
"6966","discover",3,0,0,0,3
"6967","diseases",2,1,0,0,3
"6968","disgraced",1,2,0,0,3
"6969","disguise",2,0,1,0,3
"6970","dishes",0,3,0,0,3
"6971","disinterested",2,1,0,0,3
"6972","dislike",0,3,0,0,3
"6973","dismiss",1,2,0,0,3
"6974","dismounted",1,1,1,0,3
"6975","disobedience",0,3,0,0,3
"6976","disorder",1,2,0,0,3
"6977","dispatched",3,0,0,0,3
"6978","dispelling",1,1,1,0,3
"6979","dispense",0,2,0,1,3
"6980","disquiet",1,2,0,0,3
"6981","disregarding",1,2,0,0,3
"6982","dissatisfaction",1,2,0,0,3
"6983","dissolution",1,2,0,0,3
"6984","dissolve",2,1,0,0,3
"6985","distances",2,1,0,0,3
"6986","districts",3,0,0,0,3
"6987","disturbance",2,1,0,0,3
"6988","divested",1,2,0,0,3
"6989","divulged",2,1,0,0,3
"6990","docile",2,1,0,0,3
"6991","dock",1,2,0,0,3
"6992","docks",1,0,0,2,3
"6993","document",3,0,0,0,3
"6994","dogma",0,0,0,3,3
"6995","dole",2,1,0,0,3
"6996","domination",1,2,0,0,3
"6997","done”",3,0,0,0,3
"6998","drama",2,1,0,0,3
"6999","dregs",1,1,1,0,3
"7000","droppings",0,3,0,0,3
"7001","drops",0,2,1,0,3
"7002","dumas",1,1,0,1,3
"7003","dungeon",1,2,0,0,3
"7004","durgin",0,1,2,0,3
"7005","dusky",2,1,0,0,3
"7006","dwelt",1,2,0,0,3
"7007","e c",3,0,0,0,3
"7008","earning",1,1,1,0,3
"7009","eats",1,2,0,0,3
"7010","educating",2,1,0,0,3
"7011","effectually",3,0,0,0,3
"7012","eggs",3,0,0,0,3
"7013","egyptians",1,1,0,1,3
"7014","elapsed",2,1,0,0,3
"7015","eldest",1,1,1,0,3
"7016","electoral",3,0,0,0,3
"7017","elegance",2,1,0,0,3
"7018","elevated",1,2,0,0,3
"7019","elizabeth",3,0,0,0,3
"7020","elmira",3,0,0,0,3
"7021","emigrants",1,2,0,0,3
"7022","empire",3,0,0,0,3
"7023","employing",2,1,0,0,3
"7024","endorsement",3,0,0,0,3
"7025","engine",3,0,0,0,3
"7026","enigma",2,1,0,0,3
"7027","enlighten",1,2,0,0,3
"7028","enquiry",2,0,0,1,3
"7029","enrolled",1,2,0,0,3
"7030","enslaver",1,2,0,0,3
"7031","entertaining",1,1,0,1,3
"7032","enthusiastically",2,1,0,0,3
"7033","envied",1,1,1,0,3
"7034","episcopal",2,1,0,0,3
"7035","equalled",0,0,3,0,3
"7036","equivalent",1,1,1,0,3
"7037","erroneous",2,0,1,0,3
"7038","error",2,1,0,0,3
"7039","esquire",1,1,1,0,3
"7040","ethnology",1,1,0,1,3
"7041","evade",2,1,0,0,3
"7042","evangelist",2,1,0,0,3
"7043","eventful",3,0,0,0,3
"7044","evincing",1,1,1,0,3
"7045","exactions",1,2,0,0,3
"7046","exaggerated",2,0,1,0,3
"7047","exasperate",2,1,0,0,3
"7048","excellency",1,2,0,0,3
"7049","excess",1,0,2,0,3
"7050","exclaimed",2,1,0,0,3
"7051","exclude",3,0,0,0,3
"7052","exculpate",0,2,1,0,3
"7053","excursion",0,0,0,3,3
"7054","execrated",1,2,0,0,3
"7055","execrations",1,2,0,0,3
"7056","exemplary",1,2,0,0,3
"7057","exert",1,2,0,0,3
"7058","exhortations",2,1,0,0,3
"7059","exhorted",1,1,1,0,3
"7060","exhorter",1,1,1,0,3
"7061","expelled",1,1,0,1,3
"7062","expending",2,1,0,0,3
"7063","expert",2,1,0,0,3
"7064","explosive",2,1,0,0,3
"7065","expressing",3,0,0,0,3
"7066","expressions",2,1,0,0,3
"7067","expressly",2,1,0,0,3
"7068","extorted",1,1,1,0,3
"7069","extravagance",2,1,0,0,3
"7070","extremes",0,3,0,0,3
"7071","extremities",1,1,1,0,3
"7072","exultingly",1,1,1,0,3
"7073","eyeball",1,1,1,0,3
"7074","facility",3,0,0,0,3
"7075","faction",3,0,0,0,3
"7076","faded",1,2,0,0,3
"7077","failing",2,1,0,0,3
"7078","failures",2,1,0,0,3
"7079","famed",0,0,0,3,3
"7080","fanatic",2,1,0,0,3
"7081","faneuil",3,0,0,0,3
"7082","fanned",1,1,1,0,3
"7083","farewell",1,2,0,0,3
"7084","farmington",3,0,0,0,3
"7085","favors",1,0,2,0,3
"7086","fearing",1,2,0,0,3
"7087","fearless",1,1,1,0,3
"7088","feasibility",2,1,0,0,3
"7089","feasible",1,1,1,0,3
"7090","feasting",1,1,1,0,3
"7091","feather",1,2,0,0,3
"7092","feb",0,0,0,3,3
"7093","feign",2,1,0,0,3
"7094","fellowcountrymen",3,0,0,0,3
"7095","fellowservants",3,0,0,0,3
"7096","felon",1,1,1,0,3
"7097","female",1,1,1,0,3
"7098","fettered",0,3,0,0,3
"7099","fewest",2,1,0,0,3
"7100","fiddling",1,1,1,0,3
"7101","figs",1,1,0,1,3
"7102","fillmore",2,1,0,0,3
"7103","finish",3,0,0,0,3
"7104","finsbury",0,3,0,0,3
"7105","firmer",3,0,0,0,3
"7106","fitly",1,1,0,1,3
"7107","flagrant",2,1,0,0,3
"7108","flags",1,1,0,1,3
"7109","flame",2,1,0,0,3
"7110","flames",3,0,0,0,3
"7111","flashing",1,2,0,0,3
"7112","fleet",2,1,0,0,3
"7113","flickered",1,1,1,0,3
"7114","flickering",1,1,1,0,3
"7115","fling",2,1,0,0,3
"7116","flinging",1,2,0,0,3
"7117","flint",2,1,0,0,3
"7118","flintiest",3,0,0,0,3
"7119","floating",0,2,0,1,3
"7120","flogged",2,1,0,0,3
"7121","flowed",2,1,0,0,3
"7122","fold",1,1,1,0,3
"7123","fool",2,1,0,0,3
"7124","footsteps",1,2,0,0,3
"7125","forcibly",2,1,0,0,3
"7126","foreseen",2,1,0,0,3
"7127","foreshadowed",3,0,0,0,3
"7128","forests",2,1,0,0,3
"7129","forgive",1,2,0,0,3
"7130","forthcoming",1,1,1,0,3
"7131","fortified",3,0,0,0,3
"7132","fostering",1,2,0,0,3
"7133","foulest",1,1,1,0,3
"7134","founder",2,1,0,0,3
"7135","fourthly",2,1,0,0,3
"7136","fragments",2,0,0,1,3
"7137","franchise",2,1,0,0,3
"7138","francis",2,1,0,0,3
"7139","franklin",2,0,0,1,3
"7140","freedom_",0,2,1,0,3
"7141","fret",1,1,1,0,3
"7142","frightened",2,1,0,0,3
"7143","frightfully",1,1,1,0,3
"7144","frontyard",3,0,0,0,3
"7145","frozen",1,1,1,0,3
"7146","fruitless",2,1,0,0,3
"7147","funeral",1,1,0,1,3
"7148","gait",1,2,0,0,3
"7149","galled",1,1,0,1,3
"7150","gallery",0,1,0,2,3
"7151","gallop",1,2,0,0,3
"7152","gazed",2,1,0,0,3
"7153","gentleness",1,1,1,0,3
"7154","gentry",1,2,0,0,3
"7155","geo",3,0,0,0,3
"7156","gestures",1,2,0,0,3
"7157","gifted",3,0,0,0,3
"7158","gilded",2,1,0,0,3
"7159","giles",1,1,1,0,3
"7160","glanced",2,1,0,0,3
"7161","glancing",2,1,0,0,3
"7162","gleesome",1,2,0,0,3
"7163","glimmering",0,2,1,0,3
"7164","goal",2,1,0,0,3
"7165","godlike",0,1,2,0,3
"7166","gong",2,0,0,1,3
"7167","goodell",3,0,0,0,3
"7168","goodly",2,1,0,0,3
"7169","goodnatured",3,0,0,0,3
"7170","goods",3,0,0,0,3
"7171","gore’s",1,1,1,0,3
"7172","govern",1,1,1,0,3
"7173","governing",2,1,0,0,3
"7174","gracious",1,1,0,1,3
"7175","graduate",0,3,0,0,3
"7176","grafton",3,0,0,0,3
"7177","grander",2,1,0,0,3
"7178","granville",3,0,0,0,3
"7179","grated",1,2,0,0,3
"7180","gratefully",3,0,0,0,3
"7181","grating",1,2,0,0,3
"7182","graveyard",2,1,0,0,3
"7183","gravity",2,1,0,0,3
"7184","greedily",1,1,1,0,3
"7185","greek",2,0,0,1,3
"7186","greenfield",2,1,0,0,3
"7187","greenish",1,2,0,0,3
"7188","greet",1,0,0,2,3
"7189","griefs",1,2,0,0,3
"7190","grievously",2,1,0,0,3
"7191","grinding",1,1,1,0,3
"7192","grinned",1,1,1,0,3
"7193","groans",0,1,2,0,3
"7194","gropes",1,1,1,0,3
"7195","guidance",1,1,1,0,3
"7196","guided",1,2,0,0,3
"7197","gushed",1,1,1,0,3
"7198","h b",3,0,0,0,3
"7199","habitable",1,1,1,0,3
"7200","haggard",1,2,0,0,3
"7201","hairbreadth",3,0,0,0,3
"7202","halt",2,1,0,0,3
"7203","halting",1,1,1,0,3
"7204","handle",1,2,0,0,3
"7205","hands”",3,0,0,0,3
"7206","happier",1,0,2,0,3
"7207","hardness",1,1,0,1,3
"7208","harrison",0,1,2,0,3
"7209","harvest",1,1,1,0,3
"7210","harvey",1,0,0,2,3
"7211","hatchet",1,1,1,0,3
"7212","hates",0,3,0,0,3
"7213","hath",2,1,0,0,3
"7214","head”",3,0,0,0,3
"7215","healed",2,1,0,0,3
"7216","hears",1,1,1,0,3
"7217","heartlessly",1,2,0,0,3
"7218","heated",1,2,0,0,3
"7219","heeded",3,0,0,0,3
"7220","heels",0,2,0,1,3
"7221","heighten",1,1,0,1,3
"7222","helpful",3,0,0,0,3
"7223","hen",1,2,0,0,3
"7224","hereditary",0,3,0,0,3
"7225","herod",1,1,1,0,3
"7226","herrings",1,2,0,0,3
"7227","hester",0,0,3,0,3
"7228","hewing",1,1,1,0,3
"7229","highhanded",3,0,0,0,3
"7230","hint",2,0,0,1,3
"7231","hoboken",3,0,0,0,3
"7232","holder",0,3,0,0,3
"7233","holes",2,1,0,0,3
"7234","homage",2,0,1,0,3
"7235","home”",3,0,0,0,3
"7236","homeless",0,1,2,0,3
"7237","homeward",1,1,0,1,3
"7238","hood",0,3,0,0,3
"7239","hour’s",2,1,0,0,3
"7240","howland",3,0,0,0,3
"7241","humblest",1,1,1,0,3
"7242","hurl",1,2,0,0,3
"7243","hurt",1,0,1,1,3
"7244","hypocritical",1,1,1,0,3
"7245","ideal",1,2,0,0,3
"7246","illustrates",3,0,0,0,3
"7247","imbue",1,1,1,0,3
"7248","imitation",2,0,1,0,3
"7249","imminent",3,0,0,0,3
"7250","immovable",2,1,0,0,3
"7251","impartiality",3,0,0,0,3
"7252","imparting",2,1,0,0,3
"7253","impatience",1,2,0,0,3
"7254","implements",1,2,0,0,3
"7255","implication",3,0,0,0,3
"7256","imported",1,2,0,0,3
"7257","importunities",1,2,0,0,3
"7258","impracticable",2,1,0,0,3
"7259","improvements",2,0,0,1,3
"7260","impulse",2,1,0,0,3
"7261","impulsive",2,1,0,0,3
"7262","inborn",1,2,0,0,3
"7263","inclines",1,1,1,0,3
"7264","incoherent",1,1,1,0,3
"7265","incompatible",1,1,1,0,3
"7266","indestructible",0,3,0,0,3
"7267","indicate",3,0,0,0,3
"7268","indicating",1,1,1,0,3
"7269","indirect",1,2,0,0,3
"7270","indirection",2,1,0,0,3
"7271","indulgence",2,1,0,0,3
"7272","infamous",2,1,0,0,3
"7273","infer",1,1,1,0,3
"7274","infested",2,1,0,0,3
"7275","inflictions",0,3,0,0,3
"7276","informant",1,1,1,0,3
"7277","infuriated",1,2,0,0,3
"7278","innumerable",1,1,0,1,3
"7279","inoperative",2,1,0,0,3
"7280","inquirer",1,1,1,0,3
"7281","insecure",3,0,0,0,3
"7282","insertion",1,2,0,0,3
"7283","insignificant",2,1,0,0,3
"7284","inspection",1,1,1,0,3
"7285","instinct",1,2,0,0,3
"7286","institute",1,1,1,0,3
"7287","instrumental",1,1,1,0,3
"7288","instrumentalities",1,2,0,0,3
"7289","insufficient",1,1,1,0,3
"7290","insuperable",2,1,0,0,3
"7291","intellects",1,1,1,0,3
"7292","intensified",1,2,0,0,3
"7293","interfered",1,1,1,0,3
"7294","interpose",1,1,1,0,3
"7295","interpretation",1,2,0,0,3
"7296","interruption",1,1,1,0,3
"7297","interval",1,1,1,0,3
"7298","intervening",2,1,0,0,3
"7299","intimacy",1,2,0,0,3
"7300","intruder",1,2,0,0,3
"7301","invite",1,1,0,1,3
"7302","inviter",2,1,0,0,3
"7303","involve",1,2,0,0,3
"7304","involving",2,1,0,0,3
"7305","ironlike",2,1,0,0,3
"7306","irreconcilable",1,2,0,0,3
"7307","issuing",2,1,0,0,3
"7308","jargon",0,2,1,0,3
"7309","jeers",1,2,0,0,3
"7310","jerry",1,2,0,0,3
"7311","johnsons",0,2,1,0,3
"7312","joining",0,3,0,0,3
"7313","joke",2,1,0,0,3
"7314","jokes",1,1,1,0,3
"7315","jonathan",3,0,0,0,3
"7316","joshua",3,0,0,0,3
"7317","journeymen",1,1,1,0,3
"7318","jubilee",1,2,0,0,3
"7319","judges",2,1,0,0,3
"7320","justly",2,1,0,0,3
"7321","katy’s",2,1,0,0,3
"7322","keelson",2,1,0,0,3
"7323","keys",2,1,0,0,3
"7324","kicking",2,1,0,0,3
"7325","kicks",1,1,1,0,3
"7326","kindled",1,2,0,0,3
"7327","kindliest",2,1,0,0,3
"7328","kindling",1,2,0,0,3
"7329","kirk",3,0,0,0,3
"7330","kitchens",1,2,0,0,3
"7331","kossuth",0,3,0,0,3
"7332","langston",3,0,0,0,3
"7333","languished",1,1,1,0,3
"7334","lapse",3,0,0,0,3
"7335","lashed",1,1,1,0,3
"7336","laughing",1,2,0,0,3
"7337","laughingly",1,1,1,0,3
"7338","law’s",1,1,1,0,3
"7339","leader_",0,3,0,0,3
"7340","leaning",1,1,1,0,3
"7341","leaping",1,1,0,1,3
"7342","lecturing",1,1,1,0,3
"7343","ledger",0,3,0,0,3
"7344","lee’s",1,1,1,0,3
"7345","legged",0,2,1,0,3
"7346","lends",0,2,1,0,3
"7347","liberality",2,1,0,0,3
"7348","liberally",3,0,0,0,3
"7349","lifea",3,0,0,0,3
"7350","limitations",2,1,0,0,3
"7351","lineal",1,1,1,0,3
"7352","literature",2,1,0,0,3
"7353","livery",1,0,2,0,3
"7354","lloyd”",3,0,0,0,3
"7355","localities",3,0,0,0,3
"7356","lodged",2,1,0,0,3
"7357","lodging",1,1,0,1,3
"7358","log",1,2,0,0,3
"7359","loguen",2,1,0,0,3
"7360","longing",2,1,0,0,3
"7361","lookout",2,1,0,0,3
"7362","loosed",1,1,1,0,3
"7363","lots",1,2,0,0,3
"7364","louder",0,1,2,0,3
"7365","louis",2,1,0,0,3
"7366","lowly",1,0,1,1,3
"7367","lucern",0,0,0,3,3
"7368","lukewarm",1,2,0,0,3
"7369","lunch",2,0,0,1,3
"7370","lust",0,2,0,1,3
"7371","luther",1,1,1,0,3
"7372","lyceums",2,1,0,0,3
"7373","lynch",1,1,1,0,3
"7374","madam",3,0,0,0,3
"7375","madly",2,1,0,0,3
"7376","magnificence",2,1,0,0,3
"7377","magnitude",2,1,0,0,3
"7378","mail",3,0,0,0,3
"7379","maimed",2,1,0,0,3
"7380","mainspring",3,0,0,0,3
"7381","makers",1,2,0,0,3
"7382","malady",3,0,0,0,3
"7383","malignant",2,1,0,0,3
"7384","maltreated",2,1,0,0,3
"7385","manchester",2,0,0,1,3
"7386","manifesting",1,1,1,0,3
"7387","mann",3,0,0,0,3
"7388","manual",2,1,0,0,3
"7389","manufactured",1,0,0,2,3
"7390","manure",1,1,1,0,3
"7391","manuscript",1,2,0,0,3
"7392","mapped",3,0,0,0,3
"7393","marking",3,0,0,0,3
"7394","marred",1,1,0,1,3
"7395","marsh",2,0,0,1,3
"7396","martyr",3,0,0,0,3
"7397","martyrs",2,1,0,0,3
"7398","marvel",1,2,0,0,3
"7399","materially",1,1,1,0,3
"7400","materials",1,2,0,0,3
"7401","maternal",1,2,0,0,3
"7402","mats",1,1,1,0,3
"7403","matted",1,1,1,0,3
"7404","maturity",1,2,0,0,3
"7405","me_",0,2,1,0,3
"7406","mediteranian",0,0,0,3,3
"7407","medium",2,1,0,0,3
"7408","meekness",1,1,1,0,3
"7409","meetinghouse",2,0,1,0,3
"7410","meets",0,2,1,0,3
"7411","melancholy",1,2,0,0,3
"7412","memories",2,0,1,0,3
"7413","mended",1,1,0,1,3
"7414","merest",1,0,2,0,3
"7415","merrily",1,1,1,0,3
"7416","methodists",1,2,0,0,3
"7417","mexican",1,1,1,0,3
"7418","militia",3,0,0,0,3
"7419","milk",1,2,0,0,3
"7420","miller",0,3,0,0,3
"7421","minor",1,2,0,0,3
"7422","mischievous",1,2,0,0,3
"7423","missed",1,2,0,0,3
"7424","missing",2,1,0,0,3
"7425","missionary",2,0,0,1,3
"7426","misty",1,1,1,0,3
"7427","mixed",1,2,0,0,3
"7428","moans",1,1,1,0,3
"7429","mobile",1,2,0,0,3
"7430","mobocrats",2,1,0,0,3
"7431","moderation",3,0,0,0,3
"7432","modified",2,1,0,0,3
"7433","molest",1,2,0,0,3
"7434","momentary",2,0,0,1,3
"7435","mongers",0,2,1,0,3
"7436","monsters",0,2,1,0,3
"7437","moods",2,1,0,0,3
"7438","moorings",1,1,1,0,3
"7439","moroni",0,0,0,3,3
"7440","mortals",0,3,0,0,3
"7441","motto",1,0,2,0,3
"7442","mouldering",1,0,1,1,3
"7443","mule",2,1,0,0,3
"7444","muscles",1,2,0,0,3
"7445","museum",0,0,0,3,3
"7446","musical",2,1,0,0,3
"7447","mute",0,3,0,0,3
"7448","mutilated",3,0,0,0,3
"7449","mutton",1,1,1,0,3
"7450","myron",3,0,0,0,3
"7451","namely",3,0,0,0,3
"7452","napoleon",1,1,1,0,3
"7453","naturethe",3,0,0,0,3
"7454","necked",0,3,0,0,3
"7455","necks",1,1,1,0,3
"7456","needles",3,0,0,0,3
"7457","negative",1,1,1,0,3
"7458","negro’s",3,0,0,0,3
"7459","neighbor",1,0,0,2,3
"7460","nicely",2,1,0,0,3
"7461","niggers”",3,0,0,0,3
"7462","nigh",1,1,1,0,3
"7463","night’s",2,1,0,0,3
"7464","nineteen",2,1,0,0,3
"7465","nineteenth",2,1,0,0,3
"7466","nod",1,1,1,0,3
"7467","noisome",1,1,1,0,3
"7468","numbering",2,0,1,0,3
"7469","nursed",3,0,0,0,3
"7470","o’er",1,2,0,0,3
"7471","objected",3,0,0,0,3
"7472","obligations",2,1,0,0,3
"7473","obnoxious",2,1,0,0,3
"7474","oct",1,1,0,1,3
"7475","odious",2,1,0,0,3
"7476","odium",1,1,1,0,3
"7477","odor",1,2,0,0,3
"7478","offender",2,1,0,0,3
"7479","oldfashioned",3,0,0,0,3
"7480","onehalf",3,0,0,0,3
"7481","oozing",1,1,1,0,3
"7482","operating",2,1,0,0,3
"7483","opossums",1,1,1,0,3
"7484","oppress",2,1,0,0,3
"7485","orange",1,1,1,0,3
"7486","oranges",0,0,0,3,3
"7487","orations",2,1,0,0,3
"7488","ordained",1,1,1,0,3
"7489","order”",3,0,0,0,3
"7490","organ",1,2,0,0,3
"7491","organs",1,2,0,0,3
"7492","originated",2,1,0,0,3
"7493","ornamental",1,1,0,1,3
"7494","ostensibly",2,1,0,0,3
"7495","other’s",0,3,0,0,3
"7496","outcry",1,2,0,0,3
"7497","outlay",1,2,0,0,3
"7498","outlook",2,0,0,1,3
"7499","outsider",1,2,0,0,3
"7500","overheard",1,1,0,1,3
"7501","overshadowed",1,2,0,0,3
"7502","overshadows",2,0,1,0,3
"7503","overthrew",1,2,0,0,3
"7504","overwhelming",0,2,1,0,3
"7505","owl",1,1,1,0,3
"7506","paddle",1,1,1,0,3
"7507","pained",2,1,0,0,3
"7508","painstaking",2,1,0,0,3
"7509","paint",2,1,0,0,3
"7510","palms",1,1,0,1,3
"7511","panicstricken",3,0,0,0,3
"7512","parade",0,1,0,2,3
"7513","parcel",1,1,1,0,3
"7514","parcels",1,2,0,0,3
"7515","parchment",2,1,0,0,3
"7516","parental",0,2,1,0,3
"7517","parlance",1,2,0,0,3
"7518","participated",2,1,0,0,3
"7519","particular",3,0,0,0,3
"7520","particularly",3,0,0,0,3
"7521","passport",3,0,0,0,3
"7522","paternity",1,2,0,0,3
"7523","pathetic",0,1,2,0,3
"7524","patient",1,1,1,0,3
"7525","patrol",1,1,1,0,3
"7526","paused",1,2,0,0,3
"7527","pavement",1,1,1,0,3
"7528","peaches",1,2,0,0,3
"7529","peck",0,2,1,0,3
"7530","pedestal",2,0,0,1,3
"7531","peeped",2,1,0,0,3
"7532","peleg",3,0,0,0,3
"7533","pending",2,1,0,0,3
"7534","penn",3,0,0,0,3
"7535","peopled",1,1,1,0,3
"7536","perceived",1,1,1,0,3
"7537","perfections",2,0,0,1,3
"7538","perpetrating",1,1,1,0,3
"7539","perpetually",0,2,1,0,3
"7540","persecutions",2,1,0,0,3
"7541","persist",1,1,1,0,3
"7542","pestiferous",1,2,0,0,3
"7543","petted",1,2,0,0,3
"7544","phaetons",2,1,0,0,3
"7545","phenomenon",1,2,0,0,3
"7546","phil",0,3,0,0,3
"7547","pilate",1,1,1,0,3
"7548","pillow",1,2,0,0,3
"7549","pirates",1,1,1,0,3
"7550","plaintive",1,2,0,0,3
"7551","plank",2,1,0,0,3
"7552","plant",2,0,1,0,3
"7553","playfully",2,1,0,0,3
"7554","pleaded",2,1,0,0,3
"7555","plunder",2,1,0,0,3
"7556","plundered",1,1,1,0,3
"7557","plunderers",1,1,1,0,3
"7558","plunged",1,1,1,0,3
"7559","ply",1,1,1,0,3
"7560","pocketed",1,2,0,0,3
"7561","pockets",1,1,0,1,3
"7562","polite",1,1,0,1,3
"7563","politeness",3,0,0,0,3
"7564","politician",1,2,0,0,3
"7565","polls",3,0,0,0,3
"7566","pollute",0,3,0,0,3
"7567","pompeii",0,0,0,3,3
"7568","poplars",2,1,0,0,3
"7569","possessors",2,1,0,0,3
"7570","posts",2,1,0,0,3
"7571","pot",1,2,0,0,3
"7572","pounce",1,2,0,0,3
"7573","pounded",2,1,0,0,3
"7574","practicability",0,3,0,0,3
"7575","preceded",2,0,1,0,3
"7576","precise",1,2,0,0,3
"7577","predominating",2,1,0,0,3
"7578","prefix",2,1,0,0,3
"7579","pregnant",3,0,0,0,3
"7580","preliminaries",0,3,0,0,3
"7581","preliminary",1,2,0,0,3
"7582","presbyterian",2,1,0,0,3
"7583","preserve",1,1,1,0,3
"7584","preside",3,0,0,0,3
"7585","presided",1,1,0,1,3
"7586","presiding",2,1,0,0,3
"7587","pretense",1,1,0,1,3
"7588","pretensions",0,1,2,0,3
"7589","pretentious",1,1,0,1,3
"7590","prevailing",2,1,0,0,3
"7591","prevalent",2,1,0,0,3
"7592","price’s",2,1,0,0,3
"7593","priestcraft",2,1,0,0,3
"7594","priests",0,0,2,1,3
"7595","print",1,2,0,0,3
"7596","prisoner",2,0,0,1,3
"7597","prisons",1,2,0,0,3
"7598","privation",1,1,1,0,3
"7599","prized",1,1,1,0,3
"7600","proclaim",1,1,1,0,3
"7601","productions",3,0,0,0,3
"7602","profanity",1,1,1,0,3
"7603","professions",1,1,1,0,3
"7604","progressive",3,0,0,0,3
"7605","prohibited",2,1,0,0,3
"7606","prohibition",2,1,0,0,3
"7607","promises",2,1,0,0,3
"7608","promoted",3,0,0,0,3
"7609","promoting",2,1,0,0,3
"7610","promotion",1,1,1,0,3
"7611","proofs",0,1,2,0,3
"7612","propagandists",3,0,0,0,3
"7613","prophet",1,1,0,1,3
"7614","proportioned",1,2,0,0,3
"7615","proportions",0,2,1,0,3
"7616","prospective",2,1,0,0,3
"7617","prosperous",1,2,0,0,3
"7618","protector",1,1,1,0,3
"7619","prouder",0,2,1,0,3
"7620","providential",2,1,0,0,3
"7621","providentially",1,2,0,0,3
"7622","proving",0,3,0,0,3
"7623","provocation",1,2,0,0,3
"7624","provoke",2,1,0,0,3
"7625","provoked",3,0,0,0,3
"7626","proximity",2,1,0,0,3
"7627","publicity",1,2,0,0,3
"7628","publisher",3,0,0,0,3
"7629","pulsation",2,1,0,0,3
"7630","pupil",1,2,0,0,3
"7631","purest",1,1,1,0,3
"7632","push",2,0,0,1,3
"7633","pushing",1,1,0,1,3
"7634","quailed",2,0,1,0,3
"7635","quarry",3,0,0,0,3
"7636","queer",0,1,0,2,3
"7637","questionable",0,2,1,0,3
"7638","questioned",1,1,1,0,3
"7639","quincy",2,1,0,0,3
"7640","quitted",1,2,0,0,3
"7641","racked",1,1,1,0,3
"7642","rags",2,1,0,0,3
"7643","railroads",2,1,0,0,3
"7644","rails",2,1,0,0,3
"7645","railway",1,0,0,2,3
"7646","rainy",1,0,0,2,3
"7647","rapidity",3,0,0,0,3
"7648","rattlesnake",1,2,0,0,3
"7649","ravages",2,0,1,0,3
"7650","raved",1,1,1,0,3
"7651","realms",1,2,0,0,3
"7652","reasoned",2,0,1,0,3
"7653","recalled",1,1,1,0,3
"7654","receipt",2,1,0,0,3
"7655","reconciling",1,1,1,0,3
"7656","recorder",2,0,1,0,3
"7657","recounted",1,1,1,0,3
"7658","recovered",1,2,0,0,3
"7659","recur",1,2,0,0,3
"7660","redolent",1,2,0,0,3
"7661","reducing",1,2,0,0,3
"7662","reflect",1,2,0,0,3
"7663","refrain",1,1,1,0,3
"7664","reign",2,1,0,0,3
"7665","reigns",1,2,0,0,3
"7666","reject",1,1,1,0,3
"7667","relent",2,1,0,0,3
"7668","relieve",1,2,0,0,3
"7669","remarked",1,1,1,0,3
"7670","remarking",1,2,0,0,3
"7671","renter",1,1,1,0,3
"7672","repel",2,1,0,0,3
"7673","reports",2,1,0,0,3
"7674","representations",3,0,0,0,3
"7675","reproached",2,1,0,0,3
"7676","reprobation",2,1,0,0,3
"7677","reproof",3,0,0,0,3
"7678","repugnance",0,3,0,0,3
"7679","repulse",2,1,0,0,3
"7680","repulsed",2,1,0,0,3
"7681","reputable",1,1,1,0,3
"7682","rescued",2,0,1,0,3
"7683","resent",2,1,0,0,3
"7684","resident",1,0,2,0,3
"7685","responsibilities",0,1,2,0,3
"7686","restored",2,0,1,0,3
"7687","restricted",1,2,0,0,3
"7688","resurrection",1,1,1,0,3
"7689","retaining",2,1,0,0,3
"7690","retaken",1,1,1,0,3
"7691","retaliate",3,0,0,0,3
"7692","retired",3,0,0,0,3
"7693","retrospect",2,1,0,0,3
"7694","retrospection",2,1,0,0,3
"7695","returns",1,1,1,0,3
"7696","reverberate",1,1,1,0,3
"7697","reversed",2,1,0,0,3
"7698","revival",1,2,0,0,3
"7699","richest",1,1,1,0,3
"7700","richmond’s",1,2,0,0,3
"7701","ricketson",2,0,1,0,3
"7702","rigged",1,1,0,1,3
"7703","rightfully",1,1,1,0,3
"7704","rightfulness",2,1,0,0,3
"7705","rightly",1,1,1,0,3
"7706","rigidly",1,2,0,0,3
"7707","rises",2,1,0,0,3
"7708","riveted",1,2,0,0,3
"7709","roads",2,1,0,0,3
"7710","roared",2,1,0,0,3
"7711","roaring",1,1,1,0,3
"7712","robed",1,1,1,0,3
"7713","robinson",3,0,0,0,3
"7714","robs",0,1,2,0,3
"7715","roguish",1,2,0,0,3
"7716","roller",1,1,1,0,3
"7717","roma",0,0,0,3,3
"7718","romish",0,0,0,3,3
"7719","rouse",3,0,0,0,3
"7720","rutherford",3,0,0,0,3
"7721","sabbaths",2,1,0,0,3
"7722","sadder",2,1,0,0,3
"7723","safeguards",3,0,0,0,3
"7724","sage",0,2,0,1,3
"7725","sailor’s",3,0,0,0,3
"7726","sailors’",3,0,0,0,3
"7727","saint",1,2,0,0,3
"7728","saintly",1,2,0,0,3
"7729","sam",2,0,1,0,3
"7730","sanctuary",0,3,0,0,3
"7731","sandya",3,0,0,0,3
"7732","sane",1,1,0,1,3
"7733","sarcasm",0,3,0,0,3
"7734","sawing",2,1,0,0,3
"7735","scorpions",1,1,1,0,3
"7736","scotch",1,2,0,0,3
"7737","scourgings",0,2,1,0,3
"7738","scow",1,1,1,0,3
"7739","scrape",1,1,1,0,3
"7740","screw",0,3,0,0,3
"7741","scripture",1,1,1,0,3
"7742","scurf",1,1,1,0,3
"7743","seas",1,1,1,0,3
"7744","secondly",3,0,0,0,3
"7745","secrecy",1,2,0,0,3
"7746","sectional",2,1,0,0,3
"7747","sects",1,1,0,1,3
"7748","sedate",1,2,0,0,3
"7749","selecting",2,1,0,0,3
"7750","sensibilities",2,1,0,0,3
"7751","sensitiveness",0,3,0,0,3
"7752","sentinel",1,1,1,0,3
"7753","serenity",3,0,0,0,3
"7754","seriously",3,0,0,0,3
"7755","severer",2,1,0,0,3
"7756","seymour",3,0,0,0,3
"7757","shad",1,2,0,0,3
"7758","shaft",1,2,0,0,3
"7759","shamelessly",2,1,0,0,3
"7760","sharer",1,2,0,0,3
"7761","sharpe",3,0,0,0,3
"7762","sharply",2,1,0,0,3
"7763","sheridan’s",1,1,1,0,3
"7764","shipbuilding",3,0,0,0,3
"7765","shipyards",2,1,0,0,3
"7766","shoemaker",2,1,0,0,3
"7767","shoemakers",1,2,0,0,3
"7768","shortened",1,1,1,0,3
"7769","shrill",1,1,1,0,3
"7770","shrinks",2,1,0,0,3
"7771","shudder",2,1,0,0,3
"7772","significant",2,1,0,0,3
"7773","sincerity",1,0,1,1,3
"7774","singer",1,1,1,0,3
"7775","singly",1,2,0,0,3
"7776","sinister",2,1,0,0,3
"7777","sixpence",2,1,0,0,3
"7778","skull",1,1,1,0,3
"7779","slater’s",1,1,1,0,3
"7780","slavemasters",2,1,0,0,3
"7781","slavemother’s",3,0,0,0,3
"7782","slaves”",3,0,0,0,3
"7783","slaveship",2,1,0,0,3
"7784","sleeps",1,2,0,0,3
"7785","sleeves",1,1,1,0,3
"7786","slumber",1,2,0,0,3
"7787","slumbering",0,1,2,0,3
"7788","smartest",0,1,2,0,3
"7789","smiling",1,2,0,0,3
"7790","smith’s",1,1,1,0,3
"7791","smote",1,2,0,0,3
"7792","snap",1,2,0,0,3
"7793","snugly",1,2,0,0,3
"7794","sobriety",2,1,0,0,3
"7795","sol",2,1,0,0,3
"7796","solicitous",1,2,0,0,3
"7797","solved",1,2,0,0,3
"7798","soothing",2,0,1,0,3
"7799","soundness",2,1,0,0,3
"7800","sources",2,1,0,0,3
"7801","south_",0,3,0,0,3
"7802","southerners",2,1,0,0,3
"7803","sovereign",1,2,0,0,3
"7804","spain",2,1,0,0,3
"7805","spangled",1,2,0,0,3
"7806","spellingbook",3,0,0,0,3
"7807","sphere",3,0,0,0,3
"7808","spies",1,1,1,0,3
"7809","spoiler",0,0,3,0,3
"7810","spoons",1,1,1,0,3
"7811","spreading",1,1,1,0,3
"7812","sprightly",1,1,1,0,3
"7813","spurns",2,1,0,0,3
"7814","squad",3,0,0,0,3
"7815","squads",3,0,0,0,3
"7816","stairway",2,1,0,0,3
"7817","stamp",1,2,0,0,3
"7818","standardbearer",3,0,0,0,3
"7819","stars”",3,0,0,0,3
"7820","states”",3,0,0,0,3
"7821","statesmanship",3,0,0,0,3
"7822","statue",1,1,0,1,3
"7823","stature",1,1,1,0,3
"7824","statutes",2,0,1,0,3
"7825","stayed",2,1,0,0,3
"7826","steals",0,2,1,0,3
"7827","steamship",3,0,0,0,3
"7828","stiff",1,1,1,0,3
"7829","stinginess",1,2,0,0,3
"7830","stingy",1,2,0,0,3
"7831","stopt",0,0,0,3,3
"7832","storer",3,0,0,0,3
"7833","storing",2,1,0,0,3
"7834","storks",1,1,1,0,3
"7835","storms",2,1,0,0,3
"7836","stowing",1,1,1,0,3
"7837","stratagem",1,1,1,0,3
"7838","streak",2,1,0,0,3
"7839","stretching",1,2,0,0,3
"7840","strews",1,1,1,0,3
"7841","strikingly",2,1,0,0,3
"7842","stuck",1,2,0,0,3
"7843","student",3,0,0,0,3
"7844","studying",1,1,0,1,3
"7845","stuff",1,1,1,0,3
"7846","stupor",1,1,1,0,3
"7847","subjection",1,2,0,0,3
"7848","subscribe",1,1,1,0,3
"7849","substance",3,0,0,0,3
"7850","succeeding",2,1,0,0,3
"7851","successor",3,0,0,0,3
"7852","suggestive",2,0,0,1,3
"7853","suits",1,1,0,1,3
"7854","summed",2,1,0,0,3
"7855","sunday’s",2,1,0,0,3
"7856","sundayschool",3,0,0,0,3
"7857","sundered",1,1,1,0,3
"7858","superintendent",1,1,1,0,3
"7859","supplies",1,2,0,0,3
"7860","supplying",3,0,0,0,3
"7861","surmounted",1,1,0,1,3
"7862","surpassing",1,1,0,1,3
"7863","surprises",1,1,0,1,3
"7864","surprisingly",3,0,0,0,3
"7865","sustaining",3,0,0,0,3
"7866","swaggering",2,1,0,0,3
"7867","sweat",0,1,2,0,3
"7868","sweetest",1,1,1,0,3
"7869","sweetness",1,2,0,0,3
"7870","swept",1,2,0,0,3
"7871","swimming",1,1,1,0,3
"7872","swing",1,0,2,0,3
"7873","swings",1,1,1,0,3
"7874","syllable",2,1,0,0,3
"7875","synagogues",1,1,1,0,3
"7876","systematically",3,0,0,0,3
"7877","tamed",1,1,1,0,3
"7878","tangible",2,1,0,0,3
"7879","tardiness",2,1,0,0,3
"7880","taunting",1,1,1,0,3
"7881","team",0,1,2,0,3
"7882","teamsters",2,1,0,0,3
"7883","teeming",1,2,0,0,3
"7884","tendencies",2,1,0,0,3
"7885","tending",2,1,0,0,3
"7886","tenfold",0,0,3,0,3
"7887","terminate",2,1,0,0,3
"7888","termination",1,1,0,1,3
"7889","terrified",1,1,1,0,3
"7890","terrify",1,1,1,0,3
"7891","testimonies",2,1,0,0,3
"7892","thanked",3,0,0,0,3
"7893","theft",1,1,1,0,3
"7894","thicket",1,1,1,0,3
"7895","thirdly",2,1,0,0,3
"7896","thirst",1,2,0,0,3
"7897","thou",0,3,0,0,3
"7898","thoughtless",1,1,1,0,3
"7899","thraldom",2,0,1,0,3
"7900","thrall",1,2,0,0,3
"7901","thrifty",1,2,0,0,3
"7902","thundered",1,2,0,0,3
"7903","thunders",0,2,1,0,3
"7904","tilton",2,0,0,1,3
"7905","tis",0,3,0,0,3
"7906","toiled",1,2,0,0,3
"7907","toils",1,2,0,0,3
"7908","token",2,1,0,0,3
"7909","tolerant",3,0,0,0,3
"7910","tonight”",3,0,0,0,3
"7911","tower",0,0,0,3,3
"7912","traitor",2,1,0,0,3
"7913","tranquil",1,0,1,1,3
"7914","tranquilizing",2,1,0,0,3
"7915","transatlantic",3,0,0,0,3
"7916","transformation",2,1,0,0,3
"7917","transgression",3,0,0,0,3
"7918","transparent",2,1,0,0,3
"7919","traveler",1,2,0,0,3
"7920","tremulous",3,0,0,0,3
"7921","trespass",1,1,1,0,3
"7922","tribune",2,1,0,0,3
"7923","triumphs",2,1,0,0,3
"7924","trump",1,1,1,0,3
"7925","truthfulness",1,2,0,0,3
"7926","turban",1,1,0,1,3
"7927","turbid",1,1,1,0,3
"7928","twins",1,1,1,0,3
"7929","twisted",2,1,0,0,3
"7930","ugly",3,0,0,0,3
"7931","unalloyed",2,1,0,0,3
"7932","unasked",1,1,1,0,3
"7933","unbolted",1,2,0,0,3
"7934","unbounded",1,1,1,0,3
"7935","unchangeable",2,1,0,0,3
"7936","uncompromising",2,1,0,0,3
"7937","unconcern",1,2,0,0,3
"7938","unconsciousness",3,0,0,0,3
"7939","undaunted",2,1,0,0,3
"7940","undefended",1,2,0,0,3
"7941","undergone",1,1,0,1,3
"7942","undone",1,0,2,0,3
"7943","uneasiness",1,2,0,0,3
"7944","uneducated",2,1,0,0,3
"7945","unfrequent",1,2,0,0,3
"7946","ungrateful",3,0,0,0,3
"7947","uniformly",1,2,0,0,3
"7948","unlimited",2,1,0,0,3
"7949","unmistakable",2,1,0,0,3
"7950","unmolested",0,2,1,0,3
"7951","unpardonable",0,1,2,0,3
"7952","unprepared",1,1,1,0,3
"7953","unprofitable",1,2,0,0,3
"7954","unprotected",1,2,0,0,3
"7955","unreasoning",2,1,0,0,3
"7956","unsuspecting",1,2,0,0,3
"7957","untamed",1,2,0,0,3
"7958","untrodden",1,1,1,0,3
"7959","unused",1,1,1,0,3
"7960","unwittingly",1,2,0,0,3
"7961","upas",2,1,0,0,3
"7962","upholders",1,1,1,0,3
"7963","uppermost",2,0,1,0,3
"7964","upturned",2,1,0,0,3
"7965","urchins",0,2,1,0,3
"7966","urging",3,0,0,0,3
"7967","ushered",1,1,1,0,3
"7968","vacant",1,1,1,0,3
"7969","valor",3,0,0,0,3
"7970","vastly",1,2,0,0,3
"7971","vatican",0,0,0,3,3
"7972","vaults",3,0,0,0,3
"7973","veal",1,1,1,0,3
"7974","veins",2,1,0,0,3
"7975","verge",2,1,0,0,3
"7976","version",1,2,0,0,3
"7977","vestments",0,0,0,3,3
"7978","vices",1,1,1,0,3
"7979","victories",2,1,0,0,3
"7980","vigilant",2,0,1,0,3
"7981","villain",2,1,0,0,3
"7982","villainous",1,2,0,0,3
"7983","villains",1,2,0,0,3
"7984","violate",2,1,0,0,3
"7985","violates",0,3,0,0,3
"7986","virgin",1,0,0,2,3
"7987","visions",2,1,0,0,3
"7988","visiting",1,2,0,0,3
"7989","visitor",3,0,0,0,3
"7990","visitors",2,0,0,1,3
"7991","vocation",2,0,1,0,3
"7992","vortex",2,1,0,0,3
"7993","voters",3,0,0,0,3
"7994","voyages",2,1,0,0,3
"7995","wade",3,0,0,0,3
"7996","waged",3,0,0,0,3
"7997","wagner",3,0,0,0,3
"7998","waist",1,1,1,0,3
"7999","waiter",3,0,0,0,3
"8000","wallowing",1,1,1,0,3
"8001","walnut",3,0,0,0,3
"8002","wanting",3,0,0,0,3
"8003","wasteful",2,1,0,0,3
"8004","watchful",1,1,1,0,3
"8005","watchfulness",0,2,1,0,3
"8006","watson’s",1,1,1,0,3
"8007","wave",3,0,0,0,3
"8008","weakened",3,0,0,0,3
"8009","weaker",2,1,0,0,3
"8010","weapon",1,2,0,0,3
"8011","weave",1,1,1,0,3
"8012","weed",1,2,0,0,3
"8013","weeds",2,1,0,0,3
"8014","weighty",2,1,0,0,3
"8015","welcomes",2,1,0,0,3
"8016","wellknown",3,0,0,0,3
"8017","welltrained",3,0,0,0,3
"8018","whale",0,1,0,2,3
"8019","whence",3,0,0,0,3
"8020","whereupon",3,0,0,0,3
"8021","whetting",2,1,0,0,3
"8022","whipper",2,1,0,0,3
"8023","whispering",2,1,0,0,3
"8024","whiteness",1,1,0,1,3
"8025","wields",0,2,1,0,3
"8026","wilberforce",3,0,0,0,3
"8027","wildest",1,1,1,0,3
"8028","willow",2,1,0,0,3
"8029","wilmington",3,0,0,0,3
"8030","windmill",1,2,0,0,3
"8031","wiped",1,1,1,0,3
"8032","wiser",2,1,0,0,3
"8033","withdrawal",2,1,0,0,3
"8034","withdrawn",3,0,0,0,3
"8035","wolves",0,2,0,1,3
"8036","woodcolored",3,0,0,0,3
"8037","work”",3,0,0,0,3
"8038","worker",2,0,0,1,3
"8039","workthe",3,0,0,0,3
"8040","worried",2,1,0,0,3
"8041","wrathful",1,2,0,0,3
"8042","wrested",1,2,0,0,3
"8043","writhed",1,1,1,0,3
"8044","wronged",2,1,0,0,3
"8045","yankees",2,1,0,0,3
"8046","zion",0,3,0,0,3
"8047"," j",2,0,0,0,2
"8048","_all_",0,2,0,0,2
"8049","_another",0,2,0,0,2
"8050","_apprenticeship",0,2,0,0,2
"8051","_are_",0,2,0,0,2
"8052","_at",0,2,0,0,2
"8053","_bad_",0,2,0,0,2
"8054","_black",0,0,2,0,2
"8055","_bowse_",0,1,1,0,2
"8056","_can_",0,2,0,0,2
"8057","_chance_",0,2,0,0,2
"8058","_childhood_",0,2,0,0,2
"8059","_christian_",0,2,0,0,2
"8060","_covey",0,2,0,0,2
"8061","_defensive_",0,2,0,0,2
"8062","_did_",0,2,0,0,2
"8063","_do_",0,2,0,0,2
"8064","_epsom",0,2,0,0,2
"8065","_experience",0,2,0,0,2
"8066","_fact_",0,2,0,0,2
"8067","_father_",0,2,0,0,2
"8068","_for",0,2,0,0,2
"8069","_form_",0,2,0,0,2
"8070","_friend_",0,2,0,0,2
"8071","_friends",0,1,1,0,2
"8072","_get",0,0,2,0,2
"8073","_goads_",0,2,0,0,2
"8074","_good_",0,2,0,0,2
"8075","_gradual",0,2,0,0,2
"8076","_his",0,2,0,0,2
"8077","_his_",0,2,0,0,2
"8078","_how_",0,2,0,0,2
"8079","_i_",0,2,0,0,2
"8080","_introduced",0,2,0,0,2
"8081","_is",0,2,0,0,2
"8082","_kind_",0,2,0,0,2
"8083","_liberty",0,2,0,0,2
"8084","_little_",0,2,0,0,2
"8085","_master",0,2,0,0,2
"8086","_men_",0,2,0,0,2
"8087","_not",0,2,0,0,2
"8088","_now_",0,2,0,0,2
"8089","_own",0,0,2,0,2
"8090","_parentage_",0,2,0,0,2
"8091","_personal",0,2,0,0,2
"8092","_poor",0,1,1,0,2
"8093","_prichard’s",0,2,0,0,2
"8094","_property_",0,2,0,0,2
"8095","_religious",0,2,0,0,2
"8096","_removed",0,2,0,0,2
"8097","_seem_",0,2,0,0,2
"8098","_stand",0,2,0,0,2
"8099","_they",0,2,0,0,2
"8100","_thinking_",0,2,0,0,2
"8101","_this_",0,2,0,0,2
"8102","_till",0,0,2,0,2
"8103","_treatment",0,2,0,0,2
"8104","_twenty",0,2,0,0,2
"8105","_various",0,2,0,0,2
"8106","_very",0,2,0,0,2
"8107","_well_",0,2,0,0,2
"8108","_why",0,2,0,0,2
"8109","_why_",0,2,0,0,2
"8110","_would_",0,2,0,0,2
"8111","‘better",2,0,0,0,2
"8112","”“fred",2,0,0,0,2
"8113","“ah”",2,0,0,0,2
"8114","“buck”",2,0,0,0,2
"8115","“capt",2,0,0,0,2
"8116","“douglass”",2,0,0,0,2
"8117","“ell”",2,0,0,0,2
"8118","“fed",2,0,0,0,2
"8119","“fred",2,0,0,0,2
"8120","“frederick",2,0,0,0,2
"8121","“freedmen’s",2,0,0,0,2
"8122","“friends",2,0,0,0,2
"8123","“god",2,0,0,0,2
"8124","“honor",2,0,0,0,2
"8125","“impudence”",2,0,0,0,2
"8126","“infidel”",2,0,0,0,2
"8127","“lady",2,0,0,0,2
"8128","“law",2,0,0,0,2
"8129","“liberty",2,0,0,0,2
"8130","“lord’s",2,0,0,0,2
"8131","“lost",2,0,0,0,2
"8132","“man",2,0,0,0,2
"8133","“marshal",2,0,0,0,2
"8134","“miss",2,0,0,0,2
"8135","“narrative",2,0,0,0,2
"8136","“narrative”",2,0,0,0,2
"8137","“national",2,0,0,0,2
"8138","“natural",2,0,0,0,2
"8139","“negro",2,0,0,0,2
"8140","“sir",2,0,0,0,2
"8141","“sir”",2,0,0,0,2
"8142","”speech",2,0,0,0,2
"8143","“thee",2,0,0,0,2
"8144","“tide",2,0,0,0,2
"8145","“time",2,0,0,0,2
"8146","“tracy",2,0,0,0,2
"8147","“truth",2,0,0,0,2
"8148","“union",2,0,0,0,2
"8149","“whatever",2,0,0,0,2
"8150","“woman’s",2,0,0,0,2
"8151","12",0,2,0,0,2
"8152","15",0,0,2,0,2
"8153","157",0,2,0,0,2
"8154","1817",0,1,1,0,2
"8155","1832",0,0,2,0,2
"8156","1843",0,2,0,0,2
"8157","1846",0,2,0,0,2
"8158","1st",0,1,1,0,2
"8159","57",0,2,0,0,2
"8160","7",0,2,0,0,2
"8161","9",0,2,0,0,2
"8162","abaft",2,0,0,0,2
"8163","abandonment",2,0,0,0,2
"8164","abandonmentthe",2,0,0,0,2
"8165","abated",1,1,0,0,2
"8166","aberdeen",1,1,0,0,2
"8167","abhorring",1,1,0,0,2
"8168","abide",1,0,1,0,2
"8169","abiding",1,0,1,0,2
"8170","ably",1,0,1,0,2
"8171","abolitionists_",0,2,0,0,2
"8172","abominations",0,2,0,0,2
"8173","abound",0,0,2,0,2
"8174","abridge",1,1,0,0,2
"8175","abroadattentions",2,0,0,0,2
"8176","abroadvoyage",2,0,0,0,2
"8177","absented",1,1,0,0,2
"8178","absorbed",2,0,0,0,2
"8179","abstain",1,1,0,0,2
"8180","abstraction",1,1,0,0,2
"8181","abusing",1,1,0,0,2
"8182","accession",2,0,0,0,2
"8183","accordingly",2,0,0,0,2
"8184","accountability",1,1,0,0,2
"8185","accusers",1,1,0,0,2
"8186","achieve",2,0,0,0,2
"8187","acknowledged",2,0,0,0,2
"8188","acknowledgement",0,2,0,0,2
"8189","acquaintances",1,0,1,0,2
"8190","acquainting",1,1,0,0,2
"8191","acquirementsher",2,0,0,0,2
"8192","acquisition",1,1,0,0,2
"8193","activities",1,1,0,0,2
"8194","actuated",1,1,0,0,2
"8195","addressesliterary",2,0,0,0,2
"8196","adequate",0,1,1,0,2
"8197","adjourn",2,0,0,0,2
"8198","adjusting",1,1,0,0,2
"8199","admirable",1,1,0,0,2
"8200","admiral",2,0,0,0,2
"8201","admiring",1,1,0,0,2
"8202","admitting",1,0,1,0,2
"8203","adoration",1,1,0,0,2
"8204","adornment",1,1,0,0,2
"8205","adroitly",1,1,0,0,2
"8206","advancement",0,2,0,0,2
"8207","adventure",1,1,0,0,2
"8208","adventurous",2,0,0,0,2
"8209","advertise",1,1,0,0,2
"8210","advertised",2,0,0,0,2
"8211","advicesandy",2,0,0,0,2
"8212","advisable",1,1,0,0,2
"8213","adviser",1,0,1,0,2
"8214","adze",1,1,0,0,2
"8215","afflicts",0,1,1,0,2
"8216","affluence",1,1,0,0,2
"8217","affording",1,1,0,0,2
"8218","affray",1,1,0,0,2
"8219","aftercoming",2,0,0,0,2
"8220","agencies",2,0,0,0,2
"8221","agencyyouthful",2,0,0,0,2
"8222","aggravatingly",1,1,0,0,2
"8223","aggregation",0,2,0,0,2
"8224","aggressions",1,1,0,0,2
"8225","aggressor",1,1,0,0,2
"8226","agile",1,1,0,0,2
"8227","agility",1,1,0,0,2
"8228","agitationanguish",2,0,0,0,2
"8229","ah",0,1,1,0,2
"8230","aiming",0,2,0,0,2
"8231","ain’t",1,1,0,0,2
"8232","aisle",1,1,0,0,2
"8233","alarming",1,1,0,0,2
"8234","aldermen",1,1,0,0,2
"8235","alexandrian",0,0,1,1,2
"8236","aliens",1,1,0,0,2
"8237","alighted",1,1,0,0,2
"8238","all_",0,2,0,0,2
"8239","allabounding",2,0,0,0,2
"8240","allegations",1,1,0,0,2
"8241","allege",1,1,0,0,2
"8242","alliances",1,1,0,0,2
"8243","allied",1,0,1,0,2
"8244","allowances",2,0,0,0,2
"8245","allows",2,0,0,0,2
"8246","allpervading",2,0,0,0,2
"8247","alluding",1,1,0,0,2
"8248","almanac",1,1,0,0,2
"8249","almonds",1,1,0,0,2
"8250","also”",2,0,0,0,2
"8251","alteration",1,1,0,0,2
"8252","alternativedeplorable",2,0,0,0,2
"8253","amanda’s",2,0,0,0,2
"8254","ambiguity",1,1,0,0,2
"8255","ambush",1,1,0,0,2
"8256","ameliorate",1,1,0,0,2
"8257","americakindness",2,0,0,0,2
"8258","ammunition",2,0,0,0,2
"8259","amounted",1,1,0,0,2
"8260","analyze",0,1,1,0,2
"8261","anarchy",2,0,0,0,2
"8262","andrew’s",2,0,0,0,2
"8263","andy",2,0,0,0,2
"8264","anglosaxon",2,0,0,0,2
"8265","animates",1,1,0,0,2
"8266","animus",1,1,0,0,2
"8267","annihilating",1,1,0,0,2
"8268","annoyancesplantation",2,0,0,0,2
"8269","annoyed",0,2,0,0,2
"8270","anon",1,1,0,0,2
"8271","antagonistic",0,2,0,0,2
"8272","anthem",2,0,0,0,2
"8273","anthems",1,1,0,0,2
"8274","anthonyhis",2,0,0,0,2
"8275","anticipation",1,1,0,0,2
"8276","anticipations",0,2,0,0,2
"8277","antidote",1,1,0,0,2
"8278","antiquities",0,1,0,1,2
"8279","apartment",1,1,0,0,2
"8280","apologists",1,1,0,0,2
"8281","apologize",0,2,0,0,2
"8282","apostates",1,1,0,0,2
"8283","appeala",2,0,0,0,2
"8284","appearances",1,1,0,0,2
"8285","appenines",0,0,0,2,2
"8286","applauded",2,0,0,0,2
"8287","apple",0,1,1,0,2
"8288","appliances",2,0,0,0,2
"8289","appointing",1,0,1,0,2
"8290","appraisers",1,1,0,0,2
"8291","appreciate",2,0,0,0,2
"8292","appreciates",1,1,0,0,2
"8293","appreciating",2,0,0,0,2
"8294","apprehend",1,1,0,0,2
"8295","apprehensions",2,0,0,0,2
"8296","apprehensive",1,0,1,0,2
"8297","apprenticeship",2,0,0,0,2
"8298","approaches",0,1,0,1,2
"8299","appropriated",2,0,0,0,2
"8300","appropriately",0,1,1,0,2
"8301","appropriating",1,1,0,0,2
"8302","appropriations",1,1,0,0,2
"8303","aptly",1,1,0,0,2
"8304","aptness",1,1,0,0,2
"8305","arbors",1,1,0,0,2
"8306","archetectural",0,0,0,2,2
"8307","archetecture",0,0,0,2,2
"8308","architecture",0,0,0,2,2
"8309","aristocracies",1,1,0,0,2
"8310","armory",1,0,1,0,2
"8311","aromatic",1,1,0,0,2
"8312","aroused",0,2,0,0,2
"8313","arraying",1,1,0,0,2
"8314","artfulness",1,1,0,0,2
"8315","arthur",2,0,0,0,2
"8316","articulate",1,1,0,0,2
"8317","artist",0,0,0,2,2
"8318","artistic",1,1,0,0,2
"8319","ascended",0,1,0,1,2
"8320","ascribed",1,1,0,0,2
"8321","ashing",0,0,0,2,2
"8322","asparagus",1,1,0,0,2
"8323","aspects",0,2,0,0,2
"8324","aspersions",1,1,0,0,2
"8325","aspirants",2,0,0,0,2
"8326","aspirationsheavenly",2,0,0,0,2
"8327","aspire",1,1,0,0,2
"8328","assail",1,1,0,0,2
"8329","assassin’s",2,0,0,0,2
"8330","assaulting",1,1,0,0,2
"8331","assent",1,1,0,0,2
"8332","assents",0,2,0,0,2
"8333","asserter",1,1,0,0,2
"8334","asserts",1,1,0,0,2
"8335","atheism",1,1,0,0,2
"8336","atrocities",1,1,0,0,2
"8337","attachmentnew",2,0,0,0,2
"8338","attained_",0,2,0,0,2
"8339","attempt”",2,0,0,0,2
"8340","attendant",1,1,0,0,2
"8341","attentionsfamiliar",2,0,0,0,2
"8342","attests",2,0,0,0,2
"8343","attract",2,0,0,0,2
"8344","attractionspecuniary",2,0,0,0,2
"8345","audacity",1,1,0,0,2
"8346","audiences",1,1,0,0,2
"8347","auditory",0,1,1,0,2
"8348","aught",1,1,0,0,2
"8349","auldhis",2,0,0,0,2
"8350","aunts",0,2,0,0,2
"8351","australia",0,0,0,2,2
"8352","authenticity",1,1,0,0,2
"8353","authoress",2,0,0,0,2
"8354","authorize",1,1,0,0,2
"8355","available",2,0,0,0,2
"8356","avails",1,1,0,0,2
"8357","avenues",1,1,0,0,2
"8358","average",1,0,1,0,2
"8359","avert",1,1,0,0,2
"8360","averteda",2,0,0,0,2
"8361","avocation",1,1,0,0,2
"8362","avowed",2,0,0,0,2
"8363","avowing",0,1,1,0,2
"8364","awakened_",0,2,0,0,2
"8365","awakens",1,1,0,0,2
"8366","awarded",2,0,0,0,2
"8367","away”",2,0,0,0,2
"8368","awaycomrades",2,0,0,0,2
"8369","awayreturn",2,0,0,0,2
"8370","ax",0,2,0,0,2
"8371","axe",1,0,1,0,2
"8372","babiesash",2,0,0,0,2
"8373","backward",1,1,0,0,2
"8374","baffle",2,0,0,0,2
"8375","baffled",1,1,0,0,2
"8376","baggagenathan",2,0,0,0,2
"8377","bake",1,1,0,0,2
"8378","baking",1,1,0,0,2
"8379","ball",0,1,1,0,2
"8380","ballast",1,1,0,0,2
"8381","balm",1,1,0,0,2
"8382","balsambreadhow",2,0,0,0,2
"8383","baltimore_",0,2,0,0,2
"8384","baltimorearrival",2,0,0,0,2
"8385","baltimoredelight",2,0,0,0,2
"8386","baltimoremy",2,0,0,0,2
"8387","baltimoretommy",2,0,0,0,2
"8388","bandana",1,1,0,0,2
"8389","baneful",0,2,0,0,2
"8390","banish",2,0,0,0,2
"8391","banished",1,1,0,0,2
"8392","banishment",1,0,1,0,2
"8393","banners",1,1,0,0,2
"8394","baptism",2,0,0,0,2
"8395","baptist",2,0,0,0,2
"8396","baptized",2,0,0,0,2
"8397","barefaced",1,1,0,0,2
"8398","barely",0,0,2,0,2
"8399","bargained",1,1,0,0,2
"8400","baronial",1,1,0,0,2
"8401","barroom",2,0,0,0,2
"8402","bars",1,1,0,0,2
"8403","baseness",0,1,1,0,2
"8404","baser",1,1,0,0,2
"8405","bases",2,0,0,0,2
"8406","basest",0,1,1,0,2
"8407","bated",1,1,0,0,2
"8408","battled",2,0,0,0,2
"8409","bayonet",2,0,0,0,2
"8410","beach",1,1,0,0,2
"8411","beaming",0,1,1,0,2
"8412","bean",0,1,0,1,2
"8413","beans",1,1,0,0,2
"8414","bearers",1,1,0,0,2
"8415","beater",1,1,0,0,2
"8416","beating”",2,0,0,0,2
"8417","beatingdriven",2,0,0,0,2
"8418","beatingwhy",2,0,0,0,2
"8419","becomes",2,0,0,0,2
"8420","bedfordarrival",2,0,0,0,2
"8421","bedsdeprivation",2,0,0,0,2
"8422","bedside",2,0,0,0,2
"8423","bedsteads",0,2,0,0,2
"8424","beets",1,1,0,0,2
"8425","befriend",1,0,1,0,2
"8426","beget",0,2,0,0,2
"8427","beggars",1,1,0,0,2
"8428","begged",2,0,0,0,2
"8429","benighted",1,0,0,1,2
"8430","benumbed",1,1,0,0,2
"8431","beriah",2,0,0,0,2
"8432","beseech",1,1,0,0,2
"8433","beside",2,0,0,0,2
"8434","besought",2,0,0,0,2
"8435","betide",0,1,1,0,2
"8436","betrayal",1,1,0,0,2
"8437","beverly",1,1,0,0,2
"8438","bibb",1,1,0,0,2
"8439","bible_",0,2,0,0,2
"8440","bidding",1,1,0,0,2
"8441","bids",0,2,0,0,2
"8442","biggest",1,1,0,0,2
"8443","binds",1,1,0,0,2
"8444","birthdescription",2,0,0,0,2
"8445","birthnames",2,0,0,0,2
"8446","bishop",1,0,0,1,2
"8447","biting",0,2,0,0,2
"8448","blackbirds",2,0,0,0,2
"8449","blasts",1,1,0,0,2
"8450","blending",2,0,0,0,2
"8451","blew",0,0,2,0,2
"8452","blinded",1,1,0,0,2
"8453","blissful",1,1,0,0,2
"8454","blistered",2,0,0,0,2
"8455","bllelock",0,0,0,2,2
"8456","bloodbought",2,0,0,0,2
"8457","bloodless",1,1,0,0,2
"8458","bloods",1,1,0,0,2
"8459","bloodstained",2,0,0,0,2
"8460","bloodthirsty",2,0,0,0,2
"8461","blow”",2,0,0,0,2
"8462","bludgeons",2,0,0,0,2
"8463","blunt",0,1,1,0,2
"8464","blunted",1,1,0,0,2
"8465","boastfully",1,1,0,0,2
"8466","bodied",0,1,1,0,2
"8467","boil",1,1,0,0,2
"8468","bondage”",2,0,0,0,2
"8469","bonds”",2,0,0,0,2
"8470","bony",1,1,0,0,2
"8471","borrow",2,0,0,0,2
"8472","bostonobjections",2,0,0,0,2
"8473","bottle",1,1,0,0,2
"8474","botts",2,0,0,0,2
"8475","boundlessness",1,1,0,0,2
"8476","bounteous",2,0,0,0,2
"8477","bouquet",2,0,0,0,2
"8478","bouquets",2,0,0,0,2
"8479","bowly’s",1,1,0,0,2
"8480","bran",0,2,0,0,2
"8481","brandies",1,1,0,0,2
"8482","brandings",0,1,1,0,2
"8483","brandishing",1,1,0,0,2
"8484","bravado",1,1,0,0,2
"8485","breasts",1,1,0,0,2
"8486","breathless",0,0,0,2,2
"8487","breed",0,1,0,1,2
"8488","breeder_",0,1,1,0,2
"8489","breeds",1,1,0,0,2
"8490","brev",1,1,0,0,2
"8491","bribes",0,2,0,0,2
"8492","bridges",1,1,0,0,2
"8493","brig",1,1,0,0,2
"8494","brigade",2,0,0,0,2
"8495","briggs",1,1,0,0,2
"8496","brightening",1,0,1,0,2
"8497","brim",1,1,0,0,2
"8498","britain_",0,2,0,0,2
"8499","broiling",1,1,0,0,2
"8500","brokenhearted",1,1,0,0,2
"8501","bronze",1,0,0,1,2
"8502","brooding",1,1,0,0,2
"8503","brook",1,0,1,0,2
"8504","brother’s",0,1,1,0,2
"8505","brotherslaves",2,0,0,0,2
"8506","brougham",2,0,0,0,2
"8507","brownish",1,1,0,0,2
"8508","browns",2,0,0,0,2
"8509","brownto",2,0,0,0,2
"8510","bruff",2,0,0,0,2
"8511","brutehood",1,1,0,0,2
"8512","brutes",0,1,1,0,2
"8513","brutification",1,1,0,0,2
"8514","brutual",0,2,0,0,2
"8515","buchanana",2,0,0,0,2
"8516","buck",1,1,0,0,2
"8517","buds",1,1,0,0,2
"8518","buffum’s",2,0,0,0,2
"8519","bundle",1,1,0,0,2
"8520","bunker",2,0,0,0,2
"8521","buoyant",1,1,0,0,2
"8522","burdensome",1,1,0,0,2
"8523","bushes",1,1,0,0,2
"8524","busily",1,1,0,0,2
"8525","bust",2,0,0,0,2
"8526","butchered",1,1,0,0,2
"8527","buxton",2,0,0,0,2
"8528","bye",0,0,0,2,2
"8529","c c",2,0,0,0,2
"8530","cabin”",2,0,0,0,2
"8531","cabinindustrial",2,0,0,0,2
"8532","cæsar",2,0,0,0,2
"8533","cage",1,1,0,0,2
"8534","calamitous",1,1,0,0,2
"8535","calming",1,1,0,0,2
"8536","cambriarefusal",2,0,0,0,2
"8537","camel",0,0,2,0,2
"8538","campmeetinganger",2,0,0,0,2
"8539","campmeetingwhat",2,0,0,0,2
"8540","can”",2,0,0,0,2
"8541","canoes",1,1,0,0,2
"8542","cant",2,0,0,0,2
"8543","cantelopes",1,1,0,0,2
"8544","canvassed",1,1,0,0,2
"8545","capacities",0,2,0,0,2
"8546","caper",1,1,0,0,2
"8547","capital”",2,0,0,0,2
"8548","captains",2,0,0,0,2
"8549","captious",1,1,0,0,2
"8550","captivating",0,2,0,0,2
"8551","capturing",0,2,0,0,2
"8552","capuchin",0,0,0,2,2
"8553","cardinal",1,1,0,0,2
"8554","cardinals",0,0,0,2,2
"8555","careerobjectionsa",2,0,0,0,2
"8556","cargo",1,1,0,0,2
"8557","caricatured",1,1,0,0,2
"8558","caring",1,1,0,0,2
"8559","carpet",2,0,0,0,2
"8560","carpetbag",2,0,0,0,2
"8561","carpetbagger",2,0,0,0,2
"8562","carpets",1,1,0,0,2
"8563","carrion",1,1,0,0,2
"8564","cartwright",1,1,0,0,2
"8565","cass",2,0,0,0,2
"8566","castle",0,0,0,2,2
"8567","castor",1,1,0,0,2
"8568","casualties",1,1,0,0,2
"8569","catharines",2,0,0,0,2
"8570","cats",1,1,0,0,2
"8571","caucasus",0,2,0,0,2
"8572","cauliflower",1,1,0,0,2
"8573","cause”",2,0,0,0,2
"8574","celery",1,1,0,0,2
"8575","cellar",1,1,0,0,2
"8576","cemetary",0,0,0,2,2
"8577","cemetery",2,0,0,0,2
"8578","censured",0,1,1,0,2
"8579","census",2,0,0,0,2
"8580","ceremonious",1,1,0,0,2
"8581","chagrined",1,1,0,0,2
"8582","chamber",1,1,0,0,2
"8583","champion",1,0,1,0,2
"8584","changecousin",2,0,0,0,2
"8585","changefame",2,0,0,0,2
"8586","changereasons",2,0,0,0,2
"8587","chanting",1,1,0,0,2
"8588","characteristicsthe",2,0,0,0,2
"8589","characterization",1,1,0,0,2
"8590","characteroverseers",2,0,0,0,2
"8591","chargeable",0,2,0,0,2
"8592","charlestown",2,0,0,0,2
"8593","charmless",0,1,1,0,2
"8594","charmsauthor’s",2,0,0,0,2
"8595","chas",1,0,0,1,2
"8596","chastitygreat",2,0,0,0,2
"8597","chatham’s",1,1,0,0,2
"8598","chattelhood",1,1,0,0,2
"8599","cheap",1,1,0,0,2
"8600","cheated",1,1,0,0,2
"8601","cheeks",1,0,0,1,2
"8602","chewing",1,1,0,0,2
"8603","childish",1,1,0,0,2
"8604","childrenauthor’s",2,0,0,0,2
"8605","childrenlife",2,0,0,0,2
"8606","childsarah",2,0,0,0,2
"8607","chime",0,1,1,0,2
"8608","chinaman",2,0,0,0,2
"8609","chivalrous",2,0,0,0,2
"8610","chivalry",1,1,0,0,2
"8611","choke",0,1,1,0,2
"8612","chopped",1,1,0,0,2
"8613","christendom",1,1,0,0,2
"8614","churchpoor",2,0,0,0,2
"8615","cicero",0,0,0,2,2
"8616","cinder",1,1,0,0,2
"8617","circumspect",1,1,0,0,2
"8618","circumstancesscene",2,0,0,0,2
"8619","circumstantial",1,1,0,0,2
"8620","circumvented",1,1,0,0,2
"8621","circumventing",1,1,0,0,2
"8622","citadel",1,0,0,1,2
"8623","cite",0,2,0,0,2
"8624","claiming",1,1,0,0,2
"8625","clams",0,2,0,0,2
"8626","clank",1,1,0,0,2
"8627","claws",1,1,0,0,2
"8628","cleaner",1,1,0,0,2
"8629","clergy",1,1,0,0,2
"8630","clerk’s",0,1,1,0,2
"8631","climbed",1,0,0,1,2
"8632","cline",1,1,0,0,2
"8633","clothingnaked",2,0,0,0,2
"8634","clue",1,1,0,0,2
"8635","clung",1,1,0,0,2
"8636","cluster",1,1,0,0,2
"8637","clustered",1,1,0,0,2
"8638","coachmanwilliam",2,0,0,0,2
"8639","coating",1,1,0,0,2
"8640","coats",1,0,1,0,2
"8641","cobb",2,0,0,0,2
"8642","codes",1,1,0,0,2
"8643","coercion",1,1,0,0,2
"8644","coercionhymns",2,0,0,0,2
"8645","coffee",1,1,0,0,2
"8646","cognizance",1,1,0,0,2
"8647","colaborers",2,0,0,0,2
"8648","coldblooded",2,0,0,0,2
"8649","coldhow",2,0,0,0,2
"8650","coldness",1,1,0,0,2
"8651","collection",1,1,0,0,2
"8652","collegehon",2,0,0,0,2
"8653","collision",1,1,0,0,2
"8654","combed",0,1,0,1,2
"8655","comfortsincreased",2,0,0,0,2
"8656","coming”speech",2,0,0,0,2
"8657","commanderinchief",2,0,0,0,2
"8658","commence",0,1,1,0,2
"8659","commendation",1,1,0,0,2
"8660","commends",0,1,0,1,2
"8661","comment",1,1,0,0,2
"8662","commissioner",2,0,0,0,2
"8663","commodious",1,1,0,0,2
"8664","commodity",0,2,0,0,2
"8665","commonwealth",2,0,0,0,2
"8666","communicated",2,0,0,0,2
"8667","communications",1,1,0,0,2
"8668","communistic",2,0,0,0,2
"8669","communities",1,1,0,0,2
"8670","companysad",2,0,0,0,2
"8671","compassionated",1,1,0,0,2
"8672","complains",0,1,1,0,2
"8673","completing",1,1,0,0,2
"8674","complicated",1,1,0,0,2
"8675","complimentary",2,0,0,0,2
"8676","composition",2,0,0,0,2
"8677","comprehending",1,1,0,0,2
"8678","concealments",1,1,0,0,2
"8679","concedes",1,1,0,0,2
"8680","conceding",1,1,0,0,2
"8681","concentration",1,1,0,0,2
"8682","concession",2,0,0,0,2
"8683","conclude",1,0,1,0,2
"8684","conclusions",1,1,0,0,2
"8685","conclusionscompensations",2,0,0,0,2
"8686","condescend",1,1,0,0,2
"8687","condign",1,1,0,0,2
"8688","conducting",1,1,0,0,2
"8689","conductorcapt",2,0,0,0,2
"8690","confederated",1,1,0,0,2
"8691","confer",2,0,0,0,2
"8692","conference",1,1,0,0,2
"8693","confidential",2,0,0,0,2
"8694","confine",1,1,0,0,2
"8695","confinement",1,0,1,0,2
"8696","confining",1,1,0,0,2
"8697","confirms",0,2,0,0,2
"8698","conflagration",1,1,0,0,2
"8699","conflicting",1,1,0,0,2
"8700","congratulating",1,1,0,0,2
"8701","congregate",2,0,0,0,2
"8702","congressmen",2,0,0,0,2
"8703","conkling",2,0,0,0,2
"8704","conn",2,0,0,0,2
"8705","connect",2,0,0,0,2
"8706","consenting",1,1,0,0,2
"8707","conservatives",2,0,0,0,2
"8708","consistently",1,0,1,0,2
"8709","consolate",0,0,0,2,2
"8710","console",0,1,1,0,2
"8711","conspired",0,1,1,0,2
"8712","constituting",1,1,0,0,2
"8713","constructions",1,1,0,0,2
"8714","construed",0,2,0,0,2
"8715","consult",2,0,0,0,2
"8716","consumer",1,1,0,0,2
"8717","consumers",1,1,0,0,2
"8718","contagion",1,1,0,0,2
"8719","contain",2,0,0,0,2
"8720","containing",0,0,0,2,2
"8721","contemptuous",1,1,0,0,2
"8722","contentmentcongenial",2,0,0,0,2
"8723","contestelection",2,0,0,0,2
"8724","contiguity",1,1,0,0,2
"8725","continent",2,0,0,0,2
"8726","contingencies",0,2,0,0,2
"8727","contingency",2,0,0,0,2
"8728","continuing",0,1,1,0,2
"8729","contract",1,1,0,0,2
"8730","contradicts",1,1,0,0,2
"8731","contrasting",1,1,0,0,2
"8732","contrastsgreat",2,0,0,0,2
"8733","contributing",0,2,0,0,2
"8734","controversydecoration",2,0,0,0,2
"8735","convenience",1,1,0,0,2
"8736","conveniences",1,1,0,0,2
"8737","conventionuncle",2,0,0,0,2
"8738","conversant",1,1,0,0,2
"8739","converts",1,0,1,0,2
"8740","conveyed",1,1,0,0,2
"8741","conveying",1,1,0,0,2
"8742","convict",2,0,0,0,2
"8743","convictionloss",2,0,0,0,2
"8744","convincing",1,1,0,0,2
"8745","cooped",1,1,0,0,2
"8746","cooperate",1,1,0,0,2
"8747","cooperation",1,1,0,0,2
"8748","coopering",0,1,1,0,2
"8749","copious",1,1,0,0,2
"8750","coppering",1,1,0,0,2
"8751","coran",0,0,0,2,2
"8752","cords",0,1,1,0,2
"8753","corinthian",2,0,0,0,2
"8754","cornish",1,1,0,0,2
"8755","coroner’s",1,1,0,0,2
"8756","corps",2,0,0,0,2
"8757","costume",1,0,0,1,2
"8758","counselled",2,0,0,0,2
"8759","countryinterview",2,0,0,0,2
"8760","countryits",2,0,0,0,2
"8761","courses",1,1,0,0,2
"8762","courtesies",1,1,0,0,2
"8763","cousins",0,2,0,0,2
"8764","covert",1,1,0,0,2
"8765","covey’smeditations",2,0,0,0,2
"8766","covey’spunished",2,0,0,0,2
"8767","covey”",2,0,0,0,2
"8768","coveyfamily",2,0,0,0,2
"8769","coveyfirst",2,0,0,0,2
"8770","coveyhis",2,0,0,0,2
"8771","coveyreckless",2,0,0,0,2
"8772","cower",1,1,0,0,2
"8773","cowyard",2,0,0,0,2
"8774","cracks",1,1,0,0,2
"8775","crafts",0,2,0,0,2
"8776","crashy",1,1,0,0,2
"8777","cream",1,1,0,0,2
"8778","creep",1,1,0,0,2
"8779","crevice",1,1,0,0,2
"8780","criminals",1,1,0,0,2
"8781","crisped",1,1,0,0,2
"8782","critically",1,1,0,0,2
"8783","criticise",1,1,0,0,2
"8784","criticism",2,0,0,0,2
"8785","criticisms",1,1,0,0,2
"8786","crocus",1,1,0,0,2
"8787","crofts",1,0,0,1,2
"8788","crops",1,1,0,0,2
"8789","crouching",0,1,1,0,2
"8790","crusade",2,0,0,0,2
"8791","crust",1,1,0,0,2
"8792","crutches",1,1,0,0,2
"8793","cuffs",1,1,0,0,2
"8794","cultivating",1,1,0,0,2
"8795","cumber",1,1,0,0,2
"8796","curran",1,1,0,0,2
"8797","customary",1,1,0,0,2
"8798","cuts",0,2,0,0,2
"8799","d c",2,0,0,0,2
"8800","dairies",1,1,0,0,2
"8801","dairy",1,1,0,0,2
"8802","dallas",2,0,0,0,2
"8803","damnation",0,1,1,0,2
"8804","damped",1,1,0,0,2
"8805","dana",2,0,0,0,2
"8806","darling",1,1,0,0,2
"8807","dastardly",1,1,0,0,2
"8808","daunt",1,1,0,0,2
"8809","day”",2,0,0,0,2
"8810","dazzle",0,1,0,1,2
"8811","deacon",1,1,0,0,2
"8812","dead”",2,0,0,0,2
"8813","deadened",1,1,0,0,2
"8814","dearer",1,1,0,0,2
"8815","debased",1,1,0,0,2
"8816","debates",1,1,0,0,2
"8817","debtor",2,0,0,0,2
"8818","decades",2,0,0,0,2
"8819","deceivers",1,1,0,0,2
"8820","decent",1,1,0,0,2
"8821","decisions",1,1,0,0,2
"8822","declares",0,2,0,0,2
"8823","decorously",1,1,0,0,2
"8824","deduce",1,1,0,0,2
"8825","deeming",1,1,0,0,2
"8826","defaced",1,1,0,0,2
"8827","defaces",0,1,1,0,2
"8828","defeatedvengeance",2,0,0,0,2
"8829","defenseless",0,2,0,0,2
"8830","defies",1,1,0,0,2
"8831","deformity",1,0,0,1,2
"8832","defying",1,1,0,0,2
"8833","dejean",0,0,0,2,2
"8834","delegations",2,0,0,0,2
"8835","delegationtheir",2,0,0,0,2
"8836","delevan",2,0,0,0,2
"8837","delevanexperiences",2,0,0,0,2
"8838","delicacy",1,1,0,0,2
"8839","delicious",1,1,0,0,2
"8840","delightfully",1,1,0,0,2
"8841","delighting",0,1,0,1,2
"8842","democracy",0,2,0,0,2
"8843","demoralizing",1,1,0,0,2
"8844","denizens",1,1,0,0,2
"8845","denominations",1,0,0,1,2
"8846","departments",1,1,0,0,2
"8847","depending",1,1,0,0,2
"8848","depicted",2,0,0,0,2
"8849","deplorably",1,1,0,0,2
"8850","deplore",1,1,0,0,2
"8851","deputy",1,1,0,0,2
"8852","dereliction",1,1,0,0,2
"8853","dervishers",0,0,0,2,2
"8854","descended",0,2,0,0,2
"8855","descending",1,1,0,0,2
"8856","descry",1,1,0,0,2
"8857","desertlike",2,0,0,0,2
"8858","deserves",0,2,0,0,2
"8859","desirableness",1,1,0,0,2
"8860","desiring",1,0,1,0,2
"8861","despairing",1,1,0,0,2
"8862","despicable",1,1,0,0,2
"8863","destination",0,1,0,1,2
"8864","destinies",2,0,0,0,2
"8865","destiniesgeneral",2,0,0,0,2
"8866","detention",2,0,0,0,2
"8867","determines",1,1,0,0,2
"8868","deterring",1,1,0,0,2
"8869","detract",0,2,0,0,2
"8870","detracted",1,1,0,0,2
"8871","developing",1,1,0,0,2
"8872","devise",2,0,0,0,2
"8873","devised",0,1,1,0,2
"8874","diabolical",0,1,1,0,2
"8875","dialogues",1,1,0,0,2
"8876","diameter",1,1,0,0,2
"8877","dickinson",2,0,0,0,2
"8878","dictated",2,0,0,0,2
"8879","dictates",1,1,0,0,2
"8880","dictionaryincendiary",2,0,0,0,2
"8881","diet",1,1,0,0,2
"8882","differently",2,0,0,0,2
"8883","difficultiespatrick",2,0,0,0,2
"8884","dignitary",2,0,0,0,2
"8885","dilapidation",1,1,0,0,2
"8886","diminution",1,1,0,0,2
"8887","diploma",1,1,0,0,2
"8888","dipping",1,1,0,0,2
"8889","dire",1,1,0,0,2
"8890","disagreement",2,0,0,0,2
"8891","disappoint",1,1,0,0,2
"8892","disapprobation",2,0,0,0,2
"8893","disapproval",1,0,1,0,2
"8894","disapproved",2,0,0,0,2
"8895","disaster",1,1,0,0,2
"8896","disbanded",2,0,0,0,2
"8897","discerning",1,1,0,0,2
"8898","disciples",0,2,0,0,2
"8899","disclaim",2,0,0,0,2
"8900","disclosing",1,1,0,0,2
"8901","discord",1,0,1,0,2
"8902","discouragements",1,1,0,0,2
"8903","discourses",0,2,0,0,2
"8904","discovering",2,0,0,0,2
"8905","discoveryskill",2,0,0,0,2
"8906","discreditable",1,1,0,0,2
"8907","discreet",2,0,0,0,2
"8908","disdaining",0,2,0,0,2
"8909","disease",2,0,0,0,2
"8910","disenthrall",0,2,0,0,2
"8911","disfigured",1,1,0,0,2
"8912","disguises",2,0,0,0,2
"8913","dishearten",1,1,0,0,2
"8914","disheartening",2,0,0,0,2
"8915","disheveled",1,1,0,0,2
"8916","dishonor",1,1,0,0,2
"8917","dishonorable",2,0,0,0,2
"8918","dislikes",0,2,0,0,2
"8919","dislodge",2,0,0,0,2
"8920","dismal",1,1,0,0,2
"8921","dismissed",0,2,0,0,2
"8922","disobeyed",0,0,2,0,2
"8923","dispensed",0,1,1,0,2
"8924","dispersed",2,0,0,0,2
"8925","displeased",0,1,0,1,2
"8926","disposer",1,1,0,0,2
"8927","disposing",1,1,0,0,2
"8928","disprove",0,2,0,0,2
"8929","disproved",1,0,1,0,2
"8930","disproving",2,0,0,0,2
"8931","disraeli",2,0,0,0,2
"8932","disrepute",1,1,0,0,2
"8933","disruption",2,0,0,0,2
"8934","dissolved",1,1,0,0,2
"8935","dissolving",1,1,0,0,2
"8936","distinctive",2,0,0,0,2
"8937","distinguishing",2,0,0,0,2
"8938","distribution",2,0,0,0,2
"8939","distrustful",1,1,0,0,2
"8940","disturber",1,1,0,0,2
"8941","ditch",1,1,0,0,2
"8942","ditches",1,1,0,0,2
"8943","divers",1,1,0,0,2
"8944","divide",1,0,1,0,2
"8945","divination",1,1,0,0,2
"8946","dixon",1,1,0,0,2
"8947","domains",1,1,0,0,2
"8948","dominions",1,1,0,0,2
"8949","donations",1,1,0,0,2
"8950","dotted",1,1,0,0,2
"8951","douglass’s",0,2,0,0,2
"8952","downcast",1,1,0,0,2
"8953","downward",0,1,1,0,2
"8954","downy",1,1,0,0,2
"8955","dragon",1,1,0,0,2
"8956","draining",1,1,0,0,2
"8957","drains",1,1,0,0,2
"8958","drawbridge",1,0,1,0,2
"8959","draws",1,1,0,0,2
"8960","dray",0,2,0,0,2
"8961","dreamerroute",2,0,0,0,2
"8962","dreary",2,0,0,0,2
"8963","drenching",1,1,0,0,2
"8964","dressing",1,1,0,0,2
"8965","drill",1,1,0,0,2
"8966","dripping",0,1,1,0,2
"8967","drives",0,2,0,0,2
"8968","drover",0,2,0,0,2
"8969","drovers",0,1,1,0,2
"8970","drums",1,1,0,0,2
"8971","drunkennessgood",2,0,0,0,2
"8972","dues",1,1,0,0,2
"8973","duncan",1,1,0,0,2
"8974","durgan",1,1,0,0,2
"8975","duties_",0,2,0,0,2
"8976","dutiesa",2,0,0,0,2
"8977","dutiestheir",2,0,0,0,2
"8978","dutymurder",2,0,0,0,2
"8979","dwellingplace",2,0,0,0,2
"8980","dyspepsia",1,1,0,0,2
"8981","eagerness",0,2,0,0,2
"8982","eaglerailroad",2,0,0,0,2
"8983","easterly",0,1,1,0,2
"8984","eastonthe",2,0,0,0,2
"8985","eaton",1,1,0,0,2
"8986","ebony",1,1,0,0,2
"8987","ecstacy",1,1,0,0,2
"8988","ecstatic",1,1,0,0,2
"8989","editor’s",0,2,0,0,2
"8990","effectively",2,0,0,0,2
"8991","efficacious",1,1,0,0,2
"8992","efficiently",1,1,0,0,2
"8993","egg",1,1,0,0,2
"8994","egotism",1,1,0,0,2
"8995","egotistical",0,1,1,0,2
"8996","elaborately",1,1,0,0,2
"8997","elders",1,1,0,0,2
"8998","elective",2,0,0,0,2
"8999","eleventh",2,0,0,0,2
"9000","elicited",1,1,0,0,2
"9001","ellen",1,1,0,0,2
"9002","elude",2,0,0,0,2
"9003","emanate",1,1,0,0,2
"9004","emanating",1,1,0,0,2
"9005","emancipates",1,1,0,0,2
"9006","emancipationits",2,0,0,0,2
"9007","emancipator",2,0,0,0,2
"9008","embarrassed",2,0,0,0,2
"9009","embodied",1,1,0,0,2
"9010","embodiment",1,1,0,0,2
"9011","embowered",1,1,0,0,2
"9012","emigrate",1,1,0,0,2
"9013","eminently",2,0,0,0,2
"9014","emptyhanded",2,0,0,0,2
"9015","enables",1,1,0,0,2
"9016","enacting",1,1,0,0,2
"9017","enactments",0,2,0,0,2
"9018","enacts",1,1,0,0,2
"9019","endanger",2,0,0,0,2
"9020","endeared",0,1,1,0,2
"9021","enemy’s",1,1,0,0,2
"9022","enervating",1,1,0,0,2
"9023","enfeebled",1,1,0,0,2
"9024","englandpresidential",2,0,0,0,2
"9025","engrossing",0,2,0,0,2
"9026","enhance",0,1,1,0,2
"9027","enhanced",1,1,0,0,2
"9028","enjoined",1,1,0,0,2
"9029","enjoying",1,0,1,0,2
"9030","enjoys",0,1,1,0,2
"9031","enkindling",1,1,0,0,2
"9032","enlarge",2,0,0,0,2
"9033","enlarged",2,0,0,0,2
"9034","enlightening",0,0,2,0,2
"9035","enlistment",2,0,0,0,2
"9036","entangling",1,1,0,0,2
"9037","enterprises",0,2,0,0,2
"9038","enterprisethe",2,0,0,0,2
"9039","entertainment",0,1,1,0,2
"9040","entertainments",1,1,0,0,2
"9041","enthusiasmfugitive",2,0,0,0,2
"9042","entitle",1,1,0,0,2
"9043","entombed",1,1,0,0,2
"9044","entreaties",0,1,1,0,2
"9045","entreating",1,0,1,0,2
"9046","enviable",1,1,0,0,2
"9047","envious",1,1,0,0,2
"9048","environments",1,1,0,0,2
"9049","epsom",2,0,0,0,2
"9050","equaled",1,1,0,0,2
"9051","equip",2,0,0,0,2
"9052","eraits",2,0,0,0,2
"9053","ere",0,2,0,0,2
"9054","erie",2,0,0,0,2
"9055","escapeconsiderations",2,0,0,0,2
"9056","escapenothing",2,0,0,0,2
"9057","escapeox",2,0,0,0,2
"9058","escapeplan",2,0,0,0,2
"9059","escorted",2,0,0,0,2
"9060","espoused",1,1,0,0,2
"9061","essentially",0,1,1,0,2
"9062","esther’s",1,1,0,0,2
"9063","estimated",1,1,0,0,2
"9064","etcthe",2,0,0,0,2
"9065","eulogies",2,0,0,0,2
"9066","european",0,1,0,1,2
"9067","even”",2,0,0,0,2
"9068","everett",2,0,0,0,2
"9069","everglades",1,1,0,0,2
"9070","everyday",1,1,0,0,2
"9071","ewing",1,0,0,1,2
"9072","ewry",1,1,0,0,2
"9073","exaggerate",1,1,0,0,2
"9074","exaggeration",1,0,1,0,2
"9075","exaggerations",0,1,1,0,2
"9076","exceed",1,0,0,1,2
"9077","excepted",1,1,0,0,2
"9078","exclamations",1,1,0,0,2
"9079","excludes",1,1,0,0,2
"9080","excuses",1,1,0,0,2
"9081","execrable",0,1,1,0,2
"9082","execrate",0,1,1,0,2
"9083","executioner",1,1,0,0,2
"9084","executionmy",2,0,0,0,2
"9085","exempt",0,1,0,1,2
"9086","exhaustion",1,1,0,0,2
"9087","exhaustive",2,0,0,0,2
"9088","exhortation",1,1,0,0,2
"9089","existing",2,0,0,0,2
"9090","expatriation",1,1,0,0,2
"9091","expediency",2,0,0,0,2
"9092","expedients",1,1,0,0,2
"9093","expedition",2,0,0,0,2
"9094","expeditions",2,0,0,0,2
"9095","expensive",1,0,0,1,2
"9096","experiencespainful",2,0,0,0,2
"9097","experiencing",1,1,0,0,2
"9098","explaining",0,0,2,0,2
"9099","exploit",1,1,0,0,2
"9100","exposures",0,1,1,0,2
"9101","exslave",2,0,0,0,2
"9102","extant",0,1,0,1,2
"9103","extensively",2,0,0,0,2
"9104","external",0,1,0,1,2
"9105","extinct",1,0,1,0,2
"9106","extinguished",1,1,0,0,2
"9107","extirpation",1,1,0,0,2
"9108","eyed",0,2,0,0,2
"9109","fabled",1,1,0,0,2
"9110","fabulous",1,1,0,0,2
"9111","facts”",2,0,0,0,2
"9112","fade",0,0,0,2,2
"9113","failurestrange",2,0,0,0,2
"9114","fain",1,1,0,0,2
"9115","fairest",1,0,1,0,2
"9116","fairs",2,0,0,0,2
"9117","faithfulness",0,2,0,0,2
"9118","falls",1,0,1,0,2
"9119","falsehood",1,1,0,0,2
"9120","familiarity",1,1,0,0,2
"9121","familyinvited",2,0,0,0,2
"9122","fanaticism",1,1,0,0,2
"9123","fans",1,1,0,0,2
"9124","fares",2,0,0,0,2
"9125","farmer",1,1,0,0,2
"9126","farrier",1,1,0,0,2
"9127","fascinate",1,1,0,0,2
"9128","father”",2,0,0,0,2
"9129","fatherly",1,1,0,0,2
"9130","fatigue",1,0,1,0,2
"9131","faultless",1,1,0,0,2
"9132","favordanger",2,0,0,0,2
"9133","fearfully",1,1,0,0,2
"9134","fearignorance",2,0,0,0,2
"9135","fearspainful",2,0,0,0,2
"9136","feasted",1,1,0,0,2
"9137","fee",2,0,0,0,2
"9138","feebleness",1,1,0,0,2
"9139","feeds",0,0,1,1,2
"9140","feigning",1,1,0,0,2
"9141","fellowman",2,0,0,0,2
"9142","fellowshiped",1,1,0,0,2
"9143","fellowslaves",2,0,0,0,2
"9144","fencecorner",2,0,0,0,2
"9145","fenced",1,1,0,0,2
"9146","fertility",1,1,0,0,2
"9147","fessenden",2,0,0,0,2
"9148","festering",0,1,1,0,2
"9149","fetlocks",1,1,0,0,2
"9150","feud",1,1,0,0,2
"9151","feverdemon",2,0,0,0,2
"9152","feverish",1,1,0,0,2
"9153","fiction”",2,0,0,0,2
"9154","fiercely",1,1,0,0,2
"9155","fifth",2,0,0,0,2
"9156","fightits",2,0,0,0,2
"9157","fights",1,0,1,0,2
"9158","figures",1,0,0,1,2
"9159","fillibustering",2,0,0,0,2
"9160","fills",1,0,1,0,2
"9161","filthy",1,1,0,0,2
"9162","financial",2,0,0,0,2
"9163","finelooking",2,0,0,0,2
"9164","fines",0,2,0,0,2
"9165","finite",1,1,0,0,2
"9166","fir",1,1,0,0,2
"9167","fired",2,0,0,0,2
"9168","fireside",2,0,0,0,2
"9169","firetriumphs",2,0,0,0,2
"9170","firstrate",2,0,0,0,2
"9171","fisherwoman",2,0,0,0,2
"9172","fishwomen",1,1,0,0,2
"9173","fixedharassing",2,0,0,0,2
"9174","fixture",1,1,0,0,2
"9175","flagrantly",1,1,0,0,2
"9176","flavor",1,1,0,0,2
"9177","flay",0,2,0,0,2
"9178","flights",1,1,0,0,2
"9179","flit",1,1,0,0,2
"9180","flitting",1,1,0,0,2
"9181","float",0,2,0,0,2
"9182","floats",2,0,0,0,2
"9183","floatstage",2,0,0,0,2
"9184","flogging_",0,2,0,0,2
"9185","flood”",2,0,0,0,2
"9186","floral",2,0,0,0,2
"9187","florida",1,1,0,0,2
"9188","flour",0,2,0,0,2
"9189","flourished",2,0,0,0,2
"9190","flourishes",1,1,0,0,2
"9191","flowery",2,0,0,0,2
"9192","fluency",1,0,1,0,2
"9193","fluttering",1,1,0,0,2
"9194","fog",1,1,0,0,2
"9195","folds",1,1,0,0,2
"9196","foliage",2,0,0,0,2
"9197","follies",2,0,0,0,2
"9198","fond",1,1,0,0,2
"9199","fondness",1,1,0,0,2
"9200","foodsinging",2,0,0,0,2
"9201","footnotes",0,2,0,0,2
"9202","footprints",0,1,1,0,2
"9203","forbear",1,1,0,0,2
"9204","forbearance",2,0,0,0,2
"9205","fore",0,1,0,1,2
"9206","forecastle",1,1,0,0,2
"9207","forecastledeckhutchinson",2,0,0,0,2
"9208","forego",1,1,0,0,2
"9209","foreshadow",1,1,0,0,2
"9210","foreshadowing",1,1,0,0,2
"9211","forfeit",1,1,0,0,2
"9212","forge",1,1,0,0,2
"9213","forgetfulness",1,1,0,0,2
"9214","forgets",2,0,0,0,2
"9215","forgetting",0,2,0,0,2
"9216","forgiven",1,1,0,0,2
"9217","forlorn",1,1,0,0,2
"9218","form’s",1,1,0,0,2
"9219","formalities",1,1,0,0,2
"9220","formally",2,0,0,0,2
"9221","fornication",1,1,0,0,2
"9222","forsaken",0,2,0,0,2
"9223","fortysix",2,0,0,0,2
"9224","forums",0,0,0,2,2
"9225","fostered",1,1,0,0,2
"9226","foundations",1,1,0,0,2
"9227","foundery",0,2,0,0,2
"9228","fourpence",1,1,0,0,2
"9229","fowell",2,0,0,0,2
"9230","foxknowledge",2,0,0,0,2
"9231","fragrant",2,0,0,0,2
"9232","francisco",2,0,0,0,2
"9233","franks",0,0,0,2,2
"9234","freddy”",2,0,0,0,2
"9235","frederick”",2,0,0,0,2
"9236","freedman’s",2,0,0,0,2
"9237","freedom”",2,0,0,0,2
"9238","freeing",2,0,0,0,2
"9239","freeland’sauthor’s",2,0,0,0,2
"9240","freelandan",2,0,0,0,2
"9241","freemanconflict",2,0,0,0,2
"9242","freight",2,0,0,0,2
"9243","freighted",1,1,0,0,2
"9244","frenzy",1,0,0,1,2
"9245","frequency",0,1,1,0,2
"9246","friendjoy",2,0,0,0,2
"9247","friendschange",2,0,0,0,2
"9248","friendshipenfranchisement",2,0,0,0,2
"9249","friendstheir",2,0,0,0,2
"9250","friendswoman",2,0,0,0,2
"9251","frighten",1,1,0,0,2
"9252","fronted",0,2,0,0,2
"9253","fronting",1,1,0,0,2
"9254","frosts",2,0,0,0,2
"9255","frosty",1,1,0,0,2
"9256","frying",1,1,0,0,2
"9257","fuel",2,0,0,0,2
"9258","fulfil",1,0,1,0,2
"9259","fulfill",2,0,0,0,2
"9260","fulfilling",1,1,0,0,2
"9261","fulfillment",0,2,0,0,2
"9262","fumes",1,1,0,0,2
"9263","furder",1,1,0,0,2
"9264","furiously",1,1,0,0,2
"9265","furnace",2,0,0,0,2
"9266","furtherance",2,0,0,0,2
"9267","furtherclouds",2,0,0,0,2
"9268","fused",1,1,0,0,2
"9269","gainstill",2,0,0,0,2
"9270","gala",1,1,0,0,2
"9271","galileo",0,0,0,2,2
"9272","gall",1,1,0,0,2
"9273","gallantly",1,1,0,0,2
"9274","galleries",0,0,0,2,2
"9275","gang",2,0,0,0,2
"9276","garment",1,1,0,0,2
"9277","garnett",1,1,0,0,2
"9278","garrett",2,0,0,0,2
"9279","garrison’s",1,1,0,0,2
"9280","garrisonantislavery",2,0,0,0,2
"9281","garrisonian",0,2,0,0,2
"9282","gateway",1,0,1,0,2
"9283","gaunt",1,1,0,0,2
"9284","gem",1,1,0,0,2
"9285","generalities",2,0,0,0,2
"9286","generalization",1,1,0,0,2
"9287","generositydifficulties",2,0,0,0,2
"9288","genesee",2,0,0,0,2
"9289","gentler",1,1,0,0,2
"9290","genuineness",1,1,0,0,2
"9291","genuinereasons",2,0,0,0,2
"9292","geographical",2,0,0,0,2
"9293","geographyimaginary",2,0,0,0,2
"9294","germanfearssafe",2,0,0,0,2
"9295","gerritt",2,0,0,0,2
"9296","gesticulating",1,1,0,0,2
"9297","ghastly",0,2,0,0,2
"9298","gifta",2,0,0,0,2
"9299","ginger",1,1,0,0,2
"9300","gip",0,0,2,0,2
"9301","gird",1,1,0,0,2
"9302","glasgow",1,1,0,0,2
"9303","glee",1,1,0,0,2
"9304","glimpse",1,0,0,1,2
"9305","glimpses",2,0,0,0,2
"9306","glistening",1,1,0,0,2
"9307","gloat",0,2,0,0,2
"9308","glocester",2,0,0,0,2
"9309","glorified",1,0,0,1,2
"9310","glorying",1,1,0,0,2
"9311","glossiness",1,1,0,0,2
"9312","gnat",0,0,2,0,2
"9313","gnawings",0,0,2,0,2
"9314","goading",0,2,0,0,2
"9315","gone”",2,0,0,0,2
"9316","goodbye",2,0,0,0,2
"9317","goresketch",2,0,0,0,2
"9318","gorsuch",2,0,0,0,2
"9319","gory",0,0,2,0,2
"9320","goulds",2,0,0,0,2
"9321","gout",1,1,0,0,2
"9322","gov",1,1,0,0,2
"9323","grabbed",1,1,0,0,2
"9324","graced",1,1,0,0,2
"9325","gradation",1,1,0,0,2
"9326","gradations",2,0,0,0,2
"9327","gradual",2,0,0,0,2
"9328","granddaughter",2,0,0,0,2
"9329","grandmotherhis",2,0,0,0,2
"9330","grandparents",0,2,0,0,2
"9331","grandparentstheir",2,0,0,0,2
"9332","grandson",2,0,0,0,2
"9333","grapes",1,1,0,0,2
"9334","graphically",1,1,0,0,2
"9335","greatgrandchildren",2,0,0,0,2
"9336","greathearted",2,0,0,0,2
"9337","greece",0,0,0,2,2
"9338","greedy",1,1,0,0,2
"9339","greener",2,0,0,0,2
"9340","greenes",2,0,0,0,2
"9341","greenock",1,1,0,0,2
"9342","greenwoodhon",2,0,0,0,2
"9343","griefpartingslaves",2,0,0,0,2
"9344","grievances",1,1,0,0,2
"9345","griffiths",2,0,0,0,2
"9346","grimes",2,0,0,0,2
"9347","grimkeabby",2,0,0,0,2
"9348","grindstone",0,1,1,0,2
"9349","groaned",1,1,0,0,2
"9350","groomes",1,1,0,0,2
"9351","grotto",0,0,0,2,2
"9352","grovelling",1,0,0,1,2
"9353","growl",1,1,0,0,2
"9354","grows",1,1,0,0,2
"9355","guarantee",2,0,0,0,2
"9356","guaranteed",2,0,0,0,2
"9357","guards",0,2,0,0,2
"9358","gullies",1,1,0,0,2
"9359","gush",1,1,0,0,2
"9360","guthriehon",2,0,0,0,2
"9361","ha",0,0,2,0,2
"9362","habiliments",0,1,1,0,2
"9363","habitations",1,1,0,0,2
"9364","hallowell",2,0,0,0,2
"9365","halted",1,0,1,0,2
"9366","halter",1,0,1,0,2
"9367","hamlet",2,0,0,0,2
"9368","hammer",0,2,0,0,2
"9369","hampshire",2,0,0,0,2
"9370","hampton",2,0,0,0,2
"9371","handa",2,0,0,0,2
"9372","handicrafts",2,0,0,0,2
"9373","handicraftsmen",1,1,0,0,2
"9374","handling",1,1,0,0,2
"9375","handshis",2,0,0,0,2
"9376","handwriting",2,0,0,0,2
"9377","hanged”",2,0,0,0,2
"9378","happiness”",2,0,0,0,2
"9379","harbinger",1,1,0,0,2
"9380","harbor",1,0,0,1,2
"9381","hardihood",1,1,0,0,2
"9382","harm’s",1,1,0,0,2
"9383","harmlessly",1,1,0,0,2
"9384","harnesses",1,1,0,0,2
"9385","harrington",1,1,0,0,2
"9386","harrisburgh",1,1,0,0,2
"9387","hartford",2,0,0,0,2
"9388","hasty",2,0,0,0,2
"9389","hating",1,1,0,0,2
"9390","haughty",1,1,0,0,2
"9391","haven’t",1,0,1,0,2
"9392","havre",2,0,0,0,2
"9393","hawes",2,0,0,0,2
"9394","hay",0,0,2,0,2
"9395","haymow",1,1,0,0,2
"9396","hazarded",1,1,0,0,2
"9397","hazily",1,1,0,0,2
"9398","hazy",1,1,0,0,2
"9399","he’ll",0,2,0,0,2
"9400","headache",1,1,0,0,2
"9401","heading",1,1,0,0,2
"9402","heartbroken",1,0,0,1,2
"9403","hearths",1,0,1,0,2
"9404","heaven’s",1,1,0,0,2
"9405","heaven”",2,0,0,0,2
"9406","heavings",1,1,0,0,2
"9407","hebrew",1,0,0,1,2
"9408","hector",1,1,0,0,2
"9409","heightened",1,1,0,0,2
"9410","heinousness",1,1,0,0,2
"9411","hellish",0,2,0,0,2
"9412","hendricks",2,0,0,0,2
"9413","hennymethodist",2,0,0,0,2
"9414","henrysandy",2,0,0,0,2
"9415","hereby",2,0,0,0,2
"9416","hereunto",1,1,0,0,2
"9417","hew",1,1,0,0,2
"9418","hewed",1,1,0,0,2
"9419","hickey",0,1,1,0,2
"9420","hicks’s",0,1,1,0,2
"9421","hildreth",0,0,0,2,2
"9422","himand",2,0,0,0,2
"9423","himmiss",2,0,0,0,2
"9424","himnational",2,0,0,0,2
"9425","himselfbrutal",2,0,0,0,2
"9426","himthe",2,0,0,0,2
"9427","hinderance",0,2,0,0,2
"9428","hinderances",0,2,0,0,2
"9429","hindermost",1,1,0,0,2
"9430","historian",2,0,0,0,2
"9431","histories",0,1,0,1,2
"9432","hoeing",0,1,1,0,2
"9433","holidaysdifference",2,0,0,0,2
"9434","holidayshow",2,0,0,0,2
"9435","holley",2,0,0,0,2
"9436","hollow",0,2,0,0,2
"9437","home_",0,2,0,0,2
"9438","homehis",2,0,0,0,2
"9439","homeits",2,0,0,0,2
"9440","homely",2,0,0,0,2
"9441","homemonthly",2,0,0,0,2
"9442","homereasons",2,0,0,0,2
"9443","honesty",1,1,0,0,2
"9444","honey”",2,0,0,0,2
"9445","honor”",2,0,0,0,2
"9446","honorables",1,1,0,0,2
"9447","honorably",2,0,0,0,2
"9448","hopeattend",2,0,0,0,2
"9449","horatio",2,0,0,0,2
"9450","horrors_",0,2,0,0,2
"9451","hospital",0,0,0,2,2
"9452","hospitalitythe",2,0,0,0,2
"9453","hostages",2,0,0,0,2
"9454","house_",0,2,0,0,2
"9455","houseits",2,0,0,0,2
"9456","housestables",2,0,0,0,2
"9457","howth",1,1,0,0,2
"9458","hucksters",1,1,0,0,2
"9459","hue",1,1,0,0,2
"9460","hugh’sdeath",2,0,0,0,2
"9461","hugh’sreasons",2,0,0,0,2
"9462","hughs",0,2,0,0,2
"9463","hughthe",2,0,0,0,2
"9464","humphrey",1,1,0,0,2
"9465","hundreds",2,0,0,0,2
"9466","hungerforced",2,0,0,0,2
"9467","hungerunexpected",2,0,0,0,2
"9468","hunker",1,1,0,0,2
"9469","hurra",0,1,1,0,2
"9470","hurting",2,0,0,0,2
"9471","husbandry",1,1,0,0,2
"9472","hush",0,0,1,1,2
"9473","huss",1,1,0,0,2
"9474","huts",1,1,0,0,2
"9475","identity",1,0,1,0,2
"9476","illnature",2,0,0,0,2
"9477","illomened",2,0,0,0,2
"9478","illusions",2,0,0,0,2
"9479","illustrative",1,1,0,0,2
"9480","imaged",0,2,0,0,2
"9481","imagining",1,1,0,0,2
"9482","imbedded",1,1,0,0,2
"9483","imbibe",0,1,1,0,2
"9484","imbibed",0,1,1,0,2
"9485","imbruted",1,0,1,0,2
"9486","immeasurably",2,0,0,0,2
"9487","immoderately",1,1,0,0,2
"9488","impalpable",1,1,0,0,2
"9489","impassable",0,1,1,0,2
"9490","impatiencewisdom",2,0,0,0,2
"9491","impatient",1,1,0,0,2
"9492","imperative",1,1,0,0,2
"9493","imperil",2,0,0,0,2
"9494","imperiled",2,0,0,0,2
"9495","imperiously",1,1,0,0,2
"9496","impetus",1,0,1,0,2
"9497","impiously",0,2,0,0,2
"9498","implicated",2,0,0,0,2
"9499","implore",1,1,0,0,2
"9500","imply",0,1,1,0,2
"9501","implying",1,1,0,0,2
"9502","impostor",1,1,0,0,2
"9503","imposture",0,0,1,1,2
"9504","impressionsfather",2,0,0,0,2
"9505","improperly",0,1,1,0,2
"9506","improvesnew",2,0,0,0,2
"9507","improvised",2,0,0,0,2
"9508","imputation",0,2,0,0,2
"9509","imputations",0,1,1,0,2
"9510","inability",2,0,0,0,2
"9511","inalienable",1,1,0,0,2
"9512","inasmuch",2,0,0,0,2
"9513","inauguralvicepresident",2,0,0,0,2
"9514","inaugurate",1,1,0,0,2
"9515","incidents_",0,2,0,0,2
"9516","incite",1,1,0,0,2
"9517","incited",1,0,0,1,2
"9518","inciting",2,0,0,0,2
"9519","incompetent",1,0,1,0,2
"9520","inconsiderable",1,1,0,0,2
"9521","inconvenient",1,1,0,0,2
"9522","incorporated",2,0,0,0,2
"9523","increasingly",1,0,1,0,2
"9524","inculcated",1,1,0,0,2
"9525","indefatigable",2,0,0,0,2
"9526","indefinite",1,1,0,0,2
"9527","indelicate",0,1,1,0,2
"9528","indians",1,1,0,0,2
"9529","indigent",1,1,0,0,2
"9530","indignantly",1,1,0,0,2
"9531","indignities",0,2,0,0,2
"9532","indirections",1,1,0,0,2
"9533","indistinct",1,1,0,0,2
"9534","inducements",2,0,0,0,2
"9535","inducing",1,1,0,0,2
"9536","indulge",0,1,1,0,2
"9537","indulging",1,1,0,0,2
"9538","industries",2,0,0,0,2
"9539","inequality",1,1,0,0,2
"9540","inexperience",2,0,0,0,2
"9541","inexpressible",0,2,0,0,2
"9542","infantile",0,2,0,0,2
"9543","infedel",0,0,0,2,2
"9544","inflexible",1,0,1,0,2
"9545","inflicting",1,1,0,0,2
"9546","inflicts",0,2,0,0,2
"9547","informal",2,0,0,0,2
"9548","informationthe",2,0,0,0,2
"9549","ingeneering",0,0,0,2,2
"9550","ingenuity",2,0,0,0,2
"9551","ingraft",0,2,0,0,2
"9552","ingredients",0,1,1,0,2
"9553","inhabitantscapt",2,0,0,0,2
"9554","initiating",1,1,0,0,2
"9555","initiation",0,2,0,0,2
"9556","injuries",1,1,0,0,2
"9557","injurious",0,1,1,0,2
"9558","injury",2,0,0,0,2
"9559","inmost",0,2,0,0,2
"9560","innate",0,2,0,0,2
"9561","innovation",2,0,0,0,2
"9562","inoculated",1,1,0,0,2
"9563","inquisition",2,0,0,0,2
"9564","inscription",0,0,0,2,2
"9565","insecurity“allender’s",2,0,0,0,2
"9566","insert",2,0,0,0,2
"9567","insists",1,1,0,0,2
"9568","instantaneous",2,0,0,0,2
"9569","instigators",2,0,0,0,2
"9570","instil",1,0,1,0,2
"9571","instinctively",1,1,0,0,2
"9572","instructing",1,0,1,0,2
"9573","instructor",1,1,0,0,2
"9574","insultedcaptain",2,0,0,0,2
"9575","insulting",1,1,0,0,2
"9576","insurgents",2,0,0,0,2
"9577","intangible",1,1,0,0,2
"9578","intensify",1,1,0,0,2
"9579","intensity",2,0,0,0,2
"9580","intents",1,1,0,0,2
"9581","intercourse",1,1,0,0,2
"9582","interior",2,0,0,0,2
"9583","interment",2,0,0,0,2
"9584","international",1,0,0,1,2
"9585","interrogator",1,1,0,0,2
"9586","intervals",1,1,0,0,2
"9587","interviewcapt",2,0,0,0,2
"9588","interviews",2,0,0,0,2
"9589","intestate",1,1,0,0,2
"9590","intimately",1,1,0,0,2
"9591","intimidation",2,0,0,0,2
"9592","intractable",1,1,0,0,2
"9593","intrude",1,1,0,0,2
"9594","invaders",2,0,0,0,2
"9595","invasion",1,0,0,1,2
"9596","invective",0,2,0,0,2
"9597","inventing",1,1,0,0,2
"9598","invest",1,1,0,0,2
"9599","investigating",2,0,0,0,2
"9600","invidious",0,2,0,0,2
"9601","invoked",1,1,0,0,2
"9602","involuntary",1,0,1,0,2
"9603","involves",1,1,0,0,2
"9604","irksome",1,1,0,0,2
"9605","irony",0,2,0,0,2
"9606","irrecoverable",1,1,0,0,2
"9607","irregular",1,1,0,0,2
"9608","irritation",1,1,0,0,2
"9609","is_",0,1,1,0,2
"9610","islanddorr",2,0,0,0,2
"9611","ismalia",0,0,0,2,2
"9612","isolationits",2,0,0,0,2
"9613","italics",1,0,1,0,2
"9614","itits",2,0,0,0,2
"9615","itthirteen",2,0,0,0,2
"9616","j n",2,0,0,0,2
"9617","jackson",2,0,0,0,2
"9618","jackson’s",1,1,0,0,2
"9619","jake”succored",2,0,0,0,2
"9620","janes",2,0,0,0,2
"9621","janesville",2,0,0,0,2
"9622","jar",1,1,0,0,2
"9623","jarred",1,1,0,0,2
"9624","java",1,1,0,0,2
"9625","jealous",1,1,0,0,2
"9626","jealousy",1,1,0,0,2
"9627","jeered",2,0,0,0,2
"9628","jersey",1,1,0,0,2
"9629","jerusalem",1,1,0,0,2
"9630","jestspasses",2,0,0,0,2
"9631","jip",0,2,0,0,2
"9632","jobs",1,1,0,0,2
"9633","johnsonchange",2,0,0,0,2
"9634","jonah",1,1,0,0,2
"9635","joyfully",1,1,0,0,2
"9636","joyously",1,1,0,0,2
"9637","judas",1,1,0,0,2
"9638","judicious",2,0,0,0,2
"9639","judkins",1,1,0,0,2
"9640","jug",1,1,0,0,2
"9641","julia",2,0,0,0,2
"9642","julius",1,0,0,1,2
"9643","junior",1,1,0,0,2
"9644","justifier",0,1,1,0,2
"9645","jutting",1,1,0,0,2
"9646","kagi",2,0,0,0,2
"9647","kansasjohn",2,0,0,0,2
"9648","kansasthe",2,0,0,0,2
"9649","katyallowance",2,0,0,0,2
"9650","katyher",2,0,0,0,2
"9651","katysleepa",2,0,0,0,2
"9652","keepers",0,0,2,0,2
"9653","kelly",2,0,0,0,2
"9654","kellyh",2,0,0,0,2
"9655","kelton",2,0,0,0,2
"9656","keystone",1,1,0,0,2
"9657","khedeive",0,0,0,2,2
"9658","kidnap",1,0,1,0,2
"9659","kidnapped",1,1,0,0,2
"9660","kidnapping",0,2,0,0,2
"9661","kindle",1,1,0,0,2
"9662","kindnesshow",2,0,0,0,2
"9663","kindnessmy",2,0,0,0,2
"9664","kingdom”",2,0,0,0,2
"9665","knapp",1,1,0,0,2
"9666","knelt",1,1,0,0,2
"9667","knight",1,1,0,0,2
"9668","knives",1,1,0,0,2
"9669","knots",1,1,0,0,2
"9670","labeled",1,1,0,0,2
"9671","lads",1,1,0,0,2
"9672","lain",1,1,0,0,2
"9673","lakes",1,1,0,0,2
"9674","lameness",1,1,0,0,2
"9675","lamented",2,0,0,0,2
"9676","lampers",1,1,0,0,2
"9677","landlord",1,1,0,0,2
"9678","languages",1,0,0,1,2
"9679","languor",1,1,0,0,2
"9680","lap",1,1,0,0,2
"9681","lashings",0,1,1,0,2
"9682","lateshe",2,0,0,0,2
"9683","latin",1,0,0,1,2
"9684","latitudes",1,1,0,0,2
"9685","lattice",1,1,0,0,2
"9686","laudable",1,1,0,0,2
"9687","laurels",1,1,0,0,2
"9688","lavish",1,1,0,0,2
"9689","lawsonhis",2,0,0,0,2
"9690","leaked",1,1,0,0,2
"9691","learnt",0,2,0,0,2
"9692","leered",1,1,0,0,2
"9693","legislated",2,0,0,0,2
"9694","legislative",2,0,0,0,2
"9695","lemon",1,1,0,0,2
"9696","lemons",0,0,0,2,2
"9697","lend",1,1,0,0,2
"9698","lengthened",2,0,0,0,2
"9699","lengthy",1,1,0,0,2
"9700","lent",1,1,0,0,2
"9701","leprous",1,1,0,0,2
"9702","lessen",0,2,0,0,2
"9703","lesser",2,0,0,0,2
"9704","letter”",2,0,0,0,2
"9705","lettuce",1,1,0,0,2
"9706","lever",1,1,0,0,2
"9707","lewes",0,0,0,2,2
"9708","libels",0,0,2,0,2
"9709","liberty”",2,0,0,0,2
"9710","lies",1,1,0,0,2
"9711","lighter",1,1,0,0,2
"9712","lighthearted",2,0,0,0,2
"9713","lights",0,1,0,1,2
"9714","lighttwo",2,0,0,0,2
"9715","likenesses",1,0,0,1,2
"9716","likewise",0,2,0,0,2
"9717","liking",1,1,0,0,2
"9718","limber",1,1,0,0,2
"9719","lincolnnew",2,0,0,0,2
"9720","lined",1,1,0,0,2
"9721","lip",1,1,0,0,2
"9722","liquor",1,1,0,0,2
"9723","liquors",1,1,0,0,2
"9724","lists",1,1,0,0,2
"9725","lit",1,1,0,0,2
"9726","lite",0,0,0,2,2
"9727","lloyd”wind",2,0,0,0,2
"9728","lloydauthor’s",2,0,0,0,2
"9729","lloydhis",2,0,0,0,2
"9730","lloydits",2,0,0,0,2
"9731","lloydkind",2,0,0,0,2
"9732","lloydother",2,0,0,0,2
"9733","loans",2,0,0,0,2
"9734","loathsome",1,1,0,0,2
"9735","located",2,0,0,0,2
"9736","lockermans",1,1,0,0,2
"9737","logically",1,1,0,0,2
"9738","logs",1,1,0,0,2
"9739","longcherished",2,0,0,0,2
"9740","longest",2,0,0,0,2
"9741","longfellow",1,1,0,0,2
"9742","longings",0,1,1,0,2
"9743","loomed",0,1,0,1,2
"9744","loosely",1,1,0,0,2
"9745","loosened",1,1,0,0,2
"9746","lord”",2,0,0,0,2
"9747","lordly",0,1,1,0,2
"9748","loser",1,1,0,0,2
"9749","loses",1,1,0,0,2
"9750","loudon",1,1,0,0,2
"9751","lounged",1,1,0,0,2
"9752","loveauthor’s",2,0,0,0,2
"9753","loves",1,0,1,0,2
"9754","lowe’s",1,1,0,0,2
"9755","lowering",2,0,0,0,2
"9756","lownes",0,2,0,0,2
"9757","loyalist’s",2,0,0,0,2
"9758","lucas",0,1,0,1,2
"9759","luck”",2,0,0,0,2
"9760","lucrative",2,0,0,0,2
"9761","lucretiaher",2,0,0,0,2
"9762","lucretiamaster",2,0,0,0,2
"9763","lucy",1,1,0,0,2
"9764","lumbago",1,1,0,0,2
"9765","luminous",2,0,0,0,2
"9766","lurking",1,1,0,0,2
"9767","lustily",1,1,0,0,2
"9768","lustrous",1,1,0,0,2
"9769","luxuriesits",2,0,0,0,2
"9770","luxurious",1,1,0,0,2
"9771","lyons",0,0,0,2,2
"9772","maddened",1,1,0,0,2
"9773","madeslaverywhat",2,0,0,0,2
"9774","magazines",2,0,0,0,2
"9775","magical",1,1,0,0,2
"9776","magnanimity",1,1,0,0,2
"9777","mahogany",2,0,0,0,2
"9778","mahomet",1,1,0,0,2
"9779","mailed",1,0,0,1,2
"9780","maine",2,0,0,0,2
"9781","major",2,0,0,0,2
"9782","makeshifts",2,0,0,0,2
"9783","maliciously",1,1,0,0,2
"9784","mallet",0,1,1,0,2
"9785","mane",1,1,0,0,2
"9786","mangle",1,1,0,0,2
"9787","manifestations",1,1,0,0,2
"9788","manifested“ike”",2,0,0,0,2
"9789","manifestly",1,0,1,0,2
"9790","manned",1,0,1,0,2
"9791","manofwar",2,0,0,0,2
"9792","manone",2,0,0,0,2
"9793","mansions",1,1,0,0,2
"9794","manufacturing",1,1,0,0,2
"9795","manumission",1,1,0,0,2
"9796","manumit",1,1,0,0,2
"9797","mar",0,1,0,1,2
"9798","mariner",0,0,1,1,2
"9799","marketable",0,2,0,0,2
"9800","marquis",1,1,0,0,2
"9801","marriagethe",2,0,0,0,2
"9802","marseilles",0,0,0,2,2
"9803","marshal’s",2,0,0,0,2
"9804","marshaling",2,0,0,0,2
"9805","marvellous",0,0,0,2,2
"9806","marylanders",0,2,0,0,2
"9807","masses",2,0,0,0,2
"9808","masterevils",2,0,0,0,2
"9809","masterhis",2,0,0,0,2
"9810","masterly",2,0,0,0,2
"9811","mastersbenefits",2,0,0,0,2
"9812","mastervaluation",2,0,0,0,2
"9813","mattered",2,0,0,0,2
"9814","mature",1,1,0,0,2
"9815","mayors",1,1,0,0,2
"9816","mcdermot",2,0,0,0,2
"9817","mcdermott",1,1,0,0,2
"9818","measurably",1,1,0,0,2
"9819","meats",1,1,0,0,2
"9820","meditating",1,1,0,0,2
"9821","meditations",0,2,0,0,2
"9822","meditationsagain",2,0,0,0,2
"9823","meek",0,0,1,1,2
"9824","meekly",1,1,0,0,2
"9825","melons",1,1,0,0,2
"9826","memorials",1,1,0,0,2
"9827","memphis",0,0,0,2,2
"9828","menace",1,1,0,0,2
"9829","menagerie",1,1,0,0,2
"9830","mencontrast",2,0,0,0,2
"9831","meour",2,0,0,0,2
"9832","mercer",2,0,0,0,2
"9833","merchants",1,1,0,0,2
"9834","mercies",2,0,0,0,2
"9835","merit",1,0,1,0,2
"9836","meritorious",2,0,0,0,2
"9837","messages",1,1,0,0,2
"9838","messenger",1,1,0,0,2
"9839","metal",1,1,0,0,2
"9840","methoddangerfree",2,0,0,0,2
"9841","michael’s_",0,2,0,0,2
"9842","michaelsthe",2,0,0,0,2
"9843","mightiest",0,1,1,0,2
"9844","milan",0,0,0,2,2
"9845","mildest",1,1,0,0,2
"9846","mildew",1,1,0,0,2
"9847","mildness",1,1,0,0,2
"9848","millslave",2,0,0,0,2
"9849","mindshe",2,0,0,0,2
"9850","mingle",0,0,1,1,2
"9851","ministerreligious",2,0,0,0,2
"9852","minutely",1,1,0,0,2
"9853","minuteness",1,1,0,0,2
"9854","miracles",1,0,0,1,2
"9855","misapprehension",1,0,1,0,2
"9856","misdemeanor",0,0,2,0,2
"9857","misfortunes",1,1,0,0,2
"9858","mismanagement",0,1,1,0,2
"9859","misses",2,0,0,0,2
"9860","mistressmr",2,0,0,0,2
"9861","mitchells",2,0,0,0,2
"9862","mitigate",1,1,0,0,2
"9863","mitigating",1,1,0,0,2
"9864","mocked",1,1,0,0,2
"9865","mocking",1,1,0,0,2
"9866","modestly",2,0,0,0,2
"9867","molestation",1,1,0,0,2
"9868","molested",1,1,0,0,2
"9869","monarchial",2,0,0,0,2
"9870","moneyallowed",2,0,0,0,2
"9871","mongrels",1,1,0,0,2
"9872","monopolized",1,1,0,0,2
"9873","monstrous",0,2,0,0,2
"9874","monte",0,0,0,2,2
"9875","moorfields",0,2,0,0,2
"9876","morose",1,1,0,0,2
"9877","mortally",2,0,0,0,2
"9878","morton",2,0,0,0,2
"9879","mosques",0,0,0,2,2
"9880","mother”",2,0,0,0,2
"9881","motherthe",2,0,0,0,2
"9882","motherwho",2,0,0,0,2
"9883","mottlydia",2,0,0,0,2
"9884","mould",2,0,0,0,2
"9885","mountains”",2,0,0,0,2
"9886","mouth”",2,0,0,0,2
"9887","moves",0,2,0,0,2
"9888","multifarious",1,1,0,0,2
"9889","munitions",1,1,0,0,2
"9890","murderess",0,1,1,0,2
"9891","murdersno",2,0,0,0,2
"9892","murmur",2,0,0,0,2
"9893","muscle",2,0,0,0,2
"9894","muscovite",1,1,0,0,2
"9895","mushpreparations",2,0,0,0,2
"9896","musiem",0,0,0,2,2
"9897","musty",1,1,0,0,2
"9898","mutilations",1,0,1,0,2
"9899","myers",1,1,0,0,2
"9900","myriads",0,1,1,0,2
"9901","myselfmy",2,0,0,0,2
"9902","n h",2,0,0,0,2
"9903","namewhy",2,0,0,0,2
"9904","nantucketfirst",2,0,0,0,2
"9905","narrations",1,1,0,0,2
"9906","narrowest",2,0,0,0,2
"9907","nationalities",1,0,0,1,2
"9908","nationalization",1,1,0,0,2
"9909","nationalized",1,1,0,0,2
"9910","nature’s",1,1,0,0,2
"9911","natured",0,0,0,2,2
"9912","naught",2,0,0,0,2
"9913","naval",0,0,0,2,2
"9914","neal",1,1,0,0,2
"9915","neat",0,2,0,0,2
"9916","neatness",1,1,0,0,2
"9917","needful",0,1,1,0,2
"9918","needlucretia",2,0,0,0,2
"9919","needy",1,0,1,0,2
"9920","negatively",1,1,0,0,2
"9921","negro”",2,0,0,0,2
"9922","newborn",2,0,0,0,2
"9923","niagara",2,0,0,0,2
"9924","nigger”",2,0,0,0,2
"9925","nightreturn",2,0,0,0,2
"9926","noahpresentiment",2,0,0,0,2
"9927","nobility",1,1,0,0,2
"9928","nobler",1,1,0,0,2
"9929","noiselessly",0,0,1,1,2
"9930","nominated",2,0,0,0,2
"9931","nonslaveholders",2,0,0,0,2
"9932","nonslaveholding",1,1,0,0,2
"9933","nonvoting",2,0,0,0,2
"9934","norris”",2,0,0,0,2
"9935","norrisrob’t",2,0,0,0,2
"9936","northward",1,1,0,0,2
"9937","not_",0,2,0,0,2
"9938","notabilities",1,1,0,0,2
"9939","nothing”",2,0,0,0,2
"9940","notoriety",0,2,0,0,2
"9941","notoriously",1,1,0,0,2
"9942","noxious",1,1,0,0,2
"9943","nuisance",1,1,0,0,2
"9944","numerously",2,0,0,0,2
"9945","o’connell_",0,0,2,0,2
"9946","oaken",1,1,0,0,2
"9947","oakum",1,1,0,0,2
"9948","oberlin",2,0,0,0,2
"9949","objecting",1,1,0,0,2
"9950","observer",1,1,0,0,2
"9951","obtainedgleams",2,0,0,0,2
"9952","obtainment",1,1,0,0,2
"9953","obvious",2,0,0,0,2
"9954","obviously",2,0,0,0,2
"9955","occupationhis",2,0,0,0,2
"9956","occupationlearning",2,0,0,0,2
"9957","oclk",0,0,0,2,2
"9958","october",1,0,0,1,2
"9959","odiousness",0,1,1,0,2
"9960","odors",1,1,0,0,2
"9961","ofeagerness",2,0,0,0,2
"9962","offal",0,1,1,0,2
"9963","offending",1,1,0,0,2
"9964","officially",1,0,1,0,2
"9965","offspring",0,2,0,0,2
"9966","oldagain",2,0,0,0,2
"9967","oldcolumbian",2,0,0,0,2
"9968","ole",2,0,0,0,2
"9969","oligarchy",1,1,0,0,2
"9970","omened",0,2,0,0,2
"9971","omnibus",1,1,0,0,2
"9972","onboard",0,0,0,2,2
"9973","once_",0,2,0,0,2
"9974","onesloss",2,0,0,0,2
"9975","onethird",2,0,0,0,2
"9976","oo",0,2,0,0,2
"9977","openinglyceums",2,0,0,0,2
"9978","opens",1,0,0,1,2
"9979","operator",2,0,0,0,2
"9980","opponent",1,0,1,0,2
"9981","opposes",2,0,0,0,2
"9982","oppressions",0,2,0,0,2
"9983","oppressive",1,1,0,0,2
"9984","opprobrious",1,1,0,0,2
"9985","option",2,0,0,0,2
"9986","opulent",2,0,0,0,2
"9987","ordains",1,1,0,0,2
"9988","ordinances",0,2,0,0,2
"9989","organic",1,1,0,0,2
"9990","ornament",0,0,1,1,2
"9991","orphans",2,0,0,0,2
"9992","othersmen",2,0,0,0,2
"9993","outbid",1,1,0,0,2
"9994","outbreaks",0,1,1,0,2
"9995","outgrowth",2,0,0,0,2
"9996","outlaw",1,1,0,0,2
"9997","outragea",2,0,0,0,2
"9998","outright",1,1,0,0,2
"9999","outset",2,0,0,0,2
"10000","outsiders",1,1,0,0,2
"10001","outspread",0,1,0,1,2
"10002","overboard",1,1,0,0,2
"10003","overflowing",2,0,0,0,2
"10004","overhanging",1,0,0,1,2
"10005","overruling",1,1,0,0,2
"10006","overseercol",2,0,0,0,2
"10007","overseersauthor",2,0,0,0,2
"10008","oversight",1,1,0,0,2
"10009","oversleeping",1,1,0,0,2
"10010","overthrown",1,1,0,0,2
"10011","overwhelmingly",1,1,0,0,2
"10012","overwork",1,1,0,0,2
"10013","overworked",2,0,0,0,2
"10014","p m",2,0,0,0,2
"10015","paddles",1,0,1,0,2
"10016","padlock",1,1,0,0,2
"10017","paestum",0,0,0,2,2
"10018","palazza",0,0,0,2,2
"10019","paler",1,1,0,0,2
"10020","palsy",2,0,0,0,2
"10021","pampered",0,1,1,0,2
"10022","panting",0,0,2,0,2
"10023","papers“free",2,0,0,0,2
"10024","papersunjust",2,0,0,0,2
"10025","parks",1,1,0,0,2
"10026","parliamentary",2,0,0,0,2
"10027","parody",0,0,2,0,2
"10028","paroxysm",1,1,0,0,2
"10029","parry",1,1,0,0,2
"10030","parsnips",1,1,0,0,2
"10031","partake",1,1,0,0,2
"10032","partisan",2,0,0,0,2
"10033","partner",2,0,0,0,2
"10034","partridges",1,1,0,0,2
"10035","party”",2,0,0,0,2
"10036","passageattractions",2,0,0,0,2
"10037","pasturage",1,1,0,0,2
"10038","pat",1,1,0,0,2
"10039","patent",1,1,0,0,2
"10040","paths",1,1,0,0,2
"10041","paton",1,1,0,0,2
"10042","patriarchal",1,1,0,0,2
"10043","patriot",2,0,0,0,2
"10044","patrons",2,0,0,0,2
"10045","pauper",1,1,0,0,2
"10046","paved",1,1,0,0,2
"10047","paws",0,1,1,0,2
"10048","payment",1,1,0,0,2
"10049","pays",2,0,0,0,2
"10050","peace_",0,2,0,0,2
"10051","pearly",1,1,0,0,2
"10052","pears",1,1,0,0,2
"10053","peas",1,1,0,0,2
"10054","peasantry",1,1,0,0,2
"10055","pebbles",1,1,0,0,2
"10056","pecked",0,2,0,0,2
"10057","peculiarity",1,0,0,1,2
"10058","peerless",2,0,0,0,2
"10059","pegged",1,1,0,0,2
"10060","pelting",0,2,0,0,2
"10061","pencil",1,1,0,0,2
"10062","pendleton",2,0,0,0,2
"10063","penetrating",1,1,0,0,2
"10064","penning",1,1,0,0,2
"10065","peopleletter",2,0,0,0,2
"10066","perceive",1,0,1,0,2
"10067","perceiving",1,0,0,1,2
"10068","perch",1,1,0,0,2
"10069","perchance",1,1,0,0,2
"10070","perched",1,1,0,0,2
"10071","perdition",1,0,1,0,2
"10072","peremptory",1,1,0,0,2
"10073","performer",1,1,0,0,2
"10074","periodical",1,1,0,0,2
"10075","periods",1,0,0,1,2
"10076","perishing",0,1,1,0,2
"10077","permanently",2,0,0,0,2
"10078","pernicious",0,0,2,0,2
"10079","perniciously",1,1,0,0,2
"10080","perpetrator",0,1,1,0,2
"10081","perpetrators",1,1,0,0,2
"10082","perpetuity",2,0,0,0,2
"10083","perplexities",2,0,0,0,2
"10084","persevere",1,1,0,0,2
"10085","persevered",1,1,0,0,2
"10086","persistence",1,1,0,0,2
"10087","personage",1,1,0,0,2
"10088","persuading",2,0,0,0,2
"10089","perturbation",1,1,0,0,2
"10090","perusing",1,1,0,0,2
"10091","pervade",1,1,0,0,2
"10092","perverted",1,1,0,0,2
"10093","peters",0,0,0,2,2
"10094","phantoms",1,1,0,0,2
"10095","pheasants",1,1,0,0,2
"10096","phelps",2,0,0,0,2
"10097","philadelphiaditto",2,0,0,0,2
"10098","philanthropist",0,1,0,1,2
"10099","philosopher",2,0,0,0,2
"10100","physically",1,1,0,0,2
"10101","physician",1,1,0,0,2
"10102","piazza",0,0,0,2,2
"10103","picanninies",2,0,0,0,2
"10104","picking",1,1,0,0,2
"10105","pickled",1,1,0,0,2
"10106","picturesque",0,0,0,2,2
"10107","pie",1,1,0,0,2
"10108","pierpont",1,1,0,0,2
"10109","pigeons",1,1,0,0,2
"10110","pilgrim",0,1,1,0,2
"10111","pilgrimage",1,1,0,0,2
"10112","pillowed",1,1,0,0,2
"10113","pin",1,1,0,0,2
"10114","pinching",1,1,0,0,2
"10115","pinchings",1,1,0,0,2
"10116","pinhook",1,1,0,0,2
"10117","pining",1,1,0,0,2
"10118","pinioned",1,1,0,0,2
"10119","pint",1,1,0,0,2
"10120","piracy",0,2,0,0,2
"10121","pisa",0,0,0,2,2
"10122","pitiable",1,1,0,0,2
"10123","pitiless",1,0,1,0,2
"10124","pittsburgh",1,1,0,0,2
"10125","plains",0,1,0,1,2
"10126","planks",2,0,0,0,2
"10127","plantationaunt",2,0,0,0,2
"10128","plantationhome",2,0,0,0,2
"10129","planter",0,1,1,0,2
"10130","planters",1,0,1,0,2
"10131","plants",1,1,0,0,2
"10132","platforms",1,1,0,0,2
"10133","plays",0,2,0,0,2
"10134","pleasantry",1,1,0,0,2
"10135","pleases",1,1,0,0,2
"10136","plentiful",0,2,0,0,2
"10137","plot_",0,2,0,0,2
"10138","ploughing",0,0,2,0,2
"10139","plummer’s",1,1,0,0,2
"10140","plump",1,1,0,0,2
"10141","plunge",1,1,0,0,2
"10142","plunging",0,1,1,0,2
"10143","plying",1,1,0,0,2
"10144","poetic",2,0,0,0,2
"10145","pointing",2,0,0,0,2
"10146","polished",1,1,0,0,2
"10147","politenessdoctor",2,0,0,0,2
"10148","politicians",2,0,0,0,2
"10149","polluted",1,1,0,0,2
"10150","pomeroy",2,0,0,0,2
"10151","pond",0,2,0,0,2
"10152","ponderous",1,1,0,0,2
"10153","poorest",1,1,0,0,2
"10154","pope",0,0,0,2,2
"10155","poplar",1,1,0,0,2
"10156","populace",2,0,0,0,2
"10157","populated",1,1,0,0,2
"10158","portentous",2,0,0,0,2
"10159","portions",1,1,0,0,2
"10160","portly",1,1,0,0,2
"10161","portrayed",1,1,0,0,2
"10162","positiveness",1,1,0,0,2
"10163","possesses",2,0,0,0,2
"10164","possessor",1,1,0,0,2
"10165","postal",2,0,0,0,2
"10166","postandrail",2,0,0,0,2
"10167","poste",0,0,0,2,2
"10168","postmastergeneral",2,0,0,0,2
"10169","postponedmusings",2,0,0,0,2
"10170","povertystricken",2,0,0,0,2
"10171","prairie",1,1,0,0,2
"10172","praises",1,1,0,0,2
"10173","praiseworthy",1,1,0,0,2
"10174","prayer”",2,0,0,0,2
"10175","prayermeetings",2,0,0,0,2
"10176","precepts",0,1,1,0,2
"10177","precursor",1,1,0,0,2
"10178","predecessor",1,1,0,0,2
"10179","preeminent",0,2,0,0,2
"10180","preëminent",2,0,0,0,2
"10181","preferable",0,1,1,0,2
"10182","prefers",1,1,0,0,2
"10183","prejudicethe",2,0,0,0,2
"10184","prejudicial",1,1,0,0,2
"10185","premature",2,0,0,0,2
"10186","preposterous",1,1,0,0,2
"10187","prescience",1,1,0,0,2
"10188","prescriptions",1,1,0,0,2
"10189","presenting",2,0,0,0,2
"10190","presently",1,1,0,0,2
"10191","president’s",2,0,0,0,2
"10192","presidents",2,0,0,0,2
"10193","presses",1,1,0,0,2
"10194","prestige",2,0,0,0,2
"10195","presumptuous",0,1,1,0,2
"10196","pretenders",1,1,0,0,2
"10197","prevents",1,1,0,0,2
"10198","prices",1,1,0,0,2
"10199","priest",0,0,0,2,2
"10200","primitive",1,1,0,0,2
"10201","princes",1,0,0,1,2
"10202","prisonsent",2,0,0,0,2
"10203","privations",1,0,1,0,2
"10204","prize",1,1,0,0,2
"10205","processes",0,2,0,0,2
"10206","processionnot",2,0,0,0,2
"10207","proclaims",0,1,1,0,2
"10208","prodigy",0,1,1,0,2
"10209","profaning",1,1,0,0,2
"10210","professional",2,0,0,0,2
"10211","professors",1,1,0,0,2
"10212","profitable",0,1,1,0,2
"10213","profits",0,2,0,0,2
"10214","profligacy",1,1,0,0,2
"10215","programme",1,1,0,0,2
"10216","prohibitory",0,2,0,0,2
"10217","promising",1,1,0,0,2
"10218","pronounce",0,2,0,0,2
"10219","propensity",1,1,0,0,2
"10220","properties",0,1,0,1,2
"10221","propertyhard",2,0,0,0,2
"10222","proportionately",1,1,0,0,2
"10223","proposal",1,0,1,0,2
"10224","proposes",1,1,0,0,2
"10225","proposing",1,1,0,0,2
"10226","proscriptions",2,0,0,0,2
"10227","proscriptive",2,0,0,0,2
"10228","prosecuted",2,0,0,0,2
"10229","prosecution",2,0,0,0,2
"10230","prospectscovey",2,0,0,0,2
"10231","prostrate",1,0,1,0,2
"10232","protestants",2,0,0,0,2
"10233","proximate",1,1,0,0,2
"10234","prying",1,1,0,0,2
"10235","psalm",0,1,1,0,2
"10236","puffed",0,1,1,0,2
"10237","pulling",1,1,0,0,2
"10238","pump",1,1,0,0,2
"10239","punch",0,1,1,0,2
"10240","punishable",0,2,0,0,2
"10241","puny",1,1,0,0,2
"10242","pupilsconfidence",2,0,0,0,2
"10243","purple",0,2,0,0,2
"10244","pursuance",2,0,0,0,2
"10245","pursuits",1,1,0,0,2
"10246","pursuitsuffering",2,0,0,0,2
"10247","putnams",0,0,0,2,2
"10248","puzzle",0,2,0,0,2
"10249","puzzled",1,1,0,0,2
"10250","pyramid",0,0,0,2,2
"10251","quails",1,1,0,0,2
"10252","qualifications",1,1,0,0,2
"10253","qualify",2,0,0,0,2
"10254","quarrels",0,1,1,0,2
"10255","quartersleeping",2,0,0,0,2
"10256","queerest",0,0,0,2,2
"10257","quelled",1,1,0,0,2
"10258","quitting",1,1,0,0,2
"10259","quondam",1,1,0,0,2
"10260","quotations",2,0,0,0,2
"10261","r ",2,0,0,0,2
"10262","r b",2,0,0,0,2
"10263","rabbi",0,0,2,0,2
"10264","racing",1,1,0,0,2
"10265","radishes",1,1,0,0,2
"10266","ragged",1,1,0,0,2
"10267","railroadincidents",2,0,0,0,2
"10268","rainbow",1,1,0,0,2
"10269","rained",1,1,0,0,2
"10270","rains",1,1,0,0,2
"10271","raises",0,2,0,0,2
"10272","raisins",1,1,0,0,2
"10273","rambler",1,1,0,0,2
"10274","ramses",0,1,0,1,2
"10275","ranking",0,2,0,0,2
"10276","rapine",1,1,0,0,2
"10277","rascal”",2,0,0,0,2
"10278","rascals",1,1,0,0,2
"10279","ration",1,1,0,0,2
"10280","raymond",0,2,0,0,2
"10281","rays",1,1,0,0,2
"10282","readbaneful",2,0,0,0,2
"10283","readiness",1,0,1,0,2
"10284","readtoo",2,0,0,0,2
"10285","realities",1,1,0,0,2
"10286","realizing",1,1,0,0,2
"10287","realm",2,0,0,0,2
"10288","reasonably",2,0,0,0,2
"10289","reassures",1,1,0,0,2
"10290","rebuking",1,1,0,0,2
"10291","recapitulates",1,1,0,0,2
"10292","recaptured",1,1,0,0,2
"10293","receding",0,0,1,1,2
"10294","receptionmr",2,0,0,0,2
"10295","receptionthe",2,0,0,0,2
"10296","recital",0,1,1,0,2
"10297","recognitionfriends",2,0,0,0,2
"10298","reconciliation",2,0,0,0,2
"10299","reconsideration",1,1,0,0,2
"10300","records",0,2,0,0,2
"10301","recount",2,0,0,0,2
"10302","recourse",1,1,0,0,2
"10303","recreancy",1,1,0,0,2
"10304","recruit",2,0,0,0,2
"10305","rectitude",0,2,0,0,2
"10306","recurrence",0,1,1,0,2
"10307","redemption",2,0,0,0,2
"10308","reduces",0,1,1,0,2
"10309","redwinged",2,0,0,0,2
"10310","reechoed",1,1,0,0,2
"10311","reed",1,0,0,1,2
"10312","refers",1,1,0,0,2
"10313","reflects",1,1,0,0,2
"10314","reflex",1,1,0,0,2
"10315","reformation",1,1,0,0,2
"10316","refrained",1,1,0,0,2
"10317","refreshed",1,1,0,0,2
"10318","refreshing",1,1,0,0,2
"10319","refreshment",1,1,0,0,2
"10320","refuses",1,1,0,0,2
"10321","refutation",1,1,0,0,2
"10322","refuted",2,0,0,0,2
"10323","regardless",2,0,0,0,2
"10324","regimentsvisit",2,0,0,0,2
"10325","regretplan",2,0,0,0,2
"10326","regretsmy",2,0,0,0,2
"10327","rehearsed",1,1,0,0,2
"10328","reigned",1,1,0,0,2
"10329","reins",0,2,0,0,2
"10330","rejoins",1,1,0,0,2
"10331","relaxed",1,1,0,0,2
"10332","relented",1,1,0,0,2
"10333","relieving",1,1,0,0,2
"10334","religion”",2,0,0,0,2
"10335","religionists",0,1,1,0,2
"10336","religiously",1,1,0,0,2
"10337","reluctance",2,0,0,0,2
"10338","remedial",1,1,0,0,2
"10339","renounced",1,1,0,0,2
"10340","renovating",1,1,0,0,2
"10341","rented",0,1,1,0,2
"10342","repaid",1,0,0,1,2
"10343","repairing",0,2,0,0,2
"10344","repelling",1,1,0,0,2
"10345","repenting",1,1,0,0,2
"10346","replace",2,0,0,0,2
"10347","replaced",1,1,0,0,2
"10348","replying",2,0,0,0,2
"10349","reposed",1,0,1,0,2
"10350","repressed",1,1,0,0,2
"10351","reprimand",2,0,0,0,2
"10352","reproachful",1,1,0,0,2
"10353","reproachfully",1,1,0,0,2
"10354","reproaching",1,1,0,0,2
"10355","reproofs",1,1,0,0,2
"10356","repugnant",2,0,0,0,2
"10357","resembling",1,0,0,1,2
"10358","reside",0,2,0,0,2
"10359","residences",1,1,0,0,2
"10360","residents",1,0,1,0,2
"10361","resolutely",2,0,0,0,2
"10362","resolvethe",2,0,0,0,2
"10363","resources",1,0,1,0,2
"10364","respectably",2,0,0,0,2
"10365","respite",1,1,0,0,2
"10366","restrain",0,1,1,0,2
"10367","restriction",2,0,0,0,2
"10368","rests",0,2,0,0,2
"10369","resultfaith",2,0,0,0,2
"10370","resultplans",2,0,0,0,2
"10371","reticent",2,0,0,0,2
"10372","retreated",2,0,0,0,2
"10373","retribution",1,1,0,0,2
"10374","revelations",1,1,0,0,2
"10375","revengeful",2,0,0,0,2
"10376","reverberating",0,1,0,1,2
"10377","revered",1,1,0,0,2
"10378","reverently",2,0,0,0,2
"10379","reverses",1,1,0,0,2
"10380","review",1,0,0,1,2
"10381","revised",0,2,0,0,2
"10382","revisit",2,0,0,0,2
"10383","revisits",2,0,0,0,2
"10384","reviving",1,1,0,0,2
"10385","revolt",2,0,0,0,2
"10386","rewards",1,1,0,0,2
"10387","rheumatism",1,1,0,0,2
"10388","ribaldry",1,1,0,0,2
"10389","riceswamp",2,0,0,0,2
"10390","richmondfanueil",2,0,0,0,2
"10391","riders",1,1,0,0,2
"10392","ridges",0,0,2,0,2
"10393","rifle",1,1,0,0,2
"10394","rights”",2,0,0,0,2
"10395","rights”american",2,0,0,0,2
"10396","rightspresident",2,0,0,0,2
"10397","ring",1,1,0,0,2
"10398","riotsreelection",2,0,0,0,2
"10399","roam",0,2,0,0,2
"10400","roast",1,1,0,0,2
"10401","robb",1,1,0,0,2
"10402","robe",1,0,0,1,2
"10403","robes",0,0,2,0,2
"10404","rochesterits",2,0,0,0,2
"10405","rock",1,1,0,0,2
"10406","rocking",1,1,0,0,2
"10407","rodgers",2,0,0,0,2
"10408","rodney",1,1,0,0,2
"10409","romance",2,0,0,0,2
"10410","roses",1,0,0,1,2
"10411","roughest",2,0,0,0,2
"10412","roughing",1,1,0,0,2
"10413","rousing",1,1,0,0,2
"10414","rowdies",1,1,0,0,2
"10415","rows",1,1,0,0,2
"10416","rue",1,0,0,1,2
"10417","ruffianly",1,1,0,0,2
"10418","ruffin",2,0,0,0,2
"10419","rugged",1,1,0,0,2
"10420","rugglesmarriagesteamer",2,0,0,0,2
"10421","rulepower",2,0,0,0,2
"10422","rust",1,1,0,0,2
"10423","rustled",1,1,0,0,2
"10424","rusty",1,1,0,0,2
"10425","sabbathschools",2,0,0,0,2
"10426","sabbathschoolsecresy",2,0,0,0,2
"10427","sack",2,0,0,0,2
"10428","sackcloth",1,1,0,0,2
"10429","sacredly",2,0,0,0,2
"10430","saddles",1,1,0,0,2
"10431","sagacious",2,0,0,0,2
"10432","sakkara",0,0,0,2,2
"10433","salaries",2,0,0,0,2
"10434","saleable",1,1,0,0,2
"10435","salutary",0,1,1,0,2
"10436","sanctifier",0,1,1,0,2
"10437","sanctioned",1,1,0,0,2
"10438","sandyhis",2,0,0,0,2
"10439","sapling",1,1,0,0,2
"10440","satan",1,1,0,0,2
"10441","satiety",1,1,0,0,2
"10442","savageness",1,1,0,0,2
"10443","savior",0,2,0,0,2
"10444","sawed",1,1,0,0,2
"10445","scamp",1,1,0,0,2
"10446","scampered",1,1,0,0,2
"10447","scarcity",1,1,0,0,2
"10448","scatter",1,1,0,0,2
"10449","scenerysloop",2,0,0,0,2
"10450","scenesold",2,0,0,0,2
"10451","schemes",2,0,0,0,2
"10452","schooled",2,0,0,0,2
"10453","schurz",2,0,0,0,2
"10454","scoffed",1,1,0,0,2
"10455","scold",0,0,2,0,2
"10456","scoldings",1,1,0,0,2
"10457","scorching",0,2,0,0,2
"10458","scores",1,1,0,0,2
"10459","scorned",1,1,0,0,2
"10460","scornful",1,1,0,0,2
"10461","scornfully",1,1,0,0,2
"10462","scourged",0,2,0,0,2
"10463","scourging",0,0,2,0,2
"10464","scowl",1,1,0,0,2
"10465","screaming",1,0,0,1,2
"10466","screws",0,1,1,0,2
"10467","scriptural",1,1,0,0,2
"10468","scrupulous",1,1,0,0,2
"10469","scrupulously",1,1,0,0,2
"10470","scrutinizing",1,1,0,0,2
"10471","sculpture",0,0,0,2,2
"10472","sealing",1,1,0,0,2
"10473","seam",1,1,0,0,2
"10474","seared",1,1,0,0,2
"10475","secreted",1,1,0,0,2
"10476","secretly",0,1,1,0,2
"10477","securities",2,0,0,0,2
"10478","seemings",1,1,0,0,2
"10479","seizing",1,1,0,0,2
"10480","self",2,0,0,0,2
"10481","selfdefense",2,0,0,0,2
"10482","selfmade",2,0,0,0,2
"10483","selfpossessed",2,0,0,0,2
"10484","selfpossession",2,0,0,0,2
"10485","selfpreservation",2,0,0,0,2
"10486","sella",2,0,0,0,2
"10487","semblance",1,0,1,0,2
"10488","seminary”",2,0,0,0,2
"10489","sensibility",1,1,0,0,2
"10490","sensibly",1,1,0,0,2
"10491","sensitivenessmy",2,0,0,0,2
"10492","separations",1,1,0,0,2
"10493","serene",1,1,0,0,2
"10494","sermons",1,1,0,0,2
"10495","serves",1,1,0,0,2
"10496","seth",1,1,0,0,2
"10497","sets",2,0,0,0,2
"10498","settling",1,1,0,0,2
"10499","seveir",2,0,0,0,2
"10500","severance",1,1,0,0,2
"10501","severity",0,1,1,0,2
"10502","sevier’s",0,2,0,0,2
"10503","sexes",1,0,1,0,2
"10504","shaded",1,1,0,0,2
"10505","shal",0,0,0,2,2
"10506","shallow",2,0,0,0,2
"10507","shameful",2,0,0,0,2
"10508","shapeless",1,1,0,0,2
"10509","shaw",1,0,1,0,2
"10510","shd",0,0,0,2,2
"10511","shedding",1,1,0,0,2
"10512","shelf",1,1,0,0,2
"10513","shell",1,1,0,0,2
"10514","shelling",1,1,0,0,2
"10515","shells",0,1,1,0,2
"10516","shelterless",1,1,0,0,2
"10517","shielding",1,1,0,0,2
"10518","shilling",1,1,0,0,2
"10519","shillings",1,1,0,0,2
"10520","shingles",1,1,0,0,2
"10521","shipbuilder",2,0,0,0,2
"10522","shipped",1,1,0,0,2
"10523","shirting",1,1,0,0,2
"10524","shockingly",1,1,0,0,2
"10525","shoreless",1,1,0,0,2
"10526","shorter",1,1,0,0,2
"10527","shose",1,1,0,0,2
"10528","shove",2,0,0,0,2
"10529","shovel",0,0,1,1,2
"10530","shoveled",1,1,0,0,2
"10531","shoves",2,0,0,0,2
"10532","shrinking",0,1,1,0,2
"10533","sibley",2,0,0,0,2
"10534","sickening",0,2,0,0,2
"10535","sicknatural",2,0,0,0,2
"10536","sidewalk",2,0,0,0,2
"10537","sif",1,1,0,0,2
"10538","sighing",0,2,0,0,2
"10539","sighted",0,2,0,0,2
"10540","signed",0,1,1,0,2
"10541","silencer",1,1,0,0,2
"10542","silk",1,1,0,0,2
"10543","silvery",0,1,1,0,2
"10544","similarity",1,1,0,0,2
"10545","singers",2,0,0,0,2
"10546","singlehanded",2,0,0,0,2
"10547","sinks",1,1,0,0,2
"10548","sinless",1,1,0,0,2
"10549","sisson",2,0,0,0,2
"10550","sixpreliminaries",2,0,0,0,2
"10551","skies",1,1,0,0,2
"10552","skilled",1,1,0,0,2
"10553","skillfully",1,1,0,0,2
"10554","skim",1,1,0,0,2
"10555","skinners",1,1,0,0,2
"10556","skins",1,1,0,0,2
"10557","skipped",1,1,0,0,2
"10558","skirmishing",1,1,0,0,2
"10559","slab",1,1,0,0,2
"10560","slain",1,1,0,0,2
"10561","slammed",1,1,0,0,2
"10562","slavedriver",2,0,0,0,2
"10563","slavers",0,2,0,0,2
"10564","slavery’s",1,1,0,0,2
"10565","slaveryaunt",2,0,0,0,2
"10566","slaverycity",2,0,0,0,2
"10567","slaveryeffects",2,0,0,0,2
"10568","slaveryincipient",2,0,0,0,2
"10569","slaveryone",2,0,0,0,2
"10570","slaverythe",2,0,0,0,2
"10571","slaverywar",2,0,0,0,2
"10572","slavesan",2,0,0,0,2
"10573","slavescolonel",2,0,0,0,2
"10574","slavescolumbian",2,0,0,0,2
"10575","slavesone",2,0,0,0,2
"10576","slavessent",2,0,0,0,2
"10577","slavesslavery",2,0,0,0,2
"10578","slavetrade",2,0,0,0,2
"10579","slavetrader",2,0,0,0,2
"10580","slavewhip",2,0,0,0,2
"10581","slavewoman",1,1,0,0,2
"10582","sleek",0,0,2,0,2
"10583","sleighs",1,1,0,0,2
"10584","slices",1,1,0,0,2
"10585","slighted",2,0,0,0,2
"10586","sloops",1,1,0,0,2
"10587","slovenly",1,1,0,0,2
"10588","sluggard",1,1,0,0,2
"10589","smallest",2,0,0,0,2
"10590","smeal",1,1,0,0,2
"10591","smoother",1,1,0,0,2
"10592","smouldering",1,1,0,0,2
"10593","snares",1,1,0,0,2
"10594","sneaked",1,1,0,0,2
"10595","snows",2,0,0,0,2
"10596","snowy",1,0,0,1,2
"10597","snub",1,1,0,0,2
"10598","sobbed",1,1,0,0,2
"10599","sobs",1,1,0,0,2
"10600","socket",1,1,0,0,2
"10601","sod",1,0,1,0,2
"10602","soever",1,1,0,0,2
"10603","softened",1,1,0,0,2
"10604","softer",1,1,0,0,2
"10605","soil”",2,0,0,0,2
"10606","soiling",0,2,0,0,2
"10607","sojourn",1,1,0,0,2
"10608","solicitation",0,2,0,0,2
"10609","solicitude",2,0,0,0,2
"10610","solomon",2,0,0,0,2
"10611","solved“nat",2,0,0,0,2
"10612","somehow",1,0,0,1,2
"10613","soninlaw",2,0,0,0,2
"10614","sonorous",1,1,0,0,2
"10615","sonsinlaw",2,0,0,0,2
"10616","soothe",1,1,0,0,2
"10617","soothes",1,1,0,0,2
"10618","sopha",0,2,0,0,2
"10619","sophiamy",2,0,0,0,2
"10620","sordid",1,1,0,0,2
"10621","sot",1,1,0,0,2
"10622","souled",0,2,0,0,2
"10623","sounding",1,1,0,0,2
"10624","sournessmy",2,0,0,0,2
"10625","southwest",2,0,0,0,2
"10626","sow",2,0,0,0,2
"10627","spade",1,0,0,1,2
"10628","span",1,0,0,1,2
"10629","spartan",1,0,1,0,2
"10630","specific",1,1,0,0,2
"10631","specimens",0,1,1,0,2
"10632","spectaclenight",2,0,0,0,2
"10633","speculation",1,1,0,0,2
"10634","speculations",1,1,0,0,2
"10635","speechmuch",2,0,0,0,2
"10636","spellingbooks",2,0,0,0,2
"10637","spicy",1,1,0,0,2
"10638","spike",0,2,0,0,2
"10639","spiritcunning",2,0,0,0,2
"10640","spirituous",1,1,0,0,2
"10641","splendors",2,0,0,0,2
"10642","splinters",1,1,0,0,2
"10643","split",2,0,0,0,2
"10644","spoiled",1,0,1,0,2
"10645","spurned",1,1,0,0,2
"10646","squirrels",1,1,0,0,2
"10647","stability",1,1,0,0,2
"10648","staid",0,0,2,0,2
"10649","stairs",2,0,0,0,2
"10650","stallo",0,0,0,2,2
"10651","stammering",1,1,0,0,2
"10652","stampede",2,0,0,0,2
"10653","stantonpromised",2,0,0,0,2
"10654","staple",1,1,0,0,2
"10655","stare",1,0,1,0,2
"10656","starry",1,1,0,0,2
"10657","starspangled",2,0,0,0,2
"10658","startles",1,1,0,0,2
"10659","statesfidelity",2,0,0,0,2
"10660","statesmobsincidents",2,0,0,0,2
"10661","status",1,0,0,1,2
"10662","steadfast",2,0,0,0,2
"10663","stealargument",2,0,0,0,2
"10664","steambox",2,0,0,0,2
"10665","steeps",0,0,0,2,2
"10666","steerage",1,1,0,0,2
"10667","steered",0,1,1,0,2
"10668","steering",1,1,0,0,2
"10669","stewards",1,1,0,0,2
"10670","stiffen",0,1,1,0,2
"10671","stilled",1,1,0,0,2
"10672","stimulate",1,0,1,0,2
"10673","stimulus",2,0,0,0,2
"10674","stinging",1,1,0,0,2
"10675","stonington",2,0,0,0,2
"10676","storehouse",2,0,0,0,2
"10677","stormbeaten",2,0,0,0,2
"10678","stormed",1,1,0,0,2
"10679","stowe’s",1,1,0,0,2
"10680","straining",1,1,0,0,2
"10681","straits",0,1,0,1,2
"10682","stratagems",0,0,2,0,2
"10683","strategy",2,0,0,0,2
"10684","strengthening",2,0,0,0,2
"10685","stringency",1,1,0,0,2
"10686","strip",1,0,1,0,2
"10687","strive",1,1,0,0,2
"10688","strokes",1,1,0,0,2
"10689","struggling",0,1,0,1,2
"10690","struts",1,1,0,0,2
"10691","students",2,0,0,0,2
"10692","studies",1,1,0,0,2
"10693","stuffed",1,0,1,0,2
"10694","stuttered",1,1,0,0,2
"10695","suasion",2,0,0,0,2
"10696","subdued",1,1,0,0,2
"10697","sublimely",1,1,0,0,2
"10698","subsequently",2,0,0,0,2
"10699","subsiding",1,1,0,0,2
"10700","subsisted",1,1,0,0,2
"10701","subsisting",1,1,0,0,2
"10702","substantially",2,0,0,0,2
"10703","subtle",1,1,0,0,2
"10704","subtlety",1,1,0,0,2
"10705","succeeds",0,2,0,0,2
"10706","succulent",0,2,0,0,2
"10707","succumbed",1,1,0,0,2
"10708","suez",0,0,0,2,2
"10709","sufferers",1,1,0,0,2
"10710","suffice",0,2,0,0,2
"10711","sufficiency",0,1,1,0,2
"10712","sulkeys",1,1,0,0,2
"10713","sulky",1,1,0,0,2
"10714","sullen",1,1,0,0,2
"10715","sullenness",1,1,0,0,2
"10716","sumner”",2,0,0,0,2
"10717","sumpon",1,1,0,0,2
"10718","sumpter",2,0,0,0,2
"10719","sumptuously",1,1,0,0,2
"10720","supercilious",1,1,0,0,2
"10721","superintended",1,1,0,0,2
"10722","superstitious",0,1,1,0,2
"10723","superstructure",2,0,0,0,2
"10724","supperinterview",2,0,0,0,2
"10725","supple",1,1,0,0,2
"10726","supporter",0,2,0,0,2
"10727","surmised",1,1,0,0,2
"10728","surprisethe",2,0,0,0,2
"10729","surveyed",0,1,0,1,2
"10730","susan",1,1,0,0,2
"10731","suspend",2,0,0,0,2
"10732","suspicions",0,2,0,0,2
"10733","sustenance",1,1,0,0,2
"10734","swallowed",1,1,0,0,2
"10735","swamped",1,1,0,0,2
"10736","swearer",0,0,2,0,2
"10737","swedish",2,0,0,0,2
"10738","sweep",0,1,1,0,2
"10739","sweeter",2,0,0,0,2
"10740","sweetly",0,2,0,0,2
"10741","swiftest",1,1,0,0,2
"10742","swimmingly",0,2,0,0,2
"10743","switch",0,1,1,0,2
"10744","swords",2,0,0,0,2
"10745","sworn",2,0,0,0,2
"10746","swung",1,1,0,0,2
"10747","symmetrical",2,0,0,0,2
"10748","sympathetic",2,0,0,0,2
"10749","tablecloth",2,0,0,0,2
"10750","tables",1,1,0,0,2
"10751","tablets",0,0,0,2,2
"10752","tails",0,2,0,0,2
"10753","takenplan",2,0,0,0,2
"10754","talons",1,1,0,0,2
"10755","tamely",2,0,0,0,2
"10756","tampering",1,1,0,0,2
"10757","taney",2,0,0,0,2
"10758","tappan",2,0,0,0,2
"10759","tar",0,0,2,0,2
"10760","tardily",1,1,0,0,2
"10761","tardy",2,0,0,0,2
"10762","tarry",1,1,0,0,2
"10763","tattling",1,1,0,0,2
"10764","teams",1,0,1,0,2
"10765","teas",1,1,0,0,2
"10766","tech",1,1,0,0,2
"10767","telegram",2,0,0,0,2
"10768","telegraphed",1,0,0,1,2
"10769","temerity",1,1,0,0,2
"10770","temperate",1,1,0,0,2
"10771","tempered",0,2,0,0,2
"10772","tempers",1,0,1,0,2
"10773","temples",0,0,0,2,2
"10774","temporarily",1,1,0,0,2
"10775","tended",2,0,0,0,2
"10776","tendered",2,0,0,0,2
"10777","tenderest",0,2,0,0,2
"10778","tenderly",1,1,0,0,2
"10779","tendernessa",2,0,0,0,2
"10780","tends",2,0,0,0,2
"10781","tenor",1,1,0,0,2
"10782","tenths",0,1,1,0,2
"10783","termagant",1,1,0,0,2
"10784","terrapin",1,1,0,0,2
"10785","terribly",2,0,0,0,2
"10786","terrors",0,2,0,0,2
"10787","testament",0,1,1,0,2
"10788","testaments",1,1,0,0,2
"10789","texas",2,0,0,0,2
"10790","thaddeus",2,0,0,0,2
"10791","thames",1,1,0,0,2
"10792","thankful",1,0,0,1,2
"10793","thanking",2,0,0,0,2
"10794","themlearning",2,0,0,0,2
"10795","themmy",2,0,0,0,2
"10796","themno",2,0,0,0,2
"10797","thempiteous",2,0,0,0,2
"10798","themslave",2,0,0,0,2
"10799","thencehis",2,0,0,0,2
"10800","theories",1,1,0,0,2
"10801","thereabouts",1,1,0,0,2
"10802","thereby",2,0,0,0,2
"10803","theredriver’s",2,0,0,0,2
"10804","thereinvited",2,0,0,0,2
"10805","therekind",2,0,0,0,2
"10806","therenational",2,0,0,0,2
"10807","thereofsouthern",2,0,0,0,2
"10808","thereto",1,1,0,0,2
"10809","theretohostility",2,0,0,0,2
"10810","thickly",1,1,0,0,2
"10811","thickness",0,2,0,0,2
"10812","thine",0,0,2,0,2
"10813","thirteenth",1,1,0,0,2
"10814","thirtynine",2,0,0,0,2
"10815","thomasdisappointment",2,0,0,0,2
"10816","thomashis",2,0,0,0,2
"10817","thomasvisit",2,0,0,0,2
"10818","thoroughfares",1,1,0,0,2
"10819","thought“",2,0,0,0,2
"10820","thralldom",0,2,0,0,2
"10821","threatens",2,0,0,0,2
"10822","threequarters",2,0,0,0,2
"10823","throats",1,0,1,0,2
"10824","throb",1,1,0,0,2
"10825","thumping",1,1,0,0,2
"10826","tickets",2,0,0,0,2
"10827","tight",1,1,0,0,2
"10828","tightly",1,1,0,0,2
"10829","tilgmans",1,1,0,0,2
"10830","tilling",2,0,0,0,2
"10831","time”",2,0,0,0,2
"10832","timea",2,0,0,0,2
"10833","tinged",2,0,0,0,2
"10834","tippling",1,1,0,0,2
"10835","toe",0,0,0,2,2
"10836","tolly",1,1,0,0,2
"10837","tom”",2,0,0,0,2
"10838","tommy’s",1,1,0,0,2
"10839","tommymy",2,0,0,0,2
"10840","tool",1,1,0,0,2
"10841","topic",1,1,0,0,2
"10842","topmost",2,0,0,0,2
"10843","torrent",2,0,0,0,2
"10844","toss",1,1,0,0,2
"10845","tossed",2,0,0,0,2
"10846","tough",1,1,0,0,2
"10847","tracing",1,1,0,0,2
"10848","tract",1,1,0,0,2
"10849","tracts",1,1,0,0,2
"10850","trail",1,1,0,0,2
"10851","trainunobserving",2,0,0,0,2
"10852","trait",0,1,1,0,2
"10853","traitors",2,0,0,0,2
"10854","tramping",1,1,0,0,2
"10855","trample",1,1,0,0,2
"10856","trampling",1,0,1,0,2
"10857","transactions",1,1,0,0,2
"10858","transcendent",1,1,0,0,2
"10859","transfer",1,1,0,0,2
"10860","transferable",0,1,1,0,2
"10861","transitory",1,1,0,0,2
"10862","transpire",0,2,0,0,2
"10863","transported",1,1,0,0,2
"10864","travelhon",2,0,0,0,2
"10865","travelling",0,0,1,1,2
"10866","treacherously",0,1,0,1,2
"10867","treadingyardauthor",2,0,0,0,2
"10868","treatment_",0,2,0,0,2
"10869","treesmethod",2,0,0,0,2
"10870","trialsunderground",2,0,0,0,2
"10871","tributary",1,1,0,0,2
"10872","trick",1,1,0,0,2
"10873","trifled",2,0,0,0,2
"10874","triflers",2,0,0,0,2
"10875","trifles",0,2,0,0,2
"10876","triggers",1,1,0,0,2
"10877","trinkets",1,1,0,0,2
"10878","triple",1,1,0,0,2
"10879","trivial",1,1,0,0,2
"10880","tropics",1,1,0,0,2
"10881","troublecustom",2,0,0,0,2
"10882","troubling",1,1,0,0,2
"10883","trout",1,1,0,0,2
"10884","truce",1,1,0,0,2
"10885","truest",2,0,0,0,2
"10886","truthfully",1,1,0,0,2
"10887","tumultous",0,2,0,0,2
"10888","turk",1,1,0,0,2
"10889","turkeys",1,1,0,0,2
"10890","turner”",2,0,0,0,2
"10891","turnpikes",1,1,0,0,2
"10892","tutorswhat",2,0,0,0,2
"10893","tweed",1,1,0,0,2
"10894","twelfth",1,0,1,0,2
"10895","twentyeight",2,0,0,0,2
"10896","twentythree",2,0,0,0,2
"10897","twice",2,0,0,0,2
"10898","twist",1,1,0,0,2
"10899","u s",2,0,0,0,2
"10900","unaccountably",2,0,0,0,2
"10901","unaccustomed",0,1,1,0,2
"10902","unanimity",1,1,0,0,2
"10903","unanimous",0,0,2,0,2
"10904","unapproachable",0,2,0,0,2
"10905","unauthorized",1,1,0,0,2
"10906","unbelief",1,1,0,0,2
"10907","uncensured",0,1,1,0,2
"10908","unchain",2,0,0,0,2
"10909","unchaste",1,1,0,0,2
"10910","unconcernauthor’s",2,0,0,0,2
"10911","unconstitutionality",1,1,0,0,2
"10912","uncontrollable",2,0,0,0,2
"10913","uncover",0,1,1,0,2
"10914","undeniable",1,1,0,0,2
"10915","undercalculate",1,1,0,0,2
"10916","undergo",0,1,1,0,2
"10917","undergoing",1,1,0,0,2
"10918","underrate",0,2,0,0,2
"10919","underrated",1,1,0,0,2
"10920","undeserving",1,1,0,0,2
"10921","undignified",1,1,0,0,2
"10922","undue",2,0,0,0,2
"10923","unequaled",1,1,0,0,2
"10924","unexcited",0,2,0,0,2
"10925","unexplained",0,1,1,0,2
"10926","unfailing",0,2,0,0,2
"10927","unfairly",1,0,1,0,2
"10928","unfeeling",1,1,0,0,2
"10929","unfits",1,1,0,0,2
"10930","unfitted",2,0,0,0,2
"10931","unflagging",1,1,0,0,2
"10932","unflinching",2,0,0,0,2
"10933","unfulfilled",1,1,0,0,2
"10934","unhappiness",1,0,1,0,2
"10935","unharmed",2,0,0,0,2
"10936","unhealthy",2,0,0,0,2
"10937","unholy",0,2,0,0,2
"10938","unimportant",1,1,0,0,2
"10939","unit",1,1,0,0,2
"10940","unity",2,0,0,0,2
"10941","unjustly",1,1,0,0,2
"10942","unload",1,1,0,0,2
"10943","unlooked",1,1,0,0,2
"10944","unlucky",1,1,0,0,2
"10945","unmanly",1,1,0,0,2
"10946","unmarried",1,1,0,0,2
"10947","unnecessarily",1,1,0,0,2
"10948","unparalleled",1,1,0,0,2
"10949","unperverted",1,1,0,0,2
"10950","unplaned",1,1,0,0,2
"10951","unpromising",1,1,0,0,2
"10952","unpunished",0,1,1,0,2
"10953","unrequited",1,1,0,0,2
"10954","unresisted",2,0,0,0,2
"10955","unresolved",1,1,0,0,2
"10956","unsatisfactory",1,1,0,0,2
"10957","unscriptural",0,1,1,0,2
"10958","unseared",1,1,0,0,2
"10959","unseemly",1,1,0,0,2
"10960","unsightly",1,1,0,0,2
"10961","unsoundness",1,1,0,0,2
"10962","unspeakable",2,0,0,0,2
"10963","unsuited",1,1,0,0,2
"10964","unthrifty",1,1,0,0,2
"10965","untoward",1,1,0,0,2
"10966","untried",1,0,1,0,2
"10967","untrue",1,0,1,0,2
"10968","unveil",1,0,0,1,2
"10969","unwarrantable",1,1,0,0,2
"10970","unwavering",2,0,0,0,2
"10971","unwhipped",0,1,1,0,2
"10972","unwonted",1,1,0,0,2
"10973","up_",0,2,0,0,2
"10974","upbraided",1,1,0,0,2
"10975","upbraiding",1,1,0,0,2
"10976","upfirst",2,0,0,0,2
"10977","upright",1,1,0,0,2
"10978","uprising",2,0,0,0,2
"10979","uproar",2,0,0,0,2
"10980","upsad",2,0,0,0,2
"10981","upsetting",1,1,0,0,2
"10982","upstir",1,1,0,0,2
"10983","upward",0,1,1,0,2
"10984","urgently",1,1,0,0,2
"10985","us”",2,0,0,0,2
"10986","uses",2,0,0,0,2
"10987","uttermost",2,0,0,0,2
"10988","utters",0,1,0,1,2
"10989","vainly",1,1,0,0,2
"10990","validity",2,0,0,0,2
"10991","valueless",2,0,0,0,2
"10992","valves",0,1,1,0,2
"10993","van",2,0,0,0,2
"10994","vantage",1,1,0,0,2
"10995","variable",1,1,0,0,2
"10996","vehicles",1,1,0,0,2
"10997","veil",0,2,0,0,2
"10998","veiled",0,0,0,2,2
"10999","venerate",1,1,0,0,2
"11000","venison",1,1,0,0,2
"11001","verdict",2,0,0,0,2
"11002","verse",0,2,0,0,2
"11003","vestige",1,0,1,0,2
"11004","vesuvius",0,0,0,2,2
"11005","vexations",1,1,0,0,2
"11006","vexatious",1,1,0,0,2
"11007","vice_",0,2,0,0,2
"11008","vicksburg",2,0,0,0,2
"11009","victor",2,0,0,0,2
"11010","vieing",1,1,0,0,2
"11011","villa",0,0,0,2,2
"11012","vine",1,1,0,0,2
"11013","vinegar",1,1,0,0,2
"11014","violin",1,1,0,0,2
"11015","virago",1,1,0,0,2
"11016","virginia’s",2,0,0,0,2
"11017","virus",1,1,0,0,2
"11018","visibly",2,0,0,0,2
"11019","vitality",0,2,0,0,2
"11020","vocabulary",0,2,0,0,2
"11021","vociferated",1,1,0,0,2
"11022","voluptuary",1,1,0,0,2
"11023","votaries",0,1,1,0,2
"11024","vultures",1,1,0,0,2
"11025","wafted",1,1,0,0,2
"11026","wageshow",2,0,0,0,2
"11027","wagoner",0,0,0,2,2
"11028","wagons",1,1,0,0,2
"11029","wail",0,2,0,0,2
"11030","wakefulness",0,1,1,0,2
"11031","waking",1,1,0,0,2
"11032","wantedmeeting",2,0,0,0,2
"11033","war’",2,0,0,0,2
"11034","warbling",1,1,0,0,2
"11035","wardrobe",1,1,0,0,2
"11036","warehouses",0,1,1,0,2
"11037","warmest",1,1,0,0,2
"11038","warrecollections",2,0,0,0,2
"11039","wars",1,1,0,0,2
"11040","wasa",2,0,0,0,2
"11041","wash",0,1,0,1,2
"11042","wasting",1,1,0,0,2
"11043","watchwords",1,0,1,0,2
"11044","way”",2,0,0,0,2
"11045","waycovey’s",2,0,0,0,2
"11046","weakening",1,0,1,0,2
"11047","weaknesses",2,0,0,0,2
"11048","wearied",1,0,1,0,2
"11049","wearisome",1,1,0,0,2
"11050","weavers",1,1,0,0,2
"11051","weaving",0,1,1,0,2
"11052","weep",1,1,0,0,2
"11053","weightier",0,0,2,0,2
"11054","weird",2,0,0,0,2
"11055","wellbeing",1,1,0,0,2
"11056","welldirected",2,0,0,0,2
"11057","wellfounded",2,0,0,0,2
"11058","westerly",1,1,0,0,2
"11059","westminster",1,1,0,0,2
"11060","weston",1,1,0,0,2
"11061","wetted",1,1,0,0,2
"11062","weymouth",1,1,0,0,2
"11063","wheels",1,1,0,0,2
"11064","wherefore",0,2,0,0,2
"11065","wherein",2,0,0,0,2
"11066","wherewith",0,2,0,0,2
"11067","whirl",0,1,1,0,2
"11068","whirled",1,1,0,0,2
"11069","whirling",0,1,0,1,2
"11070","whiskey",2,0,0,0,2
"11071","whispers",1,1,0,0,2
"11072","whistling",1,1,0,0,2
"11073","whitewash",1,1,0,0,2
"11074","whoever",2,0,0,0,2
"11075","wider",1,1,0,0,2
"11076","widest",0,0,2,0,2
"11077","widows",1,0,1,0,2
"11078","wife’s",0,1,1,0,2
"11079","wilk",0,1,1,0,2
"11080","wilkscurious",2,0,0,0,2
"11081","willed",1,1,0,0,2
"11082","williams",2,0,0,0,2
"11083","willows",1,1,0,0,2
"11084","wills",2,0,0,0,2
"11085","windowless",1,1,0,0,2
"11086","wines",1,1,0,0,2
"11087","wipe",1,0,1,0,2
"11088","withered",1,1,0,0,2
"11089","withering",1,1,0,0,2
"11090","wm",0,1,1,0,2
"11091","womanadvantage",2,0,0,0,2
"11092","won’t”",2,0,0,0,2
"11093","wooing",1,1,0,0,2
"11094","workings",2,0,0,0,2
"11095","workshops",2,0,0,0,2
"11096","worldly",1,1,0,0,2
"11097","wornout",2,0,0,0,2
"11098","worshiped",1,1,0,0,2
"11099","worshippers",0,0,0,2,2
"11100","worshipshocking",2,0,0,0,2
"11101","worsted",1,1,0,0,2
"11102","wrapt",1,1,0,0,2
"11103","wreak",1,1,0,0,2
"11104","wrecked",1,1,0,0,2
"11105","wrench",1,1,0,0,2
"11106","wrestle",1,1,0,0,2
"11107","wrestler",1,1,0,0,2
"11108","wrightson",1,1,0,0,2
"11109","writtendanger",2,0,0,0,2
"11110","xv",0,2,0,0,2
"11111","xx",0,2,0,0,2
"11112","xxii",0,2,0,0,2
"11113","xxiii",0,2,0,0,2
"11114","xxiv",0,2,0,0,2
"11115","xxv",0,2,0,0,2
"11116","yankee",0,1,0,1,2
"11117","yarddesperate",2,0,0,0,2
"11118","yarn",1,1,0,0,2
"11119","yearling",1,1,0,0,2
"11120","years’",2,0,0,0,2
"11121","yelling",1,1,0,0,2
"11122"," g",1,0,0,0,1
"11123"," la",0,0,0,1,1
"11124"," m",1,0,0,0,1
"11125"," ptly",0,0,0,1,1
"11126"," rue",0,0,0,1,1
"11127"," tuesday",0,0,0,1,1
"11128"," w",1,0,0,0,1
"11129","_a_",0,1,0,0,1
"11130","_abolition",0,0,1,0,1
"11131","_abolition_",0,0,1,0,1
"11132","_abolitionist",0,0,1,0,1
"11133","_abolitionists",0,1,0,0,1
"11134","_abroad_",0,1,0,0,1
"11135","_act_",0,1,0,0,1
"11136","_after_",0,1,0,0,1
"11137","_aggressive_",0,1,0,0,1
"11138","_alias_",0,1,0,0,1
"11139","_always",0,0,1,0,1
"11140","_and",0,1,0,0,1
"11141","_angel_",0,1,0,0,1
"11142","_answer_",0,1,0,0,1
"11143","_anti",0,1,0,0,1
"11144","_appearance_",0,1,0,0,1
"11145","_april_",0,0,1,0,1
"11146","_augustus",0,1,0,0,1
"11147","_bailey_",0,0,1,0,1
"11148","_baltimore",0,1,0,0,1
"11149","_behind_",0,1,0,0,1
"11150","_bible_",0,1,0,0,1
"11151","_bondage_",0,1,0,0,1
"11152","_born_",0,1,0,0,1
"11153","_box",0,1,0,0,1
"11154","_boy_",0,1,0,0,1
"11155","_brandy_",0,1,0,0,1
"11156","_brevard’s",0,1,0,0,1
"11157","_bribe_",0,1,0,0,1
"11158","_british",0,1,0,0,1
"11159","_brute_",0,1,0,0,1
"11160","_but",0,0,1,0,1
"11161","_by",0,1,0,0,1
"11162","_by_",0,1,0,0,1
"11163","_cannot",0,1,0,0,1
"11164","_capt",0,1,0,0,1
"11165","_caste_",0,1,0,0,1
"11166","_charles",0,0,1,0,1
"11167","_chattel_",0,1,0,0,1
"11168","_child_",0,1,0,0,1
"11169","_children_",0,1,0,0,1
"11170","_colored_",0,1,0,0,1
"11171","_could_",0,1,0,0,1
"11172","_crime_",0,1,0,0,1
"11173","_cripple",0,1,0,0,1
"11174","_daniel",0,0,1,0,1
"11175","_dare_",0,1,0,0,1
"11176","_darg_",0,0,1,0,1
"11177","_day_",0,1,0,0,1
"11178","_death",0,1,0,0,1
"11179","_demigod_",0,1,0,0,1
"11180","_denouncing_",0,1,0,0,1
"11181","_desideratum",0,1,0,0,1
"11182","_desideratum_",0,1,0,0,1
"11183","_devil_",0,1,0,0,1
"11184","_doctors",0,1,0,0,1
"11185","_does_",0,1,0,0,1
"11186","_doubtful_",0,1,0,0,1
"11187","_douglass_",0,0,1,0,1
"11188","_ell",0,0,1,0,1
"11189","_emancipate",0,1,0,0,1
"11190","_enemies_",0,1,0,0,1
"11191","_equals_",0,1,0,0,1
"11192","_esther_",0,1,0,0,1
"11193","_etiquette_",0,1,0,0,1
"11194","_even",0,1,0,0,1
"11195","_everything",0,1,0,0,1
"11196","_exceptions_",0,1,0,0,1
"11197","_fear_",0,1,0,0,1
"11198","_fetiche_",0,1,0,0,1
"11199","_fiends_",0,1,0,0,1
"11200","_fight_",0,1,0,0,1
"11201","_firstling_",0,1,0,0,1
"11202","_fixed",0,1,0,0,1
"11203","_foggable_",0,1,0,0,1
"11204","_forever_",0,1,0,0,1
"11205","_forte_",0,0,1,0,1
"11206","_free",0,1,0,0,1
"11207","_freedom’s",0,1,0,0,1
"11208","_freeman",0,1,0,0,1
"11209","_friendless_",0,1,0,0,1
"11210","_furore_",0,1,0,0,1
"11211","_future_",0,1,0,0,1
"11212","_generally_",0,1,0,0,1
"11213","_genius",0,1,0,0,1
"11214","_god_",0,1,0,0,1
"11215","_gold",0,1,0,0,1
"11216","_good",0,1,0,0,1
"11217","_gore",0,1,0,0,1
"11218","_got",0,1,0,0,1
"11219","_great",0,0,1,0,1
"11220","_greek_",0,1,0,0,1
"11221","_have",0,1,0,0,1
"11222","_he",0,1,0,0,1
"11223","_held",0,1,0,0,1
"11224","_hell_",0,1,0,0,1
"11225","_her_",0,1,0,0,1
"11226","_hickory",0,1,0,0,1
"11227","_hide_",0,0,1,0,1
"11228","_holy",0,1,0,0,1
"11229","_home_",0,1,0,0,1
"11230","_honest_",0,1,0,0,1
"11231","_honor_",0,1,0,0,1
"11232","_human_",0,1,0,0,1
"11233","_idols_",0,1,0,0,1
"11234","_ill_",0,1,0,0,1
"11235","_imparted_",0,1,0,0,1
"11236","_impossible_",0,1,0,0,1
"11237","_inch",0,0,1,0,1
"11238","_incidents_",0,1,0,0,1
"11239","_indelible_",0,1,0,0,1
"11240","_indirection_",0,1,0,0,1
"11241","_institution_",0,1,0,0,1
"11242","_intellectual_",0,1,0,0,1
"11243","_is_",0,1,0,0,1
"11244","_it",0,0,1,0,1
"11245","_it_",0,1,0,0,1
"11246","_italics_",0,1,0,0,1
"11247","_jim",0,1,0,0,1
"11248","_johnson_",0,0,1,0,1
"11249","_july_",0,1,0,0,1
"11250","_keep",0,1,0,0,1
"11251","_kept_",0,1,0,0,1
"11252","_kill_",0,1,0,0,1
"11253","_kind",0,1,0,0,1
"11254","_kindness_",0,1,0,0,1
"11255","_knew_",0,1,0,0,1
"11256","_laughed",0,1,0,0,1
"11257","_law_",0,1,0,0,1
"11258","_legal_",0,1,0,0,1
"11259","_let",0,1,0,0,1
"11260","_liberty_",0,1,0,0,1
"11261","_life_",0,1,0,0,1
"11262","_lived_",0,1,0,0,1
"11263","_london",0,1,0,0,1
"11264","_long",0,1,0,0,1
"11265","_loudly_",0,1,0,0,1
"11266","_loved_",0,1,0,0,1
"11267","_low_",0,1,0,0,1
"11268","_luck_",0,1,0,0,1
"11269","_made_",0,1,0,0,1
"11270","_make",0,1,0,0,1
"11271","_make_",0,1,0,0,1
"11272","_man",0,1,0,0,1
"11273","_mange_",0,1,0,0,1
"11274","_marriage",0,1,0,0,1
"11275","_maryland_",0,1,0,0,1
"11276","_mass",0,0,1,0,1
"11277","_master’s",0,1,0,0,1
"11278","_med",0,1,0,0,1
"11279","_melee_",0,1,0,0,1
"11280","_men",0,1,0,0,1
"11281","_mildly_",0,1,0,0,1
"11282","_mixed",0,1,0,0,1
"11283","_monday_",0,1,0,0,1
"11284","_money",0,1,0,0,1
"11285","_months",0,1,0,0,1
"11286","_more_",0,1,0,0,1
"11287","_most",0,1,0,0,1
"11288","_mostly_",0,1,0,0,1
"11289","_mother_",0,1,0,0,1
"11290","_motherless_",0,1,0,0,1
"11291","_mush_",0,0,1,0,1
"11292","_must",0,1,0,0,1
"11293","_mystery_",0,1,0,0,1
"11294","_narrate_",0,1,0,0,1
"11295","_narrative",0,0,1,0,1
"11296","_nearly_",0,1,0,0,1
"11297","_negro",0,1,0,0,1
"11298","_new_",0,1,0,0,1
"11299","_next_",0,1,0,0,1
"11300","_nibbles_",0,1,0,0,1
"11301","_nine",0,1,0,0,1
"11302","_no_",0,1,0,0,1
"11303","_non",0,1,0,0,1
"11304","_none_",0,1,0,0,1
"11305","_north_",0,1,0,0,1
"11306","_notes",0,1,0,0,1
"11307","_nothing_",0,1,0,0,1
"11308","_nowhere_",0,1,0,0,1
"11309","_o",0,1,0,0,1
"11310","_obtained",0,0,1,0,1
"11311","_on",0,1,0,0,1
"11312","_one",0,1,0,0,1
"11313","_others_",0,1,0,0,1
"11314","_our_",0,1,0,0,1
"11315","_overseer_",0,1,0,0,1
"11316","_own_",0,1,0,0,1
"11317","_par",0,1,0,0,1
"11318","_pass",0,1,0,0,1
"11319","_past_",0,1,0,0,1
"11320","_pecked_",0,0,1,0,1
"11321","_perdition_",0,1,0,0,1
"11322","_perhaps_",0,1,0,0,1
"11323","_persons_",0,1,0,0,1
"11324","_pig_",0,1,0,0,1
"11325","_pity_",0,1,0,0,1
"11326","_place_",0,1,0,0,1
"11327","_play_",0,1,0,0,1
"11328","_poorest_",0,1,0,0,1
"11329","_possible",0,1,0,0,1
"11330","_possibly_",0,1,0,0,1
"11331","_practical_",0,1,0,0,1
"11332","_practically_",0,1,0,0,1
"11333","_precisely_",0,1,0,0,1
"11334","_prejudged_",0,1,0,0,1
"11335","_present_",0,1,0,0,1
"11336","_probable_",0,1,0,0,1
"11337","_probation_",0,1,0,0,1
"11338","_put",0,1,0,0,1
"11339","_question_",0,1,0,0,1
"11340","_rage_",0,1,0,0,1
"11341","_really_",0,1,0,0,1
"11342","_received_",0,1,0,0,1
"11343","_religion_",0,1,0,0,1
"11344","_religious_",0,0,1,0,1
"11345","_removal_",0,1,0,0,1
"11346","_rencontres_",0,1,0,0,1
"11347","_reverend_",0,1,0,0,1
"11348","_righteous_",0,1,0,0,1
"11349","_rightfully_",0,1,0,0,1
"11350","_root",0,0,1,0,1
"11351","_rum_",0,1,0,0,1
"11352","_run",0,1,0,0,1
"11353","_run_",0,1,0,0,1
"11354","_sabbath_",0,1,0,0,1
"11355","_salt",0,1,0,0,1
"11356","_scheme",0,1,0,0,1
"11357","_seemed_",0,1,0,0,1
"11358","_shame_",0,1,0,0,1
"11359","_sheep_",0,0,1,0,1
"11360","_shooting",0,0,1,0,1
"11361","_silent",0,1,0,0,1
"11362","_singly_",0,1,0,0,1
"11363","_slave",0,1,0,0,1
"11364","_slaveholding",0,0,1,0,1
"11365","_slaves_",0,1,0,0,1
"11366","_so",0,1,0,0,1
"11367","_some_",0,1,0,0,1
"11368","_somebody_",0,1,0,0,1
"11369","_somebody’s_",0,1,0,0,1
"11370","_soured_",0,1,0,0,1
"11371","_speech",0,1,0,0,1
"11372","_spoil_",0,0,1,0,1
"11373","_standard",0,1,0,0,1
"11374","_starve",0,1,0,0,1
"11375","_starved",0,1,0,0,1
"11376","_still",0,1,0,0,1
"11377","_strongly_",0,1,0,0,1
"11378","_stuffed_",0,1,0,0,1
"11379","_such_",0,1,0,0,1
"11380","_sunday_",0,1,0,0,1
"11381","_tar_",0,0,1,0,1
"11382","_that",0,1,0,0,1
"11383","_that_",0,1,0,0,1
"11384","_theft_",0,1,0,0,1
"11385","_their",0,1,0,0,1
"11386","_there",0,1,0,0,1
"11387","_thing_",0,1,0,0,1
"11388","_things_",0,1,0,0,1
"11389","_thousand",0,1,0,0,1
"11390","_tie",0,1,0,0,1
"11391","_time_",0,1,0,0,1
"11392","_times_",0,1,0,0,1
"11393","_to_",0,1,0,0,1
"11394","_tomahawk_",0,1,0,0,1
"11395","_too_",0,1,0,0,1
"11396","_took_",0,1,0,0,1
"11397","_tub_",0,1,0,0,1
"11398","_tuck",0,1,0,0,1
"11399","_tuckahoe_",0,1,0,0,1
"11400","_tuition",0,1,0,0,1
"11401","_types",0,1,0,0,1
"11402","_underground",0,0,1,0,1
"11403","_understand_",0,1,0,0,1
"11404","_unsaintly_",0,1,0,0,1
"11405","_upon",0,0,1,0,1
"11406","_upperground",0,0,1,0,1
"11407","_vale",0,1,0,0,1
"11408","_voice_",0,1,0,0,1
"11409","_wailing",0,1,0,0,1
"11410","_was",0,1,0,0,1
"11411","_welcome_",0,0,1,0,1
"11412","_well",0,1,0,0,1
"11413","_where_",0,1,0,0,1
"11414","_whipped",0,1,0,0,1
"11415","_whisky",0,1,0,0,1
"11416","_will",0,1,0,0,1
"11417","_will_",0,1,0,0,1
"11418","_with",0,0,1,0,1
"11419","_woldfolk_",0,1,0,0,1
"11420","_woman_",0,1,0,0,1
"11421","_work",0,1,0,0,1
"11422","_work_",0,1,0,0,1
"11423","_worse_",0,1,0,0,1
"11424","_wrong_",0,1,0,0,1
"11425","_years",0,1,0,0,1
"11426","_you_",0,1,0,0,1
"11427","_yours_",0,1,0,0,1
"11428","’”",1,0,0,0,1
"11429","‘ask",1,0,0,0,1
"11430","‘dem",1,0,0,0,1
"11431","‘erring",1,0,0,0,1
"11432","‘fire",1,0,0,0,1
"11433","‘gone",1,0,0,0,1
"11434","‘held",1,0,0,0,1
"11435","‘hold",1,0,0,0,1
"11436","‘now",1,0,0,0,1
"11437","‘peace",1,0,0,0,1
"11438","‘repossession",1,0,0,0,1
"11439","‘sacrifice",1,0,0,0,1
"11440","‘thou",1,0,0,0,1
"11441","‘wait",1,0,0,0,1
"11442","‘white",1,0,0,0,1
"11443","“‘",1,0,0,0,1
"11444","“’ve",1,0,0,0,1
"11445","“‘washington",1,0,0,0,1
"11446","“abby",1,0,0,0,1
"11447","“abolitionists”",1,0,0,0,1
"11448","“ah",1,0,0,0,1
"11449","“allender’s",1,0,0,0,1
"11450","“allow",1,0,0,0,1
"11451","“allowances”",1,0,0,0,1
"11452","“although",1,0,0,0,1
"11453","“ambassadors”",1,0,0,0,1
"11454","“answer",1,0,0,0,1
"11455","“appeal",1,0,0,0,1
"11456","“attempted”",1,0,0,0,1
"11457","“b f",1,0,0,0,1
"11458","“back”",1,0,0,0,1
"11459","“backwoodsman",1,0,0,0,1
"11460","“bad",1,0,0,0,1
"11461","“bagged”",1,0,0,0,1
"11462","“bags”",1,0,0,0,1
"11463","“baltimore",1,0,0,0,1
"11464","“band",1,0,0,0,1
"11465","“baptize",1,0,0,0,1
"11466","“baublereputation",1,0,0,0,1
"11467","“bear",1,0,0,0,1
"11468","“beat",1,0,0,0,1
"11469","“beneficent",1,0,0,0,1
"11470","“besides",1,0,0,0,1
"11471","“besides”",1,0,0,0,1
"11472","“better",1,0,0,0,1
"11473","“bill”",1,0,0,0,1
"11474","“bind",1,0,0,0,1
"11475","“black",1,0,0,0,1
"11476","“bless",1,0,0,0,1
"11477","“blow",1,0,0,0,1
"11478","“blows",1,0,0,0,1
"11479","“bran",1,0,0,0,1
"11480","“brethren",1,0,0,0,1
"11481","“brook",1,0,0,0,1
"11482","“brother",1,0,0,0,1
"11483","“brownson’s",1,0,0,0,1
"11484","“candle",1,0,0,0,1
"11485","“captain",1,0,0,0,1
"11486","“cast",1,0,0,0,1
"11487","“certainly”",1,0,0,0,1
"11488","“chattel”",1,0,0,0,1
"11489","“clean”",1,0,0,0,1
"11490","“clear",1,0,0,0,1
"11491","“combe’s",1,0,0,0,1
"11492","“conciliation",1,0,0,0,1
"11493","“conquered",1,0,0,0,1
"11494","“contraband”",1,0,0,0,1
"11495","“contrabands”",1,0,0,0,1
"11496","“country”",1,0,0,0,1
"11497","“cousin",1,0,0,0,1
"11498","“cross",1,0,0,0,1
"11499","“custom”",1,0,0,0,1
"11500","“darby”",1,0,0,0,1
"11501","“dark",1,0,0,0,1
"11502","“democrat",1,0,0,0,1
"11503","“destroy",1,0,0,0,1
"11504","“discerned",1,0,0,0,1
"11505","“divination”",1,0,0,0,1
"11506","“divinity",1,0,0,0,1
"11507","“dn",1,0,0,0,1
"11508","“doctor",1,0,0,0,1
"11509","“done”",1,0,0,0,1
"11510","“douglas”obtaining",1,0,0,0,1
"11511","“douglass”obtaining",1,0,0,0,1
"11512","“drag",1,0,0,0,1
"11513","“draw",1,0,0,0,1
"11514","“dugout”",1,0,0,0,1
"11515","“east",1,0,0,0,1
"11516","“eastern",1,0,0,0,1
"11517","“easternshore",1,0,0,0,1
"11518","“eat",1,0,0,0,1
"11519","“emperor”",1,0,0,0,1
"11520","“employ",1,0,0,0,1
"11521","“even",1,0,0,0,1
"11522","“evening",1,0,0,0,1
"11523","“expected",1,0,0,0,1
"11524","“experience",1,0,0,0,1
"11525","“expounder”",1,0,0,0,1
"11526","“faith",1,0,0,0,1
"11527","“fan”",1,0,0,0,1
"11528","“father",1,0,0,0,1
"11529","“fault",1,0,0,0,1
"11530","“feddy”",1,0,0,0,1
"11531","“fellows",1,0,0,0,1
"11532","“fervently",1,0,0,0,1
"11533","“field",1,0,0,0,1
"11534","“fip’s”",1,0,0,0,1
"11535","“fipennybit”",1,0,0,0,1
"11536","“fisherman’s",1,0,0,0,1
"11537","“flatboatman”",1,0,0,0,1
"11538","“flowery",1,0,0,0,1
"11539","“fondly",1,0,0,0,1
"11540","“fought",1,0,0,0,1
"11541","“freddy",1,0,0,0,1
"11542","“frederick”",1,0,0,0,1
"11543","“free”free",1,0,0,0,1
"11544","“friends”",1,0,0,0,1
"11545","“gag",1,0,0,0,1
"11546","“gates",1,0,0,0,1
"11547","“gee”",1,0,0,0,1
"11548","“genteel",1,0,0,0,1
"11549","“gentlemen",1,0,0,0,1
"11550","“georgia",1,0,0,0,1
"11551","“get",1,0,0,0,1
"11552","“golconda”",1,0,0,0,1
"11553","“got",1,0,0,0,1
"11554","“governor",1,0,0,0,1
"11555","“graduate",1,0,0,0,1
"11556","“hair",1,0,0,0,1
"11557","“halfness”",1,0,0,0,1
"11558","“halloo",1,0,0,0,1
"11559","“hand”",1,0,0,0,1
"11560","“hard",1,0,0,0,1
"11561","“hear",1,0,0,0,1
"11562","“hence",1,0,0,0,1
"11563","“hereditary",1,0,0,0,1
"11564","“hide”",1,0,0,0,1
"11565","“history",1,0,0,0,1
"11566","“hither”",1,0,0,0,1
"11567","“honorable”",1,0,0,0,1
"11568","“howbeit",1,0,0,0,1
"11569","“however",1,0,0,0,1
"11570","“hullo",1,0,0,0,1
"11571","“ike”",1,0,0,0,1
"11572","”implying",1,0,0,0,1
"11573","“important",1,0,0,0,1
"11574","“indeed",1,0,0,0,1
"11575","“indelicacy",1,0,0,0,1
"11576","“indian",1,0,0,0,1
"11577","“inhuman",1,0,0,0,1
"11578","“introduce",1,0,0,0,1
"11579","“intruder”",1,0,0,0,1
"11580","“jake”",1,0,0,0,1
"11581","“java”",1,0,0,0,1
"11582","“jerry",1,0,0,0,1
"11583","“jim",1,0,0,0,1
"11584","“juba”",1,0,0,0,1
"11585","“jubilee",1,0,0,0,1
"11586","“kin",1,0,0,0,1
"11587","“kin”d",1,0,0,0,1
"11588","“kind",1,0,0,0,1
"11589","“know",1,0,0,0,1
"11590","“knowledge",1,0,0,0,1
"11591","“l ”",1,0,0,0,1
"11592","“l f”",1,0,0,0,1
"11593","“l”",1,0,0,0,1
"11594","“lay",1,0,0,0,1
"11595","“letter",1,0,0,0,1
"11596","“liberty”",1,0,0,0,1
"11597","“line”",1,0,0,0,1
"11598","“live”",1,0,0,0,1
"11599","“look",1,0,0,0,1
"11600","“look”",1,0,0,0,1
"11601","“lord",1,0,0,0,1
"11602","“major",1,0,0,0,1
"11603","“mas’",1,0,0,0,1
"11604","“massachusetts",1,0,0,0,1
"11605","“master",1,0,0,0,1
"11606","“meant",1,0,0,0,1
"11607","“men",1,0,0,0,1
"11608","“might",1,0,0,0,1
"11609","“milk",1,0,0,0,1
"11610","“mining",1,0,0,0,1
"11611","“morning",1,0,0,0,1
"11612","“moses",1,0,0,0,1
"11613","“mother",1,0,0,0,1
"11614","“mrs",1,0,0,0,1
"11615","“nature",1,0,0,0,1
"11616","“necessity”",1,0,0,0,1
"11617","“ned",1,0,0,0,1
"11618","“negroes",1,0,0,0,1
"11619","“nep”",1,0,0,0,1
"11620","“never",1,0,0,0,1
"11621","“nevertheless”",1,0,0,0,1
"11622","“none",1,0,0,0,1
"11623","“nonsense”",1,0,0,0,1
"11624","“north",1,0,0,0,1
"11625","“notice",1,0,0,0,1
"11626","“notwithstanding”",1,0,0,0,1
"11627","“o",1,0,0,0,1
"11628","“offense",1,0,0,0,1
"11629","“often",1,0,0,0,1
"11630","“ossawatamie",1,0,0,0,1
"11631","“othello’s",1,0,0,0,1
"11632","“paddy”",1,0,0,0,1
"11633","“pastoral",1,0,0,0,1
"11634","“patched",1,0,0,0,1
"11635","“people",1,0,0,0,1
"11636","“plainly",1,0,0,0,1
"11637","“poor",1,0,0,0,1
"11638","“poppie",1,0,0,0,1
"11639","“potpie”",1,0,0,0,1
"11640","“preachers’",1,0,0,0,1
"11641","“president”",1,0,0,0,1
"11642","“prichard’s",1,0,0,0,1
"11643","“principalities",1,0,0,0,1
"11644","“purple",1,0,0,0,1
"11645","“put",1,0,0,0,1
"11646","“putting",1,0,0,0,1
"11647","“question",1,0,0,0,1
"11648","“quick",1,0,0,0,1
"11649","“railsplitter”",1,0,0,0,1
"11650","“rather",1,0,0,0,1
"11651","“remember",1,0,0,0,1
"11652","“repeal”",1,0,0,0,1
"11653","“repose”",1,0,0,0,1
"11654","“republics",1,0,0,0,1
"11655","“revolution”",1,0,0,0,1
"11656","“rig”",1,0,0,0,1
"11657","“right",1,0,0,0,1
"11658","“root",1,0,0,0,1
"11659","“rough",1,0,0,0,1
"11660","“rule",1,0,0,0,1
"11661","“s ”",1,0,0,0,1
"11662","“s f”",1,0,0,0,1
"11663","“s”",1,0,0,0,1
"11664","“sanctuary”",1,0,0,0,1
"11665","“sandy",1,0,0,0,1
"11666","“sandy”",1,0,0,0,1
"11667","“saw”",1,0,0,0,1
"11668","“scholar",1,0,0,0,1
"11669","“sea",1,0,0,0,1
"11670","“sealed",1,0,0,0,1
"11671","“search",1,0,0,0,1
"11672","“sears",1,0,0,0,1
"11673","“served",1,0,0,0,1
"11674","“set",1,0,0,0,1
"11675","“shame",1,0,0,0,1
"11676","“shields",1,0,0,0,1
"11677","“shoot",1,0,0,0,1
"11678","“shot",1,0,0,0,1
"11679","“show",1,0,0,0,1
"11680","“signed",1,0,0,0,1
"11681","“signing",1,0,0,0,1
"11682","“since",1,0,0,0,1
"11683","“since”",1,0,0,0,1
"11684","“siryou",1,0,0,0,1
"11685","“sit",1,0,0,0,1
"11686","“slave",1,0,0,0,1
"11687","“slaveholders”",1,0,0,0,1
"11688","“solid",1,0,0,0,1
"11689","“something",1,0,0,0,1
"11690","“sound",1,0,0,0,1
"11691","“squatter”",1,0,0,0,1
"11692","“stalwart",1,0,0,0,1
"11693","“stars",1,0,0,0,1
"11694","“stars”",1,0,0,0,1
"11695","“stone",1,0,0,0,1
"11696","“stuff”",1,0,0,0,1
"11697","“support",1,0,0,0,1
"11698","“suppose",1,0,0,0,1
"11699","“swap",1,0,0,0,1
"11700","“swash”",1,0,0,0,1
"11701","“taken",1,0,0,0,1
"11702","“taking",1,0,0,0,1
"11703","“tennessee”",1,0,0,0,1
"11704","“terminate",1,0,0,0,1
"11705","“thing”",1,0,0,0,1
"11706","“thirdrate",1,0,0,0,1
"11707","“throw",1,0,0,0,1
"11708","“thus",1,0,0,0,1
"11709","“tide”",1,0,0,0,1
"11710","“took",1,0,0,0,1
"11711","“toted”",1,0,0,0,1
"11712","“toteing”",1,0,0,0,1
"11713","“touch",1,0,0,0,1
"11714","“treadingyard”",1,0,0,0,1
"11715","“trifles",1,0,0,0,1
"11716","“triple",1,0,0,0,1
"11717","“trust",1,0,0,0,1
"11718","“turning",1,0,0,0,1
"11719","“uncles”",1,0,0,0,1
"11720","“uncover",1,0,0,0,1
"11721","“underground",1,0,0,0,1
"11722","“underground”",1,0,0,0,1
"11723","“unknown",1,0,0,0,1
"11724","“unprofitable",1,0,0,0,1
"11725","“virtuous",1,0,0,0,1
"11726","“ward",1,0,0,0,1
"11727","“whoa”",1,0,0,0,1
"11728","“whole",1,0,0,0,1
"11729","“will",1,0,0,0,1
"11730","“william",1,0,0,0,1
"11731","“willing",1,0,0,0,1
"11732","“wished",1,0,0,0,1
"11733","“wolf”",1,0,0,0,1
"11734","“won’t",1,0,0,0,1
"11735","“word”",1,0,0,0,1
"11736","“worth",1,0,0,0,1
"11737","“worthy",1,0,0,0,1
"11738","“yes”",1,0,0,0,1
"11739","11th",0,0,1,0,1
"11740","148",0,1,0,0,1
"11741","17",0,0,1,0,1
"11742","1776",0,0,1,0,1
"11743","1818",0,0,1,0,1
"11744","1827",0,1,0,0,1
"11745","1837",0,1,0,0,1
"11746","1842",0,1,0,0,1
"11747","1847",0,1,0,0,1
"11748","1853",0,1,0,0,1
"11749","1881",0,0,1,0,1
"11750","1895",0,0,1,0,1
"11751","1929",0,0,1,0,1
"11752","1992",0,0,1,0,1
"11753","20",0,0,1,0,1
"11754","22",0,0,1,0,1
"11755","224",0,1,0,0,1
"11756","25",0,0,1,0,1
"11757","28",0,0,1,0,1
"11758","2d",0,1,0,0,1
"11759","31",0,0,1,0,1
"11760","317",0,1,0,0,1
"11761","339",0,1,0,0,1
"11762","3d",0,1,0,0,1
"11763","46",0,1,0,0,1
"11764","4th",0,1,0,0,1
"11765","52",0,1,0,0,1
"11766","54",0,1,0,0,1
"11767","54th",0,0,1,0,1
"11768","55th",0,0,1,0,1
"11769","56",0,1,0,0,1
"11770","5th",0,1,0,0,1
"11771","9th",0,1,0,0,1
"11772","a_",0,1,0,0,1
"11773","abating",1,0,0,0,1
"11774","abbreviated",1,0,0,0,1
"11775","abbreviation",1,0,0,0,1
"11776","abe",1,0,0,0,1
"11777","abel’s",1,0,0,0,1
"11778","abetting",1,0,0,0,1
"11779","abettors",0,0,1,0,1
"11780","abhorence",1,0,0,0,1
"11781","abjectly",1,0,0,0,1
"11782","able’s",0,1,0,0,1
"11783","ableas",1,0,0,0,1
"11784","ablebodied",1,0,0,0,1
"11785","abler",0,1,0,0,1
"11786","ablution",0,1,0,0,1
"11787","aboard",0,1,0,0,1
"11788","abodes",0,1,0,0,1
"11789","abolishing”",1,0,0,0,1
"11790","abolitionistbranded",1,0,0,0,1
"11791","abolitionists”",1,0,0,0,1
"11792","abolitioniststhe",1,0,0,0,1
"11793","abolitionize",1,0,0,0,1
"11794","abolitionst",0,1,0,0,1
"11795","abolitionwhatever",1,0,0,0,1
"11796","abomination",1,0,0,0,1
"11797","abone",0,0,0,1,1
"11798","abounded",0,0,1,0,1
"11799","abounds",0,0,0,1,1
"11800","abram",1,0,0,0,1
"11801","abreast",1,0,0,0,1
"11802","abroada",1,0,0,0,1
"11803","abruptly",0,0,0,1,1
"11804","absenting",0,1,0,0,1
"11805","abstract",0,1,0,0,1
"11806","absurdity",1,0,0,0,1
"11807","absurdly",1,0,0,0,1
"11808","acceded",1,0,0,0,1
"11809","accelerated",0,1,0,0,1
"11810","accent",1,0,0,0,1
"11811","accents",1,0,0,0,1
"11812","acclimation",0,1,0,0,1
"11813","accomdation",0,0,0,1,1
"11814","accommodate",0,1,0,0,1
"11815","accommodating",0,1,0,0,1
"11816","accomodation",0,0,0,1,1
"11817","accomplice",1,0,0,0,1
"11818","accomplishedthe",1,0,0,0,1
"11819","accomplishes",0,1,0,0,1
"11820","accomplishmentthe",1,0,0,0,1
"11821","accorded",1,0,0,0,1
"11822","accords",0,1,0,0,1
"11823","accoustic",0,0,0,1,1
"11824","accredited",1,0,0,0,1
"11825","accrue",1,0,0,0,1
"11826","accumulate",1,0,0,0,1
"11827","accuse",0,1,0,0,1
"11828","accusing",0,1,0,0,1
"11829","achieved",1,0,0,0,1
"11830","acknowledging",1,0,0,0,1
"11831","acknowledgment",0,1,0,0,1
"11832","acknowledgments",1,0,0,0,1
"11833","acorss",0,0,0,1,1
"11834","acquiring",1,0,0,0,1
"11835","acre",1,0,0,0,1
"11836","acropolis",0,0,0,1,1
"11837","actan",1,0,0,0,1
"11838","actively",1,0,0,0,1
"11839","acumen",0,1,0,0,1
"11840","acutely",0,1,0,0,1
"11841","ada",0,0,0,1,1
"11842","adam",1,0,0,0,1
"11843","adaptation",1,0,0,0,1
"11844","addicted",0,0,1,0,1
"11845","adduce",1,0,0,0,1
"11846","adelphic",0,0,0,1,1
"11847","adeptness",1,0,0,0,1
"11848","adequately",0,1,0,0,1
"11849","adherents",0,1,0,0,1
"11850","adhesion",1,0,0,0,1
"11851","adirondacks",1,0,0,0,1
"11852","adjourned",1,0,0,0,1
"11853","adjudge",1,0,0,0,1
"11854","adjusted",0,1,0,0,1
"11855","adjustment",1,0,0,0,1
"11856","administering",0,1,0,0,1
"11857","admire",0,1,0,0,1
"11858","admirers",1,0,0,0,1
"11859","admits",0,1,0,0,1
"11860","admonition",0,1,0,0,1
"11861","admonitions",0,1,0,0,1
"11862","adore",0,0,0,1,1
"11863","adorning",0,1,0,0,1
"11864","adorns",1,0,0,0,1
"11865","adult",0,1,0,0,1
"11866","adulterer",0,0,1,0,1
"11867","advance_",0,1,0,0,1
"11868","advantges",0,1,0,0,1
"11869","advent",0,1,0,0,1
"11870","adventurera",1,0,0,0,1
"11871","adversely",1,0,0,0,1
"11872","advertisement",0,1,0,0,1
"11873","advertising",0,1,0,0,1
"11874","advise",1,0,0,0,1
"11875","advisers",1,0,0,0,1
"11876","advising",0,1,0,0,1
"11877","advisor",0,1,0,0,1
"11878","advocating",1,0,0,0,1
"11879","ætna",1,0,0,0,1
"11880","affable",1,0,0,0,1
"11881","affectation",1,0,0,0,1
"11882","affidavits",1,0,0,0,1
"11883","affirmative",0,1,0,0,1
"11884","affirmatively",0,1,0,0,1
"11885","afflict",1,0,0,0,1
"11886","affliction",0,1,0,0,1
"11887","affright",1,0,0,0,1
"11888","affrighted",0,1,0,0,1
"11889","affront",1,0,0,0,1
"11890","afloat",0,0,0,1,1
"11891","aforethought",0,1,0,0,1
"11892","africanize",1,0,0,0,1
"11893","africans",1,0,0,0,1
"11894","africans”",1,0,0,0,1
"11895","afternoons",0,0,1,0,1
"11896","againa",1,0,0,0,1
"11897","againscheme",1,0,0,0,1
"11898","ageto",1,0,0,0,1
"11899","aggo",0,0,0,1,1
"11900","aggrandizement",1,0,0,0,1
"11901","aggravated",0,0,1,0,1
"11902","aggravations",0,0,1,0,1
"11903","agitating",0,0,1,0,1
"11904","agitator",1,0,0,0,1
"11905","agitators",1,0,0,0,1
"11906","agreeing",0,0,0,1,1
"11907","agricultural",0,1,0,0,1
"11908","agriculture",1,0,0,0,1
"11909","air”",1,0,0,0,1
"11910","airy",0,1,0,0,1
"11911","alabamafrom",1,0,0,0,1
"11912","alabamas",1,0,0,0,1
"11913","alarmcry",1,0,0,0,1
"11914","aldridge",0,1,0,0,1
"11915","alex",0,0,0,1,1
"11916","alexandria",0,0,0,1,1
"11917","alfestume",0,0,0,1,1
"11918","ali",0,1,0,0,1
"11919","alias",1,0,0,0,1
"11920","allan",1,0,0,0,1
"11921","allay",1,0,0,0,1
"11922","allayed",1,0,0,0,1
"11923","allcontrolling",1,0,0,0,1
"11924","alleghanies",1,0,0,0,1
"11925","allen",0,0,0,1,1
"11926","allender’s",0,1,0,0,1
"11927","alliceana",1,0,0,0,1
"11928","alliessetting",1,0,0,0,1
"11929","allotments",0,1,0,0,1
"11930","allowable",1,0,0,0,1
"11931","allowanced",0,0,1,0,1
"11932","alloy",1,0,0,0,1
"11933","allsufficient",1,0,0,0,1
"11934","allsufficing",1,0,0,0,1
"11935","allude",0,1,0,0,1
"11936","allured",0,1,0,0,1
"11937","aloft",0,1,0,0,1
"11938","alongjargon",1,0,0,0,1
"11939","aloof",0,1,0,0,1
"11940","alpheus",1,0,0,0,1
"11941","alphonso",1,0,0,0,1
"11942","alps",0,0,0,1,1
"11943","altantic",0,0,0,1,1
"11944","alter",1,0,0,0,1
"11945","altering",1,0,0,0,1
"11946","alternatives",1,0,0,0,1
"11947","alters",0,0,0,1,1
"11948","altogether’",1,0,0,0,1
"11949","altogether”",1,0,0,0,1
"11950","alvin",1,0,0,0,1
"11951","amanda”",1,0,0,0,1
"11952","amaze",1,0,0,0,1
"11953","ambassadors",0,1,0,0,1
"11954","ambiguous",0,1,0,0,1
"11955","amelioration",1,0,0,0,1
"11956","amend",1,0,0,0,1
"11957","ameriacn",0,1,0,0,1
"11958","america_",0,1,0,0,1
"11959","america’s",1,0,0,0,1
"11960","american_",0,1,0,0,1
"11961","american”gave",1,0,0,0,1
"11962","americas",1,0,0,0,1
"11963","americathe",1,0,0,0,1
"11964","ammonite",0,1,0,0,1
"11965","amorancy",1,0,0,0,1
"11966","amos",1,0,0,0,1
"11967","amphetheatre ",0,0,0,1,1
"11968","amplify",0,1,0,0,1
"11969","amputation",1,0,0,0,1
"11970","amused",0,1,0,0,1
"11971","amusements",1,0,0,0,1
"11972","anachronisms",1,0,0,0,1
"11973","analogous",1,0,0,0,1
"11974","analogy",0,1,0,0,1
"11975","analysis",0,1,0,0,1
"11976","ancestor",0,1,0,0,1
"11977","ancestors",1,0,0,0,1
"11978","andersonville",1,0,0,0,1
"11979","andre",0,0,0,1,1
"11980","anecdote",0,0,1,0,1
"11981","angelic",0,0,1,0,1
"11982","angelo",0,0,0,1,1
"11983","animosity",1,0,0,0,1
"11984","anise",0,0,1,0,1
"11985","ankles",1,0,0,0,1
"11986","annerversary",0,0,0,1,1
"11987","annie",1,0,0,0,1
"11988","annoucement",0,0,0,1,1
"11989","annoying",0,1,0,0,1
"11990","annual",1,0,0,0,1
"11991","annum",0,1,0,0,1
"11992","anomalous",0,0,1,0,1
"11993","another’s",0,1,0,0,1
"11994","ant’ney",0,1,0,0,1
"11995","antagonism",1,0,0,0,1
"11996","antagonized",1,0,0,0,1
"11997","antebellum",1,0,0,0,1
"11998","anterior",0,1,0,0,1
"11999","anthonywho",1,0,0,0,1
"12000","anticipating",1,0,0,0,1
"12001","anticoercion",1,0,0,0,1
"12002","antidraft",1,0,0,0,1
"12003","antinegro",1,0,0,0,1
"12004","antiquity",0,0,0,1,1
"12005","antoinette",1,0,0,0,1
"12006","anxietynew",1,0,0,0,1
"12007","anybodynow",1,0,0,0,1
"12008","anyone",0,0,0,1,1
"12009","anything”",1,0,0,0,1
"12010","apathy",1,0,0,0,1
"12011","aphorism",0,1,0,0,1
"12012","aplin",1,0,0,0,1
"12013","apologized",1,0,0,0,1
"12014","apologizing",0,0,1,0,1
"12015","apostle",0,0,0,1,1
"12016","apostles”",1,0,0,0,1
"12017","apostrophizing",0,0,1,0,1
"12018","appease",1,0,0,0,1
"12019","append",0,0,1,0,1
"12020","apperences",0,0,0,1,1
"12021","appertained",1,0,0,0,1
"12022","applauding",1,0,0,0,1
"12023","apples",1,0,0,0,1
"12024","applicants",0,1,0,0,1
"12025","applies",0,0,1,0,1
"12026","applins",1,0,0,0,1
"12027","appomattox",1,0,0,0,1
"12028","apportionment",1,0,0,0,1
"12029","appraised",0,1,0,0,1
"12030","appreciable",0,1,0,0,1
"12031","apprehending",1,0,0,0,1
"12032","apprised",0,1,0,0,1
"12033","appropriate”",1,0,0,0,1
"12034","approving",1,0,0,0,1
"12035","april_",0,0,1,0,1
"12036","apron",0,1,0,0,1
"12037","aqq",0,0,0,1,1
"12038","arab",0,0,0,1,1
"12039","arabec",0,0,0,1,1
"12040","arabia",0,1,0,0,1
"12041","arabic",0,0,1,0,1
"12042","arangement",1,0,0,0,1
"12043","arbiter",1,0,0,0,1
"12044","arcades",0,0,0,1,1
"12045","archaeologist",1,0,0,0,1
"12046","architect",1,0,0,0,1
"12047","areapoges",0,0,0,1,1
"12048","arena",1,0,0,0,1
"12049","aretations",0,0,0,1,1
"12050","argumentation",0,1,0,0,1
"12051","arh",0,0,0,1,1
"12052","arida",0,1,0,0,1
"12053","aristocratically",1,0,0,0,1
"12054","ark",0,0,1,0,1
"12055","armless",1,0,0,0,1
"12056","arno",0,0,0,1,1
"12057","arnold",1,0,0,0,1
"12058","arnolds",1,0,0,0,1
"12059","aroudessmont",0,0,0,1,1
"12060","arouse",1,0,0,0,1
"12061","arrange",1,0,0,0,1
"12062","arranging",0,1,0,0,1
"12063","arrest“perhaps",1,0,0,0,1
"12064","arrive",1,0,0,0,1
"12065","arrogance",1,0,0,0,1
"12066","arrogant",0,1,0,0,1
"12067","arrogt",0,0,0,1,1
"12068","arsenic",1,0,0,0,1
"12069","arther",0,0,0,1,1
"12070","artificers",0,0,0,1,1
"12071","artificies",0,0,0,1,1
"12072","artless",1,0,0,0,1
"12073","arts”",1,0,0,0,1
"12074","ascendancy",1,0,0,0,1
"12075","ascendency",1,0,0,0,1
"12076","ascent",0,0,0,1,1
"12077","ashore”",1,0,0,0,1
"12078","aspiration",1,0,0,0,1
"12079","aspired",0,1,0,0,1
"12080","aspiring",1,0,0,0,1
"12081","assailing",1,0,0,0,1
"12082","assalts",0,1,0,0,1
"12083","assassinated",1,0,0,0,1
"12084","assassinationcondolence",1,0,0,0,1
"12085","assasssination",0,0,0,1,1
"12086","assistants",1,0,0,0,1
"12087","associationsslaveholder’s",1,0,0,0,1
"12088","assumptions",0,1,0,0,1
"12089","astonised",0,0,0,1,1
"12090","astonish",0,0,1,0,1
"12091","astounding”",1,0,0,0,1
"12092","astute",1,0,0,0,1
"12093","at_",0,1,0,0,1
"12094","ate",0,0,1,0,1
"12095","athenians",0,0,0,1,1
"12096","athens",0,0,0,1,1
"12097","atonement",0,1,0,0,1
"12098","attaching",0,0,1,0,1
"12099","attackaccosted",1,0,0,0,1
"12100","attackarrested",1,0,0,0,1
"12101","attainment",0,1,0,0,1
"12102","attend”",1,0,0,0,1
"12103","attent",1,0,0,0,1
"12104","attention_",0,1,0,0,1
"12105","attentive",0,0,1,0,1
"12106","attesting",0,0,0,1,1
"12107","attica",0,0,0,1,1
"12108","attorney",1,0,0,0,1
"12109","attracting",0,1,0,0,1
"12110","attracts",0,0,0,1,1
"12111","auctionblock",1,0,0,0,1
"12112","audiencegreat",1,0,0,0,1
"12113","audiencein",1,0,0,0,1
"12114","aught”",1,0,0,0,1
"12115","augmented",0,0,1,0,1
"12116","auld_",0,1,0,0,1
"12117","auld”",1,0,0,0,1
"12118","aulds",0,1,0,0,1
"12119","auldtheir",1,0,0,0,1
"12120","aunties",1,0,0,0,1
"12121","auspicious",1,0,0,0,1
"12122","authentic",0,0,1,0,1
"12123","authorhans",1,0,0,0,1
"12124","authorimproved",1,0,0,0,1
"12125","autobiographical",0,0,1,0,1
"12126","autobiographies",0,1,0,0,1
"12127","avalanche",1,0,0,0,1
"12128","avalanches",0,0,0,1,1
"12129","ave",1,0,0,0,1
"12130","avenged",0,0,1,0,1
"12131","avenging",0,1,0,0,1
"12132","averted",1,0,0,0,1
"12133","avery",1,0,0,0,1
"12134","avignon ",0,0,0,1,1
"12135","avocations",1,0,0,0,1
"12136","avow",0,1,0,0,1
"12137","avowals",0,1,0,0,1
"12138","awakenedlarge",1,0,0,0,1
"12139","awaya",1,0,0,0,1
"12140","awed",0,0,0,1,1
"12141","aweinspire",1,0,0,0,1
"12142","awestruck",1,0,0,0,1
"12143","awoke",0,1,0,0,1
"12144","axle",0,1,0,0,1
"12145","axletree",1,0,0,0,1
"12146","ay",0,0,1,0,1
"12147","b j",1,0,0,0,1
"12148","b’leve",1,0,0,0,1
"12149","baa",0,0,1,0,1
"12150","babe ",0,0,0,1,1
"12151","babes",0,0,1,0,1
"12152","babylon",0,1,0,0,1
"12153","bachule",0,0,0,1,1
"12154","back_",0,1,0,0,1
"12155","backwoodsman",1,0,0,0,1
"12156","backyards",1,0,0,0,1
"12157","bahabiyeh",0,0,0,1,1
"12158","bail",1,0,0,0,1
"12159","bailey_",0,1,0,0,1
"12160","baileyor",1,0,0,0,1
"12161","bailiffs",1,0,0,0,1
"12162","baims",0,0,0,1,1
"12163","balancing",1,0,0,0,1
"12164","bales",1,0,0,0,1
"12165","balitmore",0,1,0,0,1
"12166","ball’s",1,0,0,0,1
"12167","balloon",0,1,0,0,1
"12168","ballotboxes",1,0,0,0,1
"12169","ballots",1,0,0,0,1
"12170","ballplaying",1,0,0,0,1
"12171","baltimore”",1,0,0,0,1
"12172","baltimorejoy",1,0,0,0,1
"12173","balustrades",0,1,0,0,1
"12174","ban",1,0,0,0,1
"12175","bandaged",1,0,0,0,1
"12176","banded",1,0,0,0,1
"12177","bang",0,1,0,0,1
"12178","baniau",0,0,0,1,1
"12179","bank”",1,0,0,0,1
"12180","bankbill",0,1,0,0,1
"12181","banker",1,0,0,0,1
"12182","bankers",1,0,0,0,1
"12183","banking",1,0,0,0,1
"12184","banner_",0,1,0,0,1
"12185","baptistry",0,0,0,1,1
"12186","baptists",1,0,0,0,1
"12187","baptize",1,0,0,0,1
"12188","barbeoeina",0,0,0,1,1
"12189","barber",1,0,0,0,1
"12190","barber’s",1,0,0,0,1
"12191","barbers",1,0,0,0,1
"12192","barclay",1,0,0,0,1
"12193","barelegged",0,0,0,1,1
"12194","barenecked",1,0,0,0,1
"12195","barkeeper",1,0,0,0,1
"12196","barnburners",1,0,0,0,1
"12197","barneyfather",1,0,0,0,1
"12198","baromitre",0,0,0,1,1
"12199","barred",1,0,0,0,1
"12200","barrenness",0,1,0,0,1
"12201","barricades",1,0,0,0,1
"12202","barriers",1,0,0,0,1
"12203","barrister",1,0,0,0,1
"12204","bashan",0,0,1,0,1
"12205","basin",0,1,0,0,1
"12206","bassett”",1,0,0,0,1
"12207","bast",0,0,0,1,1
"12208","batavia",1,0,0,0,1
"12209","bath",0,0,0,1,1
"12210","bats",1,0,0,0,1
"12211","batteries",1,0,0,0,1
"12212","battering",1,0,0,0,1
"12213","battleground",1,0,0,0,1
"12214","battling",1,0,0,0,1
"12215","bayanet",0,0,0,1,1
"12216","bayside",1,0,0,0,1
"12217","bazar",0,0,0,1,1
"12218","bazars",0,0,0,1,1
"12219","beacham",1,0,0,0,1
"12220","beaconsfield",1,0,0,0,1
"12221","beaman",1,0,0,0,1
"12222","beanstalk",1,0,0,0,1
"12223","beard",1,0,0,0,1
"12224","bearings",1,0,0,0,1
"12225","bearth",0,0,0,1,1
"12226","beastlike",1,0,0,0,1
"12227","beating_",0,1,0,0,1
"12228","beats",0,1,0,0,1
"12229","beautefuely",0,0,0,1,1
"12230","beauteful",0,0,0,1,1
"12231","beautefully",0,0,0,1,1
"12232","beautifful",0,0,0,1,1
"12233","beauvan",0,0,0,1,1
"12234","beckoned",0,1,0,0,1
"12235","bedchambers",1,0,0,0,1
"12236","bedford”",1,0,0,0,1
"12237","bedforda",1,0,0,0,1
"12238","bedroom",1,0,0,0,1
"12239","bedsteadup",1,0,0,0,1
"12240","bee",1,0,0,0,1
"12241","bees",1,0,0,0,1
"12242","befitting",1,0,0,0,1
"12243","befriended",0,1,0,0,1
"12244","beggar",0,1,0,0,1
"12245","beginnings",1,0,0,0,1
"12246","begrimed",1,0,0,0,1
"12247","begs",1,0,0,0,1
"12248","behaves",0,0,0,1,1
"12249","behaving",0,0,1,0,1
"12250","behest",1,0,0,0,1
"12251","beholder",1,0,0,0,1
"12252","beholders",0,1,0,0,1
"12253","beholding",0,1,0,0,1
"12254","beholds",1,0,0,0,1
"12255","believe”",1,0,0,0,1
"12256","believers",1,0,0,0,1
"12257","believes",1,0,0,0,1
"12258","beliive",0,0,0,1,1
"12259","belittle",1,0,0,0,1
"12260","beman",1,0,0,0,1
"12261","benches",1,0,0,0,1
"12262","benediction",0,1,0,0,1
"12263","benefited",1,0,0,0,1
"12264","beni",0,0,0,1,1
"12265","benignantly",1,0,0,0,1
"12266","benignity",0,1,0,0,1
"12267","benton",0,1,0,0,1
"12268","bequeathed",0,1,0,0,1
"12269","bermingham",0,0,0,1,1
"12270","berths",1,0,0,0,1
"12271","besedes",0,0,0,1,1
"12272","beseechingly",0,1,0,0,1
"12273","besieged",1,0,0,0,1
"12274","best_",0,1,0,0,1
"12275","bestir",0,1,0,0,1
"12276","bests",0,1,0,0,1
"12277","betake",0,1,0,0,1
"12278","bethlehem",0,0,0,1,1
"12279","betides",0,0,1,0,1
"12280","betokened",0,0,1,0,1
"12281","betokening",0,0,1,0,1
"12282","betrayed_",0,1,0,0,1
"12283","betrayed”",1,0,0,0,1
"12284","betsy",0,0,1,0,1
"12285","better’",1,0,0,0,1
"12286","bewilderment",1,0,0,0,1
"12287","beyond_",0,1,0,0,1
"12288","beyond”",1,0,0,0,1
"12289","biased",0,0,0,1,1
"12290","biblotye",0,0,0,1,1
"12291","bidder",0,1,0,0,1
"12292","biddulph",0,0,0,1,1
"12293","bide",1,0,0,0,1
"12294","bigotry",1,0,0,0,1
"12295","billows",0,0,0,1,1
"12296","billy”",1,0,0,0,1
"12297","biography",0,1,0,0,1
"12298","birmingham",1,0,0,0,1
"12299","birney",1,0,0,0,1
"12300","birthplace",0,0,1,0,1
"12301","births",0,1,0,0,1
"12302","biscuit”",1,0,0,0,1
"12303","bites",0,1,0,0,1
"12304","biyolow",0,0,0,1,1
"12305","blacked",1,0,0,0,1
"12306","blacking",1,0,0,0,1
"12307","blacknecked",1,0,0,0,1
"12308","blackness",0,0,1,0,1
"12309","blacks_",0,1,0,0,1
"12310","blacksmithing",0,0,1,0,1
"12311","blade",0,0,0,1,1
"12312","blaine",1,0,0,0,1
"12313","blamed",0,1,0,0,1
"12314","blameworthy",1,0,0,0,1
"12315","bland",1,0,0,0,1
"12316","blankets",0,0,1,0,1
"12317","blasphemous",0,1,0,0,1
"12318","blasting",0,1,0,0,1
"12319","blazing",1,0,0,0,1
"12320","bleak",1,0,0,0,1
"12321","bleat",0,0,1,0,1
"12322","blemish",1,0,0,0,1
"12323","blessedness",0,0,1,0,1
"12324","blinding",0,1,0,0,1
"12325","bliss",0,1,0,0,1
"12326","blisters",0,1,0,0,1
"12327","bloated",0,1,0,0,1
"12328","blocks",0,0,0,1,1
"12329","bloodchilling",1,0,0,0,1
"12330","bloodcovered",1,0,0,0,1
"12331","bloodhound",0,0,1,0,1
"12332","bloodhounds",1,0,0,0,1
"12333","bloodiest",0,0,1,0,1
"12334","bloodmoney",1,0,0,0,1
"12335","bloss",1,0,0,0,1
"12336","blot",0,1,0,0,1
"12337","blotches",0,1,0,0,1
"12338","blow’",1,0,0,0,1
"12339","bluff",1,0,0,0,1
"12340","bluish",1,0,0,0,1
"12341","blunders",0,1,0,0,1
"12342","blunts",0,1,0,0,1
"12343","blush",1,0,0,0,1
"12344","blushed",0,1,0,0,1
"12345","bluster",1,0,0,0,1
"12346","board”",1,0,0,0,1
"12347","boarded",0,0,0,1,1
"12348","boardinghouse",1,0,0,0,1
"12349","boardingschools",1,0,0,0,1
"12350","boastful",1,0,0,0,1
"12351","boathooks",1,0,0,0,1
"12352","boatman",1,0,0,0,1
"12353","boats",0,0,0,1,1
"12354","bodrachien",0,0,0,1,1
"12355","bodya",1,0,0,0,1
"12356","bogus",0,1,0,0,1
"12357","boiledand",1,0,0,0,1
"12358","boils",0,0,1,0,1
"12359","bolted",0,0,1,0,1
"12360","bombast",0,1,0,0,1
"12361","bondman’s",1,0,0,0,1
"12362","bondsman",1,0,0,0,1
"12363","bondsmen",0,1,0,0,1
"12364","bonnard",0,0,0,1,1
"12365","bonnet”",1,0,0,0,1
"12366","booked",0,0,0,1,1
"12367","bookheld",1,0,0,0,1
"12368","booklearning”",1,0,0,0,1
"12369","bookstores",1,0,0,0,1
"12370","boone",1,0,0,0,1
"12371","boost",0,1,0,0,1
"12372","bordeaux",0,0,0,1,1
"12373","borden",1,0,0,0,1
"12374","bordering",0,1,0,0,1
"12375","bordeu",0,0,0,1,1
"12376","boring",0,0,0,1,1
"12377","borrower",1,0,0,0,1
"12378","bosding",0,0,0,1,1
"12379","boston”",1,0,0,0,1
"12380","bottles”",1,0,0,0,1
"12381","bottomfact",1,0,0,0,1
"12382","bottomless",1,0,0,0,1
"12383","bottoms",1,0,0,0,1
"12384","boundaries",1,0,0,0,1
"12385","bounding",1,0,0,0,1
"12386","bounteously",0,1,0,0,1
"12387","bountiful",1,0,0,0,1
"12388","bountifully",0,0,1,0,1
"12389","bountifulness",0,1,0,0,1
"12390","bounty",1,0,0,0,1
"12391","bourbon",0,0,0,1,1
"12392","bowden",0,0,0,1,1
"12393","bowditch",1,0,0,0,1
"12394","bowdoin",0,1,0,0,1
"12395","bowels",0,1,0,0,1
"12396","bowering",1,0,0,0,1
"12397","bowlein",1,0,0,0,1
"12398","bowley’s",0,0,1,0,1
"12399","bowlien",0,1,0,0,1
"12400","bows",0,0,1,0,1
"12401","bowse",1,0,0,0,1
"12402","boysgustavus",1,0,0,0,1
"12403","brace",1,0,0,0,1
"12404","bracing",0,0,0,1,1
"12405","bragging",1,0,0,0,1
"12406","brakeman",1,0,0,0,1
"12407","branding",0,1,0,0,1
"12408","brands",1,0,0,0,1
"12409","bravadosound",1,0,0,0,1
"12410","brave”",1,0,0,0,1
"12411","braves",1,0,0,0,1
"12412","bravest",1,0,0,0,1
"12413","brawny",0,1,0,0,1
"12414","braying",0,0,1,0,1
"12415","brazenly",1,0,0,0,1
"12416","brazil",1,0,0,0,1
"12417","brazils",0,1,0,0,1
"12418","breach",1,0,0,0,1
"12419","bread_",0,1,0,0,1
"12420","breadless",0,1,0,0,1
"12421","breakers",0,1,0,0,1
"12422","breaks",1,0,0,0,1
"12423","bred",0,1,0,0,1
"12424","breeder”",1,0,0,0,1
"12425","brenlock",0,0,0,1,1
"12426","bribe",1,0,0,0,1
"12427","bribed",1,0,0,0,1
"12428","brickbats",1,0,0,0,1
"12429","bridge”",1,0,0,0,1
"12430","bridged",1,0,0,0,1
"12431","briefest",1,0,0,0,1
"12432","brightened",1,0,0,0,1
"12433","brighteyed",1,0,0,0,1
"12434","brightness",1,0,0,0,1
"12435","brigs",0,0,1,0,1
"12436","brilliarch",0,0,0,1,1
"12437","brimful",0,0,0,1,1
"12438","brinkhouse",0,0,0,1,1
"12439","briny",0,1,0,0,1
"12440","bristol",0,1,0,0,1
"12441","britanique",0,0,0,1,1
"12442","britannique",0,0,0,1,1
"12443","brittle",0,1,0,0,1
"12444","broach",1,0,0,0,1
"12445","broadens",1,0,0,0,1
"12446","broadest",1,0,0,0,1
"12447","broadhanded",1,0,0,0,1
"12448","broadly",1,0,0,0,1
"12449","broadstreet",0,0,0,1,1
"12450","broken_",0,1,0,0,1
"12451","broken”",1,0,0,0,1
"12452","brokenbacked",1,0,0,0,1
"12453","brokers",1,0,0,0,1
"12454","brook’s",0,1,0,0,1
"12455","brooklyn",1,0,0,0,1
"12456","brooks",1,0,0,0,1
"12457","brother’”",1,0,0,0,1
"12458","brotherinlaw",1,0,0,0,1
"12459","brotherssocial",1,0,0,0,1
"12460","brown”",1,0,0,0,1
"12461","brownin",1,0,0,0,1
"12462","browning",0,0,0,1,1
"12463","browns_",0,1,0,0,1
"12464","brownson",1,0,0,0,1
"12465","bruce",1,0,0,0,1
"12466","brushed",1,0,0,0,1
"12467","brusqueness",1,0,0,0,1
"12468","brutalize",0,0,1,0,1
"12469","brutus",0,0,0,1,1
"12470","bryan",0,0,0,1,1
"12471","bryant",0,1,0,0,1
"12472","bubble",1,0,0,0,1
"12473","buchanan’s",1,0,0,0,1
"12474","buffums",1,0,0,0,1
"12475","builded",1,0,0,0,1
"12476","builts",0,0,0,1,1
"12477","bulldozer’s",1,0,0,0,1
"12478","bullseye",0,0,0,1,1
"12479","bullying",1,0,0,0,1
"12480","bulwark",0,1,0,0,1
"12481","bunch",0,1,0,0,1
"12482","buoyancy",1,0,0,0,1
"12483","bureed",0,0,0,1,1
"12484","buren",1,0,0,0,1
"12485","burgesses",1,0,0,0,1
"12486","burglars",1,0,0,0,1
"12487","burialplacesuperstition",1,0,0,0,1
"12488","buried”",1,0,0,0,1
"12489","burke",1,0,0,0,1
"12490","burned”",1,0,0,0,1
"12491","burnished",1,0,0,0,1
"12492","burns",1,0,0,0,1
"12493","burnt_",0,1,0,0,1
"12494","bursting",0,1,0,0,1
"12495","buryingground",1,0,0,0,1
"12496","businesslike",1,0,0,0,1
"12497","butcher",0,1,0,0,1
"12498","butt",0,1,0,0,1
"12499","buttonhole",1,0,0,0,1
"12500","buttons",1,0,0,0,1
"12501","buys",0,0,1,0,1
"12502","bygone",1,0,0,0,1
"12503","byse",0,0,0,1,1
"12504","byword",1,0,0,0,1
"12505","cab",0,1,0,0,1
"12506","cabbage",1,0,0,0,1
"12507","cabi",1,0,0,0,1
"12508","cabinboy",1,0,0,0,1
"12509","cabinhome",1,0,0,0,1
"12510","cabmen",1,0,0,0,1
"12511","caboose",1,0,0,0,1
"12512","cady",1,0,0,0,1
"12513","caitness",0,0,0,1,1
"12514","cakecontrast",1,0,0,0,1
"12515","cal",1,0,0,0,1
"12516","calculating",1,0,0,0,1
"12517","calcutta",0,0,0,1,1
"12518","caleb",1,0,0,0,1
"12519","caledonia",0,0,0,1,1
"12520","calidian",0,0,0,1,1
"12521","california”",1,0,0,0,1
"12522","calker’s",1,0,0,0,1
"12523","callls",0,1,0,0,1
"12524","calmest",1,0,0,0,1
"12525","calumniators",0,0,1,0,1
"12526","camals",0,0,0,1,1
"12527","cambriathe",1,0,0,0,1
"12528","camden",1,0,0,0,1
"12529","came”",1,0,0,0,1
"12530","camel’s",1,0,0,0,1
"12531","camels",0,0,0,1,1
"12532","cameron",1,0,0,0,1
"12533","cameto",0,0,0,1,1
"12534","campaigns",1,0,0,0,1
"12535","campbell",0,1,0,0,1
"12536","can’",1,0,0,0,1
"12537","canaan”",1,0,0,0,1
"12538","canals",0,0,0,1,1
"12539","canandaigua",1,0,0,0,1
"12540","canceled",0,0,0,1,1
"12541","candid",1,0,0,0,1
"12542","candies",0,1,0,0,1
"12543","candles",1,0,0,0,1
"12544","cannon’s",1,0,0,0,1
"12545","cannotwill",1,0,0,0,1
"12546","canopy",0,1,0,0,1
"12547","cap’n",0,1,0,0,1
"12548","capets",0,0,0,1,1
"12549","capitalist",1,0,0,0,1
"12550","capitoline",0,0,0,1,1
"12551","capped",0,0,0,1,1
"12552","capri",0,0,0,1,1
"12553","caps",0,0,0,1,1
"12554","captan",0,1,0,0,1
"12555","captive’s",0,0,1,0,1
"12556","captives",0,1,0,0,1
"12557","capturea",1,0,0,0,1
"12558","capuchen",0,0,0,1,1
"12559","car_",0,1,0,0,1
"12560","carao",0,0,0,1,1
"12561","caravan",0,0,0,1,1
"12562","cards",1,0,0,0,1
"12563","cardwell",0,0,0,1,1
"12564","carefulness",0,0,1,0,1
"12565","careless",1,0,0,0,1
"12566","carelessly",1,0,0,0,1
"12567","cargoes",0,1,0,0,1
"12568","caricature",0,0,1,0,1
"12569","carigio",0,0,0,1,1
"12570","carnival",1,0,0,0,1
"12571","carolinas",0,0,1,0,1
"12572","carpenter’s",1,0,0,0,1
"12573","carpentersprivileged",1,0,0,0,1
"12574","carriage”",1,0,0,0,1
"12575","carriagehouses",1,0,0,0,1
"12576","carribean",1,0,0,0,1
"12577","carrollton",1,0,0,0,1
"12578","cartridgebox",1,0,0,0,1
"12579","cartwrighting",0,0,1,0,1
"12580","carve",0,1,0,0,1
"12581","carvings",0,0,0,1,1
"12582","cascades",0,0,0,1,1
"12583","cashier",1,0,0,0,1
"12584","casket",0,0,0,1,1
"12585","castings",1,0,0,0,1
"12586","castoff",1,0,0,0,1
"12587","casts",0,1,0,0,1
"12588","catcher",0,1,0,0,1
"12589","caterers",0,1,0,0,1
"12590","cathaderal",0,0,0,1,1
"12591","catholicity",1,0,0,0,1
"12592","caulking",1,0,0,0,1
"12593","causesconflict",1,0,0,0,1
"12594","causeth",0,0,0,1,1
"12595","causway",0,1,0,0,1
"12596","cautioning",0,1,0,0,1
"12597","cautions",1,0,0,0,1
"12598","cautious",1,0,0,0,1
"12599","cavils",1,0,0,0,1
"12600","ceal",0,1,0,0,1
"12601","ceal’s",0,1,0,0,1
"12602","ceaser",0,0,0,1,1
"12603","cedar",0,0,0,1,1
"12604","ceilings",0,1,0,0,1
"12605","celebrating",0,1,0,0,1
"12606","celebrities",1,0,0,0,1
"12607","celestialexpression",0,0,0,1,1
"12608","celibrated",0,0,0,1,1
"12609","cell",0,1,0,0,1
"12610","cells",0,0,1,0,1
"12611","cementary",0,0,0,1,1
"12612","cemetarie",0,0,0,1,1
"12613","cemetaries",0,0,0,1,1
"12614","cemitarie",0,0,0,1,1
"12615","centennial",0,0,0,1,1
"12616","centered",0,1,0,0,1
"12617","centrally",1,0,0,0,1
"12618","centre",1,0,0,0,1
"12619","centurion",1,0,0,0,1
"12620","ceremonya",1,0,0,0,1
"12621","cerimony",0,0,0,1,1
"12622","certifying",1,0,0,0,1
"12623","cessation",0,1,0,0,1
"12624","cested",0,1,0,0,1
"12625","chace",1,0,0,0,1
"12626","chaces",1,0,0,0,1
"12627","chainings",0,1,0,0,1
"12628","chairmanladies",1,0,0,0,1
"12629","challenge",1,0,0,0,1
"12630","chamberlain",1,0,0,0,1
"12631","champions",1,0,0,0,1
"12632","chancec",1,0,0,0,1
"12633","chandeler",0,0,0,1,1
"12634","chandeliers",1,0,0,0,1
"12635","changedcaulking",1,0,0,0,1
"12636","chant",0,0,0,1,1
"12637","chaotic",0,0,0,1,1
"12638","chapman",1,0,0,0,1
"12639","chara",0,1,0,0,1
"12640","charge”",1,0,0,0,1
"12641","charlotte",0,0,0,1,1
"12642","charmer",0,1,0,0,1
"12643","chartered",0,1,0,0,1
"12644","chases",1,0,0,0,1
"12645","chastity",0,1,0,0,1
"12646","chateau",0,0,0,1,1
"12647","chatter",1,0,0,0,1
"12648","che",0,0,0,1,1
"12649","cheafo",0,0,0,1,1
"12650","cheat",0,0,1,0,1
"12651","cheats",0,0,1,0,1
"12652","checkedmy",1,0,0,0,1
"12653","cheeirs",0,0,0,1,1
"12654","cheeked",0,1,0,0,1
"12655","cheeney",1,0,0,0,1
"12656","cheltenham",0,0,0,1,1
"12657","cheofos",0,0,0,1,1
"12658","cherry",0,0,1,0,1
"12659","chest",0,1,0,0,1
"12660","chester",0,0,0,1,1
"12661","chided",0,1,0,0,1
"12662","chiefjustice",1,0,0,0,1
"12663","chiel",0,1,0,0,1
"12664","childrenat",1,0,0,0,1
"12665","chimed",1,0,0,0,1
"12666","chin",1,0,0,0,1
"12667","chirurgical",0,1,0,0,1
"12668","choate",1,0,0,0,1
"12669","choir",0,0,0,1,1
"12670","choked",1,0,0,0,1
"12671","chooses",0,1,0,0,1
"12672","chord",0,1,0,0,1
"12673","christ’s",0,0,1,0,1
"12674","christeaned ",0,0,0,1,1
"12675","christian_",0,1,0,0,1
"12676","christian’s",0,1,0,0,1
"12677","christian”",1,0,0,0,1
"12678","christianthe",1,0,0,0,1
"12679","christo",0,0,0,1,1
"12680","christopher",1,0,0,0,1
"12681","chronic",1,0,0,0,1
"12682","chronicled",0,1,0,0,1
"12683","church”",1,0,0,0,1
"12684","churches”",1,0,0,0,1
"12685","churchmen",0,1,0,0,1
"12686","churchthe",1,0,0,0,1
"12687","cinders”",1,0,0,0,1
"12688","circling",0,1,0,0,1
"12689","circulars",1,0,0,0,1
"12690","circulated",1,0,0,0,1
"12691","circumference",1,0,0,0,1
"12692","circumvent",1,0,0,0,1
"12693","citizenshipin",1,0,0,0,1
"12694","citizenshipthe",1,0,0,0,1
"12695","cityand",1,0,0,0,1
"12696","citythe",1,0,0,0,1
"12697","civilizing",0,1,0,0,1
"12698","civilly",1,0,0,0,1
"12699","claimant",1,0,0,0,1
"12700","clamored",1,0,0,0,1
"12701","clamour",0,0,0,1,1
"12702","clamouring",0,0,0,1,1
"12703","clanking",0,0,1,0,1
"12704","clap",1,0,0,0,1
"12705","clapham",1,0,0,0,1
"12706","clapped",1,0,0,0,1
"12707","clarks",1,0,0,0,1
"12708","clarksonthe",1,0,0,0,1
"12709","clasped",1,0,0,0,1
"12710","class_",0,1,0,0,1
"12711","classed",0,0,0,1,1
"12712","classical",1,0,0,0,1
"12713","classics",0,1,0,0,1
"12714","classifying",0,1,0,0,1
"12715","classleading",1,0,0,0,1
"12716","classtheir",1,0,0,0,1
"12717","clave",0,1,0,0,1
"12718","clay’s",1,0,0,0,1
"12719","cleanse",0,1,0,0,1
"12720","cleansed",1,0,0,0,1
"12721","cleansing",0,1,0,0,1
"12722","clear”",1,0,0,0,1
"12723","clearheaded",1,0,0,0,1
"12724","clearing",0,0,1,0,1
"12725","clearsighted",1,0,0,0,1
"12726","cleinly",0,0,0,1,1
"12727","clemency",0,1,0,0,1
"12728","cleverly",0,1,0,0,1
"12729","click",1,0,0,0,1
"12730","cliffs",1,0,0,0,1
"12731","climb",1,0,0,0,1
"12732","climbing",0,1,0,0,1
"12733","cling",0,0,1,0,1
"12734","clinging",1,0,0,0,1
"12735","clinton",1,0,0,0,1
"12736","clippers",0,1,0,0,1
"12737","closefisted",1,0,0,0,1
"12738","closer",1,0,0,0,1
"12739","closes",0,0,0,1,1
"12740","clother",1,0,0,0,1
"12741","clothes”",1,0,0,0,1
"12742","clothinga",1,0,0,0,1
"12743","cloths",0,0,0,1,1
"12744","cloudy",0,0,0,1,1
"12745","cloven",0,1,0,0,1
"12746","clubs",0,1,0,0,1
"12747","clumsily",0,1,0,0,1
"12748","clumsy",0,1,0,0,1
"12749","clusters",0,0,0,1,1
"12750","clutch",1,0,0,0,1
"12751","clutched",0,1,0,0,1
"12752","clutches",1,0,0,0,1
"12753","coach",0,0,1,0,1
"12754","coalheavers",1,0,0,0,1
"12755","coals",0,1,0,0,1
"12756","coarsely",0,1,0,0,1
"12757","coated",0,1,0,0,1
"12758","coatfronts",1,0,0,0,1
"12759","coaxed",1,0,0,0,1
"12760","coaxened",0,0,0,1,1
"12761","coaxing",0,1,0,0,1
"12762","cobdenfor",1,0,0,0,1
"12763","cockcrow”",1,0,0,0,1
"12764","code_",0,1,0,0,1
"12765","coerce",1,0,0,0,1
"12766","coextensive",0,1,0,0,1
"12767","coffins",0,0,0,1,1
"12768","cogent",1,0,0,0,1
"12769","coiled",0,0,1,0,1
"12770","coincided",0,0,1,0,1
"12771","coincidence",0,1,0,0,1
"12772","coincidencebetrayalarrestsresistancemrs",1,0,0,0,1
"12773","coinone",1,0,0,0,1
"12774","coldchisel”“",1,0,0,0,1
"12775","colection",0,0,0,1,1
"12776","coleridge",0,1,0,0,1
"12777","collapse",1,0,0,0,1
"12778","collation",1,0,0,0,1
"12779","collections",1,0,0,0,1
"12780","collector",1,0,0,0,1
"12781","collisions",0,1,0,0,1
"12782","collison",0,1,0,0,1
"12783","colonial",1,0,0,0,1
"12784","colony",1,0,0,0,1
"12785","color”",1,0,0,0,1
"12786","colorphobia",1,0,0,0,1
"12787","colorwho",1,0,0,0,1
"12788","colossium",0,0,0,1,1
"12789","colouma",0,0,0,1,1
"12790","columbiaat",1,0,0,0,1
"12791","columbus",1,0,0,0,1
"12792","combating",0,0,1,0,1
"12793","combats",0,1,0,0,1
"12794","combed”",1,0,0,0,1
"12795","combines",0,1,0,0,1
"12796","combustible",0,1,0,0,1
"12797","come”",1,0,0,0,1
"12798","comefor",1,0,0,0,1
"12799","comeliness",0,1,0,0,1
"12800","comely",1,0,0,0,1
"12801","comers",0,1,0,0,1
"12802","cometh",0,1,0,0,1
"12803","comforting",0,1,0,0,1
"12804","comin",0,1,0,0,1
"12805","comings",0,0,1,0,1
"12806","commanders",1,0,0,0,1
"12807","commemorating",1,0,0,0,1
"12808","commendable",0,1,0,0,1
"12809","commentary",1,0,0,0,1
"12810","comments",1,0,0,0,1
"12811","commissary",1,0,0,0,1
"12812","committedthe",1,0,0,0,1
"12813","commodore",1,0,0,0,1
"12814","commotion",1,0,0,0,1
"12815","communicative",0,1,0,0,1
"12816","communism",1,0,0,0,1
"12817","compact",1,0,0,0,1
"12818","companions_",0,1,0,0,1
"12819","companions”",1,0,0,0,1
"12820","companionship",1,0,0,0,1
"12821","comparing",0,1,0,0,1
"12822","compass",0,0,1,0,1
"12823","compassing",0,0,1,0,1
"12824","compensate",0,0,1,0,1
"12825","compensations",1,0,0,0,1
"12826","competency",1,0,0,0,1
"12827","competitor",1,0,0,0,1
"12828","completeness",1,0,0,0,1
"12829","composing",1,0,0,0,1
"12830","comprehends",0,1,0,0,1
"12831","compression",1,0,0,0,1
"12832","compromisers",1,0,0,0,1
"12833","compromises",1,0,0,0,1
"12834","compromising",0,1,0,0,1
"12835","conceals",0,1,0,0,1
"12836","conceit",1,0,0,0,1
"12837","concentrating",0,1,0,0,1
"12838","conceptions",0,1,0,0,1
"12839","concernedto",1,0,0,0,1
"12840","conciliatory",1,0,0,0,1
"12841","concludes",0,1,0,0,1
"12842","concluding",1,0,0,0,1
"12843","concord",0,0,0,1,1
"12844","concubinage",0,0,1,0,1
"12845","concurred",1,0,0,0,1
"12846","condensation",1,0,0,0,1
"12847","condenses",0,1,0,0,1
"12848","condescended",1,0,0,0,1
"12849","condescension",0,1,0,0,1
"12850","condition_",0,1,0,0,1
"12851","conditiona",1,0,0,0,1
"12852","conditional",1,0,0,0,1
"12853","conditionally",1,0,0,0,1
"12854","condolence",1,0,0,0,1
"12855","conferences",1,0,0,0,1
"12856","conferred",0,0,1,0,1
"12857","confessing",0,1,0,0,1
"12858","confidently",1,0,0,0,1
"12859","confirm",0,1,0,0,1
"12860","conflicts",0,1,0,0,1
"12861","confluence",1,0,0,0,1
"12862","conformists",0,1,0,0,1
"12863","conforms",1,0,0,0,1
"12864","confront",0,1,0,0,1
"12865","conglomeration",0,1,0,0,1
"12866","congratulated",1,0,0,0,1
"12867","congratulation",1,0,0,0,1
"12868","congregational",1,0,0,0,1
"12869","congregationin",1,0,0,0,1
"12870","congress”",1,0,0,0,1
"12871","conical",0,0,0,1,1
"12872","conjectures",0,0,1,0,1
"12873","conjunction",1,0,0,0,1
"12874","conjuration",1,0,0,0,1
"12875","conjuror",1,0,0,0,1
"12876","connecticut”",1,0,0,0,1
"12877","conquering",1,0,0,0,1
"12878","conquest",1,0,0,0,1
"12879","consciencewhigs",1,0,0,0,1
"12880","conscientiously",1,0,0,0,1
"12881","consecrate",0,0,1,0,1
"12882","consecrated",0,0,1,0,1
"12883","consecrating",0,0,1,0,1
"12884","conservatism",1,0,0,0,1
"12885","conserve",0,0,0,1,1
"12886","considerably",1,0,0,0,1
"12887","considertion",0,1,0,0,1
"12888","consignment",1,0,0,0,1
"12889","consigns",0,1,0,0,1
"12890","consist",0,0,0,1,1
"12891","consistory",0,0,0,1,1
"12892","consists",1,0,0,0,1
"12893","consociate",0,1,0,0,1
"12894","consolidating",0,1,0,0,1
"12895","conspicuously",1,0,0,0,1
"12896","conspiring",1,0,0,0,1
"12897","constancy",1,0,0,0,1
"12898","constitutes",0,1,0,0,1
"12899","constitutions",0,1,0,0,1
"12900","construct",1,0,0,0,1
"12901","construction",1,0,0,0,1
"12902","consults",1,0,0,0,1
"12903","consuming",1,0,0,0,1
"12904","consummate",0,0,1,0,1
"12905","consummation",1,0,0,0,1
"12906","consur",0,0,0,1,1
"12907","contains",1,0,0,0,1
"12908","continents",1,0,0,0,1
"12909","continual",0,1,0,0,1
"12910","continuous",0,1,0,0,1
"12911","continuously",1,0,0,0,1
"12912","contortions",0,0,0,1,1
"12913","contraband",1,0,0,0,1
"12914","contradicted",1,0,0,0,1
"12915","contradictions",1,0,0,0,1
"12916","contradistinction",0,1,0,0,1
"12917","contrasts",1,0,0,0,1
"12918","contravenes",0,1,0,0,1
"12919","contrived",1,0,0,0,1
"12920","controversies",1,0,0,0,1
"12921","convened",1,0,0,0,1
"12922","convention’",1,0,0,0,1
"12923","convention”",1,0,0,0,1
"12924","conventionalities",0,1,0,0,1
"12925","conversation”",1,0,0,0,1
"12926","conversationand",1,0,0,0,1
"12927","conveyanceshut",1,0,0,0,1
"12928","convictionsthought",1,0,0,0,1
"12929","convulsed",0,1,0,0,1
"12930","cookaunt",1,0,0,0,1
"12931","cooperated",1,0,0,0,1
"12932","coöperated",1,0,0,0,1
"12933","cooperating",0,1,0,0,1
"12934","coöperating",1,0,0,0,1
"12935","cope",1,0,0,0,1
"12936","copeland",1,0,0,0,1
"12937","copies",1,0,0,0,1
"12938","coppercaptain",1,0,0,0,1
"12939","copperhead",1,0,0,0,1
"12940","coptic",0,0,0,1,1
"12941","copyist",0,0,1,0,1
"12942","copyrighted",1,0,0,0,1
"12943","core",0,1,0,0,1
"12944","corinithian",0,0,0,1,1
"12945","cornhill",0,0,1,0,1
"12946","coron",0,0,0,1,1
"12947","coroner",0,0,1,0,1
"12948","corporate",1,0,0,0,1
"12949","corporation",1,0,0,0,1
"12950","corresponded",1,0,0,0,1
"12951","correspondingly",1,0,0,0,1
"12952","corresponds",1,0,0,0,1
"12953","corridors",1,0,0,0,1
"12954","corrodors",0,0,0,1,1
"12955","corrupted",0,1,0,0,1
"12956","corrupting",0,1,0,0,1
"12957","corruption",0,1,0,0,1
"12958","cosdry",1,0,0,0,1
"12959","cost”",1,0,0,0,1
"12960","costing",0,1,0,0,1
"12961","cot",0,1,0,0,1
"12962","cottages",0,0,0,1,1
"12963","cottonfields",1,0,0,0,1
"12964","councila",1,0,0,0,1
"12965","councilby",1,0,0,0,1
"12966","counseled",1,0,0,0,1
"12967","counsellors",1,0,0,0,1
"12968","counterfeits",0,1,0,0,1
"12969","countermanded",1,0,0,0,1
"12970","counterstatements",1,0,0,0,1
"12971","country’s",1,0,0,0,1
"12972","countryman",1,0,0,0,1
"12973","countrymenfull",1,0,0,0,1
"12974","countrytrue",1,0,0,0,1
"12975","couragefaith",1,0,0,0,1
"12976","coursed",1,0,0,0,1
"12977","courteously",0,0,0,1,1
"12978","courtious",0,0,0,1,1
"12979","cousien",0,0,0,1,1
"12980","coventry",1,0,0,0,1
"12981","coveted",0,1,0,0,1
"12982","covey’sthe",1,0,0,0,1
"12983","coveys",0,1,0,0,1
"12984","cowards",1,0,0,0,1
"12985","cowed",0,1,0,0,1
"12986","crackers",0,1,0,0,1
"12987","cradleside",1,0,0,0,1
"12988","crags",1,0,0,0,1
"12989","cram",0,0,1,0,1
"12990","cramming",0,1,0,0,1
"12991","crane",1,0,0,0,1
"12992","crazy",1,0,0,0,1
"12993","credence",0,1,0,0,1
"12994","credited",1,0,0,0,1
"12995","creditor",1,0,0,0,1
"12996","creditors",1,0,0,0,1
"12997","creduality",0,0,0,1,1
"12998","credulous",0,0,0,1,1
"12999","creeds",1,0,0,0,1
"13000","creeping",1,0,0,0,1
"13001","creet",0,0,0,1,1
"13002","crept",0,1,0,0,1
"13003","crevices",0,1,0,0,1
"13004","crimsoned",0,0,1,0,1
"13005","crippledpurposely",1,0,0,0,1
"13006","crisen",0,0,0,1,1
"13007","crispy",1,0,0,0,1
"13008","criterion",0,0,0,1,1
"13009","criticize",1,0,0,0,1
"13010","crocodile",0,0,1,0,1
"13011","croffts",1,0,0,0,1
"13012","crooked",0,0,0,1,1
"13013","crookedess",0,0,0,1,1
"13014","cropped",0,1,0,0,1
"13015","crosses",0,0,0,1,1
"13016","crossroads",1,0,0,0,1
"13017","crosstrees",1,0,0,0,1
"13018","crouch",0,0,1,0,1
"13019","crow”",1,0,0,0,1
"13020","crowbar",0,0,1,0,1
"13021","crowbar”“fred",1,0,0,0,1
"13022","crucified",0,0,0,1,1
"13023","crucifixion",0,0,0,1,1
"13024","crude",0,1,0,0,1
"13025","cruelty_",0,1,0,0,1
"13026","crumb",0,1,0,0,1
"13027","crumble",0,0,0,1,1
"13028","crumbled",1,0,0,0,1
"13029","crummells",1,0,0,0,1
"13030","cruss",0,1,0,0,1
"13031","cudgel",0,0,1,0,1
"13032","cue",1,0,0,0,1
"13033","culminating",1,0,0,0,1
"13034","culmination",1,0,0,0,1
"13035","cultivate",0,1,0,0,1
"13036","cumbering",0,1,0,0,1
"13037","cumbrous",0,1,0,0,1
"13038","cumin",0,0,1,0,1
"13039","cupidity",1,0,0,0,1
"13040","curbstone",1,0,0,0,1
"13041","cured",0,1,0,0,1
"13042","curiosities",0,0,0,1,1
"13043","curiously",0,0,0,1,1
"13044","curly",0,1,0,0,1
"13045","curlyheaded",1,0,0,0,1
"13046","curried",0,0,1,0,1
"13047","curtailing",1,0,0,0,1
"13048","curtiss",1,0,0,0,1
"13049","curves",0,0,0,1,1
"13050","custodian",1,0,0,0,1
"13051","custody",1,0,0,0,1
"13052","cutglass",1,0,0,0,1
"13053","cyphering",0,1,0,0,1
"13054","dahhabezez",0,0,0,1,1
"13055","damages",1,0,0,0,1
"13056","damper",1,0,0,0,1
"13057","dan",1,0,0,0,1
"13058","dan”",1,0,0,0,1
"13059","dangerously",0,0,1,0,1
"13060","danieledward",1,0,0,0,1
"13061","darby",0,1,0,0,1
"13062","daring”",1,0,0,0,1
"13063","darkened",0,1,0,0,1
"13064","darkening",0,1,0,0,1
"13065","darkens",0,0,0,1,1
"13066","darknesssuffering",1,0,0,0,1
"13067","darky",0,0,1,0,1
"13068","dartmouth",0,1,0,0,1
"13069","dast",0,0,0,1,1
"13070","datesthus",1,0,0,0,1
"13071","daughters’",1,0,0,0,1
"13072","dauntless",1,0,0,0,1
"13073","daves",0,0,0,1,1
"13074","davis’",1,0,0,0,1
"13075","dawns",1,0,0,0,1
"13076","dayand",1,0,0,0,1
"13077","days”",1,0,0,0,1
"13078","daysin",1,0,0,0,1
"13079","daytime",1,0,0,0,1
"13080","dayton",1,0,0,0,1
"13081","dazzled",1,0,0,0,1
"13082","dead_",0,1,0,0,1
"13083","deadest ",0,0,0,1,1
"13084","deafen",0,1,0,0,1
"13085","dearborns",0,0,1,0,1
"13086","death”",1,0,0,0,1
"13087","deathdealing",1,0,0,0,1
"13088","deathsweat",1,0,0,0,1
"13089","debarred",0,1,0,0,1
"13090","debase",0,0,1,0,1
"13091","debatebrown",1,0,0,0,1
"13092","debated",1,0,0,0,1
"13093","debaters",1,0,0,0,1
"13094","debauch",1,0,0,0,1
"13095","debts",1,0,0,0,1
"13096","debuty",0,1,0,0,1
"13097","decalogue",0,1,0,0,1
"13098","decanters",1,0,0,0,1
"13099","decayed",1,0,0,0,1
"13100","decaying",0,1,0,0,1
"13101","deceitful",0,0,1,0,1
"13102","deceiver",0,0,1,0,1
"13103","decently",1,0,0,0,1
"13104","deception",0,1,0,0,1
"13105","deceptive",0,1,0,0,1
"13106","decisive",1,0,0,0,1
"13107","declamation",1,0,0,0,1
"13108","declamatory",0,1,0,0,1
"13109","decosa",1,0,0,0,1
"13110","decrees",0,1,0,0,1
"13111","decry",1,0,0,0,1
"13112","deduction",0,1,0,0,1
"13113","deductive",0,1,0,0,1
"13114","deeprooted",1,0,0,0,1
"13115","deface",0,1,0,0,1
"13116","defeating",1,0,0,0,1
"13117","defeats",1,0,0,0,1
"13118","defection",1,0,0,0,1
"13119","defects",1,0,0,0,1
"13120","defense_",0,1,0,0,1
"13121","defiled",0,0,1,0,1
"13122","define",0,1,0,0,1
"13123","defined",1,0,0,0,1
"13124","defraud",1,0,0,0,1
"13125","degation",0,0,0,1,1
"13126","deify",0,0,0,1,1
"13127","deity",0,0,0,1,1
"13128","dejection",1,0,0,0,1
"13129","dela",0,0,0,1,1
"13130","delany",0,0,0,1,1
"13131","delapidated",1,0,0,0,1
"13132","delawareanother",1,0,0,0,1
"13133","delays",0,1,0,0,1
"13134","delegated",1,0,0,0,1
"13135","delegent",0,0,0,1,1
"13136","deleterious",0,1,0,0,1
"13137","deliberations",1,0,0,0,1
"13138","delicately",1,0,0,0,1
"13139","delicatelyformed",1,0,0,0,1
"13140","delineation",1,0,0,0,1
"13141","deliverancea",1,0,0,0,1
"13142","delve",0,1,0,0,1
"13143","demagogue",1,0,0,0,1
"13144","demeanor",0,1,0,0,1
"13145","demolished",0,1,0,0,1
"13146","demolished”",1,0,0,0,1
"13147","demoralize",0,1,0,0,1
"13148","demoralized",1,0,0,0,1
"13149","denbysensationhow",1,0,0,0,1
"13150","denialsandydragged",1,0,0,0,1
"13151","denmark",1,0,0,0,1
"13152","denominated",1,0,0,0,1
"13153","denomination",1,0,0,0,1
"13154","denominational",0,1,0,0,1
"13155","denounces",0,1,0,0,1
"13156","denton",0,1,0,0,1
"13157","denunciatory",0,1,0,0,1
"13158","departure”",1,0,0,0,1
"13159","depict",0,0,1,0,1
"13160","depleted",1,0,0,0,1
"13161","deport",1,0,0,0,1
"13162","deported",1,0,0,0,1
"13163","deposit",1,0,0,0,1
"13164","deposits",1,0,0,0,1
"13165","depraved",0,1,0,0,1
"13166","depreciated",0,1,0,0,1
"13167","depressing",0,1,0,0,1
"13168","deprivation",0,1,0,0,1
"13169","depriving",0,1,0,0,1
"13170","deputies",1,0,0,0,1
"13171","der",0,0,0,1,1
"13172","derives",1,0,0,0,1
"13173","des",0,0,0,1,1
"13174","descendant",1,0,0,0,1
"13175","descends",0,1,0,0,1
"13176","describes",0,1,0,0,1
"13177","desdemoni",0,0,0,1,1
"13178","desease",0,0,0,1,1
"13179","desecrate",0,1,0,0,1
"13180","desecrated",0,1,0,0,1
"13181","desideratum",1,0,0,0,1
"13182","designsin",1,0,0,0,1
"13183","desist",1,0,0,0,1
"13184","desk”",1,0,0,0,1
"13185","desks",1,0,0,0,1
"13186","desolating",1,0,0,0,1
"13187","despaired",1,0,0,0,1
"13188","despatched",1,0,0,0,1
"13189","despisable",1,0,0,0,1
"13190","despiseth",0,1,0,0,1
"13191","despising",0,1,0,0,1
"13192","despoiled",1,0,0,0,1
"13193","despotesum",0,0,0,1,1
"13194","despotic",0,1,0,0,1
"13195","despotism",1,0,0,0,1
"13196","despotisms",0,1,0,0,1
"13197","destroyers",1,0,0,0,1
"13198","detail",0,0,0,1,1
"13199","detectives",1,0,0,0,1
"13200","deterioration",0,0,1,0,1
"13201","determinationyet",1,0,0,0,1
"13202","detraction",1,0,0,0,1
"13203","detracts",0,1,0,0,1
"13204","detroit",1,0,0,0,1
"13205","developments",1,0,0,0,1
"13206","devil_",0,1,0,0,1
"13207","devil”",1,0,0,0,1
"13208","devilish",0,1,0,0,1
"13209","devils",0,0,1,0,1
"13210","devolved",1,0,0,0,1
"13211","devotionmerely",1,0,0,0,1
"13212","devoured",1,0,0,0,1
"13213","dew",0,1,0,0,1
"13214","dhus",1,0,0,0,1
"13215","dialect",0,1,0,0,1
"13216","dialplate",1,0,0,0,1
"13217","diametre",0,0,0,1,1
"13218","dick",0,0,1,0,1
"13219","dickens’s",0,1,0,0,1
"13220","dictate”",1,0,0,0,1
"13221","dictation",1,0,0,0,1
"13222","diction",1,0,0,0,1
"13223","didgoing",1,0,0,0,1
"13224","didn’t",0,0,1,0,1
"13225","die_",0,1,0,0,1
"13226","die”",1,0,0,0,1
"13227","differenced",0,1,0,0,1
"13228","differencewe",1,0,0,0,1
"13229","differs",0,1,0,0,1
"13230","diffidence",0,0,1,0,1
"13231","diffident",0,1,0,0,1
"13232","diffidently",0,1,0,0,1
"13233","diffuse",1,0,0,0,1
"13234","diffusing",0,1,0,0,1
"13235","digression",1,0,0,0,1
"13236","dime",1,0,0,0,1
"13237","diminish",1,0,0,0,1
"13238","diminishing",0,1,0,0,1
"13239","diminishingwas",1,0,0,0,1
"13240","dimly",0,1,0,0,1
"13241","dingy",1,0,0,0,1
"13242","dinners",1,0,0,0,1
"13243","dint",1,0,0,0,1
"13244","diplomat",1,0,0,0,1
"13245","diplomatic",1,0,0,0,1
"13246","directionleast",1,0,0,0,1
"13247","direful",0,0,1,0,1
"13248","disabled",1,0,0,0,1
"13249","disadvantage",1,0,0,0,1
"13250","disappearing",0,1,0,0,1
"13251","disarmed",1,0,0,0,1
"13252","disarming",1,0,0,0,1
"13253","disarms",1,0,0,0,1
"13254","disastrous",0,0,1,0,1
"13255","disbandment",1,0,0,0,1
"13256","discards",1,0,0,0,1
"13257","discern",1,0,0,0,1
"13258","discerned",1,0,0,0,1
"13259","discharging",0,1,0,0,1
"13260","disclosed",0,0,1,0,1
"13261","discloses",1,0,0,0,1
"13262","disclosure",1,0,0,0,1
"13263","disclosures",0,1,0,0,1
"13264","discomfiture",1,0,0,0,1
"13265","disconcerted",1,0,0,0,1
"13266","discontened",0,1,0,0,1
"13267","discontentment",0,0,1,0,1
"13268","discontinue",1,0,0,0,1
"13269","discontinued",1,0,0,0,1
"13270","discordant",0,0,1,0,1
"13271","discount",1,0,0,0,1
"13272","discouragement",1,0,0,0,1
"13273","discouragingly",1,0,0,0,1
"13274","discredit",0,0,1,0,1
"13275","discredited",1,0,0,0,1
"13276","discrepancy",1,0,0,0,1
"13277","discriminated",1,0,0,0,1
"13278","discriminately",0,1,0,0,1
"13279","discrimination",0,1,0,0,1
"13280","discriminations",1,0,0,0,1
"13281","discription",0,0,0,1,1
"13282","discriptions",0,0,0,1,1
"13283","discussedits",1,0,0,0,1
"13284","discussions",1,0,0,0,1
"13285","disdained",1,0,0,0,1
"13286","disdainful",0,1,0,0,1
"13287","diseased",1,0,0,0,1
"13288","disentangled",0,0,1,0,1
"13289","disenthralled",0,1,0,0,1
"13290","disenthrallment",0,1,0,0,1
"13291","disfavoryet",1,0,0,0,1
"13292","disfranchise",1,0,0,0,1
"13293","dishonest",1,0,0,0,1
"13294","disinterestedly",1,0,0,0,1
"13295","disinterment",0,1,0,0,1
"13296","disinterred",1,0,0,0,1
"13297","disliked",1,0,0,0,1
"13298","dismember",1,0,0,0,1
"13299","dismembered",1,0,0,0,1
"13300","dismounting",0,0,1,0,1
"13301","disobey",0,0,1,0,1
"13302","disowned",0,1,0,0,1
"13303","disowns",0,1,0,0,1
"13304","disparaged",1,0,0,0,1
"13305","disparity",0,1,0,0,1
"13306","dispatch",1,0,0,0,1
"13307","disposal",0,0,1,0,1
"13308","disposes",0,1,0,0,1
"13309","dispositionkind",1,0,0,0,1
"13310","dispositions",0,0,1,0,1
"13311","dispossess",1,0,0,0,1
"13312","dispossessed",1,0,0,0,1
"13313","disproportionate",1,0,0,0,1
"13314","disputed",1,0,0,0,1
"13315","disputes",0,0,1,0,1
"13316","disputing",1,0,0,0,1
"13317","disqualification",1,0,0,0,1
"13318","disqualified",1,0,0,0,1
"13319","disrelish",0,1,0,0,1
"13320","dissented",0,1,0,0,1
"13321","dissenters",0,1,0,0,1
"13322","dissertation",1,0,0,0,1
"13323","dissolvedevery",1,0,0,0,1
"13324","dissuade",1,0,0,0,1
"13325","dissuaded",1,0,0,0,1
"13326","dissuading",1,0,0,0,1
"13327","dissuadings",0,1,0,0,1
"13328","distasteful",1,0,0,0,1
"13329","distillment",0,1,0,0,1
"13330","distillment”",1,0,0,0,1
"13331","distinctness",0,1,0,0,1
"13332","distracted",1,0,0,0,1
"13333","distressingly",1,0,0,0,1
"13334","distributed",1,0,0,0,1
"13335","districtsdate",1,0,0,0,1
"13336","distroyed",0,0,0,1,1
"13337","distructive",0,0,0,1,1
"13338","distrust",0,0,1,0,1
"13339","disunited",1,0,0,0,1
"13340","diun",0,0,0,1,1
"13341","diverged",0,1,0,0,1
"13342","divert",0,1,0,0,1
"13343","diverted",0,1,0,0,1
"13344","diverting",0,1,0,0,1
"13345","divesting",1,0,0,0,1
"13346","dividedsad",1,0,0,0,1
"13347","dividers",1,0,0,0,1
"13348","diving",0,0,0,1,1
"13349","divinity_",0,1,0,0,1
"13350","dixon”",1,0,0,0,1
"13351","dling",0,0,0,1,1
"13352","dodge",1,0,0,0,1
"13353","dodos",0,1,0,0,1
"13354","dodson",0,0,1,0,1
"13355","doer",0,1,0,0,1
"13356","doeth",0,0,1,0,1
"13357","doges",0,0,0,1,1
"13358","dogged",1,0,0,0,1
"13359","doings",0,1,0,0,1
"13360","dolars",0,1,0,0,1
"13361","doleful",0,1,0,0,1
"13362","doll",0,0,1,0,1
"13363","domes",1,0,0,0,1
"13364","dominant",0,1,0,0,1
"13365","dona",0,0,1,0,1
"13366","donkees",0,0,0,1,1
"13367","donkey",0,0,0,1,1
"13368","dooms",0,1,0,0,1
"13369","door”",1,0,0,0,1
"13370","doori",1,0,0,0,1
"13371","doorkeeper",1,0,0,0,1
"13372","dora",0,0,0,1,1
"13373","dorgan",1,0,0,0,1
"13374","dormant",0,1,0,0,1
"13375","dorrites",1,0,0,0,1
"13376","dost",0,1,0,0,1
"13377","dot",0,0,0,1,1
"13378","doubtedexperience",1,0,0,0,1
"13379","dough",0,1,0,0,1
"13380","douglas”",1,0,0,0,1
"13381","douglasses",1,0,0,0,1
"13382","doutful",0,0,0,1,1
"13383","downstairs",0,1,0,0,1
"13384","dozens",0,1,0,0,1
"13385","drafts",1,0,0,0,1
"13386","dragnet",1,0,0,0,1
"13387","drained",0,0,1,0,1
"13388","dram",0,0,1,0,1
"13389","dramas",1,0,0,0,1
"13390","dramatized",1,0,0,0,1
"13391","drank",0,1,0,0,1
"13392","drawback",1,0,0,0,1
"13393","drawbacks",1,0,0,0,1
"13394","drawer",1,0,0,0,1
"13395","drawers",1,0,0,0,1
"13396","drawings",1,0,0,0,1
"13397","drayeverywhere",1,0,0,0,1
"13398","dreading",0,0,0,1,1
"13399","dreads",1,0,0,0,1
"13400","dreamer",0,1,0,0,1
"13401","drear",0,1,0,0,1
"13402","dresses",0,0,0,1,1
"13403","drift",1,0,0,0,1
"13404","drilled",1,0,0,0,1
"13405","drills",1,0,0,0,1
"13406","drink”",1,0,0,0,1
"13407","drip",0,0,1,0,1
"13408","drivermr",1,0,0,0,1
"13409","drizzling",1,0,0,0,1
"13410","dropping",0,1,0,0,1
"13411","droves",0,1,0,0,1
"13412","drown",0,0,1,0,1
"13413","drowning",1,0,0,0,1
"13414","drugs",1,0,0,0,1
"13415","dryest",1,0,0,0,1
"13416","duck’s",0,1,0,0,1
"13417","due”",1,0,0,0,1
"13418","duelist",1,0,0,0,1
"13419","duffys",1,0,0,0,1
"13420","dumband",1,0,0,0,1
"13421","dungeons",0,0,0,1,1
"13422","dunlop",1,0,0,0,1
"13423","duomo",0,0,0,1,1
"13424","dustcovered",1,0,0,0,1
"13425","dutch",1,0,0,0,1
"13426","duties”",1,0,0,0,1
"13427","dutyexamining",1,0,0,0,1
"13428","dwellinghouse",1,0,0,0,1
"13429","dyer",1,0,0,0,1
"13430","dynasty",0,1,0,0,1
"13431","eaarth",0,0,0,1,1
"13432","eagles",1,0,0,0,1
"13433","eale",0,0,0,1,1
"13434","earilier",0,1,0,0,1
"13435","earle",1,0,0,0,1
"13436","earles",1,0,0,0,1
"13437","earningsgiving",1,0,0,0,1
"13438","earswas",1,0,0,0,1
"13439","earth_",0,1,0,0,1
"13440","earth’s",1,0,0,0,1
"13441","earth”",1,0,0,0,1
"13442","earthquakes",0,1,0,0,1
"13443","easely",0,0,0,1,1
"13444","eastside",0,0,0,1,1
"13445","eastward",1,0,0,0,1
"13446","eat”",1,0,0,0,1
"13447","eatendenialsandydragged",1,0,0,0,1
"13448","eaves",1,0,0,0,1
"13449","ebenezer",1,0,0,0,1
"13450","ecclesiastics",0,1,0,0,1
"13451","economyto",1,0,0,0,1
"13452","ecstasy",0,0,1,0,1
"13453","eden",0,1,0,0,1
"13454","edifice",0,0,0,1,1
"13455","edified",1,0,0,0,1
"13456","editing",0,1,0,0,1
"13457","editorinchief",1,0,0,0,1
"13458","edmonia",0,0,0,1,1
"13459","edmunson",0,1,0,0,1
"13460","edna",0,0,0,1,1
"13461","edward’s",0,1,0,0,1
"13462","effecting",1,0,0,0,1
"13463","effort”",1,0,0,0,1
"13464","effusion",1,0,0,0,1
"13465","egpt",0,0,0,1,1
"13466","egregious",0,1,0,0,1
"13467","egress",1,0,0,0,1
"13468","egypt’s",1,0,0,0,1
"13469","eightandforty",1,0,0,0,1
"13470","eightyseventh",1,0,0,0,1
"13471","eject",1,0,0,0,1
"13472","elba",1,0,0,0,1
"13473","eldredge",1,0,0,0,1
"13474","eldredges",1,0,0,0,1
"13475","eldridge",1,0,0,0,1
"13476","electioneering",1,0,0,0,1
"13477","elections",1,0,0,0,1
"13478","electronic",0,0,1,0,1
"13479","elevator",1,0,0,0,1
"13480","elias",1,0,0,0,1
"13481","elijah",1,0,0,0,1
"13482","élite",1,0,0,0,1
"13483","ell”",1,0,0,0,1
"13484","elleson",0,0,0,1,1
"13485","ellis",1,0,0,0,1
"13486","elms",1,0,0,0,1
"13487","eloquenceperhaps",1,0,0,0,1
"13488","elucidation",0,1,0,0,1
"13489","eluding",0,1,0,0,1
"13490","emaculate",0,0,0,1,1
"13491","emanated",1,0,0,0,1
"13492","emancipating",0,1,0,0,1
"13493","embarrassing",0,0,1,0,1
"13494","embattled",0,1,0,0,1
"13495","embellished",1,0,0,0,1
"13496","emblem",0,1,0,0,1
"13497","emblems",1,0,0,0,1
"13498","embody",0,1,0,0,1
"13499","emboldened",1,0,0,0,1
"13500","embracing",0,1,0,0,1
"13501","embruted",0,1,0,0,1
"13502","embryo",0,1,0,0,1
"13503","emenent",0,0,0,1,1
"13504","emergencies",1,0,0,0,1
"13505","emergenciesbent",1,0,0,0,1
"13506","emerison",0,0,0,1,1
"13507","emerson",1,0,0,0,1
"13508","emerson’s",1,0,0,0,1
"13509","emigrant",1,0,0,0,1
"13510","emigratenations",1,0,0,0,1
"13511","emily",0,1,0,0,1
"13512","emoluments",1,0,0,0,1
"13513","emperors",0,0,0,1,1
"13514","empires",0,0,0,1,1
"13515","employees",1,0,0,0,1
"13516","employers",0,1,0,0,1
"13517","employs",0,1,0,0,1
"13518","emptied",1,0,0,0,1
"13519","emptiness",1,0,0,0,1
"13520","emulate",0,1,0,0,1
"13521","enact",1,0,0,0,1
"13522","enchained",1,0,0,0,1
"13523","enclosed",0,0,1,0,1
"13524","enclosure",1,0,0,0,1
"13525","encompassed",1,0,0,0,1
"13526","encroach",1,0,0,0,1
"13527","encumbrance",0,1,0,0,1
"13528","endangers",0,1,0,0,1
"13529","endearments",0,1,0,0,1
"13530","endorsed",0,1,0,0,1
"13531","endurable",1,0,0,0,1
"13532","endures",0,1,0,0,1
"13533","enervates",0,1,0,0,1
"13534","enforcements",1,0,0,0,1
"13535","enforces",0,1,0,0,1
"13536","enforcing",0,1,0,0,1
"13537","enfranchise",1,0,0,0,1
"13538","enfranchising",1,0,0,0,1
"13539","engaging",0,1,0,0,1
"13540","englands",1,0,0,0,1
"13541","englead",0,0,0,1,1
"13542","englieries",0,0,0,1,1
"13543","englishman’s",0,1,0,0,1
"13544","englishmanwas",1,0,0,0,1
"13545","enjoymentnatural",1,0,0,0,1
"13546","enjoyments",0,1,0,0,1
"13547","enlivening",0,1,0,0,1
"13548","ennoble",1,0,0,0,1
"13549","enough’",1,0,0,0,1
"13550","enough”",1,0,0,0,1
"13551","enquired",1,0,0,0,1
"13552","enriched",1,0,0,0,1
"13553","ensue",1,0,0,0,1
"13554","ensued",1,0,0,0,1
"13555","ensuing",1,0,0,0,1
"13556","ensure",0,1,0,0,1
"13557","enterance",0,0,0,1,1
"13558","enterpriseforsaken",1,0,0,0,1
"13559","enterprizing",0,0,0,1,1
"13560","entertainmentsfaultfindingshameful",1,0,0,0,1
"13561","entertains",0,0,1,0,1
"13562","enthralled",0,1,0,0,1
"13563","entilted",0,0,0,1,1
"13564","entitles",0,1,0,0,1
"13565","entitling",0,1,0,0,1
"13566","entombs",0,0,1,0,1
"13567","entrap",0,1,0,0,1
"13568","entreat",1,0,0,0,1
"13569","entreaty",0,0,1,0,1
"13570","entrusted",1,0,0,0,1
"13571","entwine",0,1,0,0,1
"13572","enumerate",1,0,0,0,1
"13573","enumerating",0,1,0,0,1
"13574","enverous",0,0,0,1,1
"13575","environed",0,1,0,0,1
"13576","envy",0,1,0,0,1
"13577","ephemeral",1,0,0,0,1
"13578","ephesian",1,0,0,0,1
"13579","ephraim",1,0,0,0,1
"13580","episcopacy",1,0,0,0,1
"13581","epitaph",1,0,0,0,1
"13582","epithet",1,0,0,0,1
"13583","epoch",0,0,1,0,1
"13584","equipage",0,0,1,0,1
"13585","equipages",0,0,0,1,1
"13586","equipments",1,0,0,0,1
"13587","equitable",1,0,0,0,1
"13588","equivocate",0,1,0,0,1
"13589","eradication",1,0,0,0,1
"13590","erecting",0,1,0,0,1
"13591","erection",0,1,0,0,1
"13592","errand",0,0,1,0,1
"13593","errands”",1,0,0,0,1
"13594","erronious",0,0,0,1,1
"13595","escapeagainst",1,0,0,0,1
"13596","escapeday",1,0,0,0,1
"13597","escapes”",1,0,0,0,1
"13598","espousal",1,0,0,0,1
"13599","espousing",1,0,0,0,1
"13600","essayed",0,1,0,0,1
"13601","essays",1,0,0,0,1
"13602","essex",1,0,0,0,1
"13603","establishments",0,0,1,0,1
"13604","estates",1,0,0,0,1
"13605","estemate",0,0,0,1,1
"13606","estimating",1,0,0,0,1
"13607","estopped",1,0,0,0,1
"13608","estrangement",1,0,0,0,1
"13609","etc”",1,0,0,0,1
"13610","eternally",0,1,0,0,1
"13611","ethical",0,1,0,0,1
"13612","ethics",1,0,0,0,1
"13613","ethiopia",0,1,0,0,1
"13614","ethiopian",0,1,0,0,1
"13615","ethnological",1,0,0,0,1
"13616","ethnologically",0,1,0,0,1
"13617","ethnologist",1,0,0,0,1
"13618","eulogium",1,0,0,0,1
"13619","eulogy",1,0,0,0,1
"13620","evanescent",1,0,0,0,1
"13621","evangel",0,1,0,0,1
"13622","evasion",1,0,0,0,1
"13623","eve",1,0,0,0,1
"13624","evedently",0,0,0,1,1
"13625","evenly",1,0,0,0,1
"13626","evergnawing",1,0,0,0,1
"13627","evergreens",1,0,0,0,1
"13628","evering",0,0,0,1,1
"13629","everyhourviolator",1,0,0,0,1
"13630","everyone",1,0,0,0,1
"13631","evilsmelling",1,0,0,0,1
"13632","ewery",0,0,1,0,1
"13633","exactness",1,0,0,0,1
"13634","exacts",0,1,0,0,1
"13635","exalt",1,0,0,0,1
"13636","exaltation",1,0,0,0,1
"13637","exalteth",0,1,0,0,1
"13638","exalting",1,0,0,0,1
"13639","exalts",0,0,1,0,1
"13640","example’s",0,1,0,0,1
"13641","examples",0,1,0,0,1
"13642","exasperating",0,1,0,0,1
"13643","exasperation",1,0,0,0,1
"13644","exceeds",1,0,0,0,1
"13645","excellence_",0,1,0,0,1
"13646","excels",0,0,1,0,1
"13647","excepting",0,0,1,0,1
"13648","exceptionable",1,0,0,0,1
"13649","exceptionally",1,0,0,0,1
"13650","exceptionsabbathschool",1,0,0,0,1
"13651","exceptionthe",1,0,0,0,1
"13652","excersion",0,0,0,1,1
"13653","excluding",1,0,0,0,1
"13654","exclusive",0,1,0,0,1
"13655","excoriated",0,1,0,0,1
"13656","excruciating",0,1,0,0,1
"13657","excuse”",1,0,0,0,1
"13658","execration",0,1,0,0,1
"13659","executing",0,1,0,0,1
"13660","exemplars",0,1,0,0,1
"13661","exemplify",0,1,0,0,1
"13662","exercising",0,1,0,0,1
"13663","exerts",0,1,0,0,1
"13664","exhaust",0,1,0,0,1
"13665","exhausting",0,1,0,0,1
"13666","exhibitions",1,0,0,0,1
"13667","exhorting",0,1,0,0,1
"13668","exit",1,0,0,0,1
"13669","exorcised",1,0,0,0,1
"13670","expenditures",1,0,0,0,1
"13671","experiencevindication",1,0,0,0,1
"13672","expiration",0,0,1,0,1
"13673","expiring",0,0,1,0,1
"13674","explains",1,0,0,0,1
"13675","explanationthe",1,0,0,0,1
"13676","explanatory",1,0,0,0,1
"13677","explicit",0,1,0,0,1
"13678","exploded",1,0,0,0,1
"13679","exploits",1,0,0,0,1
"13680","exposes",0,1,0,0,1
"13681","exposition ",0,0,0,1,1
"13682","expostulation",0,0,1,0,1
"13683","expresident",1,0,0,0,1
"13684","expresses",1,0,0,0,1
"13685","expulsion",1,0,0,0,1
"13686","exsecretary",1,0,0,0,1
"13687","extemporaneous",0,1,0,0,1
"13688","extemporaneously",1,0,0,0,1
"13689","extemporized",1,0,0,0,1
"13690","exterminated",0,1,0,0,1
"13691","externally",1,0,0,0,1
"13692","extirpate",0,1,0,0,1
"13693","extirpated",1,0,0,0,1
"13694","extolling",1,0,0,0,1
"13695","extort",1,0,0,0,1
"13696","extortion",0,0,1,0,1
"13697","extraction",1,0,0,0,1
"13698","extravagantly",1,0,0,0,1
"13699","exult",0,1,0,0,1
"13700","exulting",1,0,0,0,1
"13701","eyewitnesses",1,0,0,0,1
"13702","fable",0,0,1,0,1
"13703","fabrics",0,0,0,1,1
"13704","facad",0,0,0,1,1
"13705","facade",0,0,0,1,1
"13706","face”",1,0,0,0,1
"13707","faceauthor’s",1,0,0,0,1
"13708","facehe",1,0,0,0,1
"13709","faces ",0,0,0,1,1
"13710","faces”",1,0,0,0,1
"13711","facing",1,0,0,0,1
"13712","fact_",0,1,0,0,1
"13713","fact”",1,0,0,0,1
"13714","factions",1,0,0,0,1
"13715","fading",1,0,0,0,1
"13716","faintest",0,0,0,1,1
"13717","faintly",0,1,0,0,1
"13718","fairness",1,0,0,0,1
"13719","fairplay",1,0,0,0,1
"13720","fairseeming",1,0,0,0,1
"13721","fait",0,0,0,1,1
"13722","faith_",0,1,0,0,1
"13723","fall”“fred",1,0,0,0,1
"13724","falter",1,0,0,0,1
"13725","faltered",0,1,0,0,1
"13726","familiarized",0,1,0,0,1
"13727","familiarly",0,1,0,0,1
"13728","family_",0,1,0,0,1
"13729","familyawkwardness",1,0,0,0,1
"13730","familymaster",1,0,0,0,1
"13731","faminestricken",1,0,0,0,1
"13732","famished",0,0,1,0,1
"13733","fanatical",1,0,0,0,1
"13734","fanciful",1,0,0,0,1
"13735","fanny",0,0,0,1,1
"13736","far_",0,1,0,0,1
"13737","farce",0,1,0,0,1
"13738","farity",1,0,0,0,1
"13739","farm”",1,0,0,0,1
"13740","farmers",1,0,0,0,1
"13741","farmhouses",1,0,0,0,1
"13742","farmsomething",1,0,0,0,1
"13743","farreaching",1,0,0,0,1
"13744","fascinating",1,0,0,0,1
"13745","fascination",0,0,0,1,1
"13746","fashioned",0,1,0,0,1
"13747","fastening",1,0,0,0,1
"13748","fastidious",1,0,0,0,1
"13749","fasting",0,0,1,0,1
"13750","fastnesses",1,0,0,0,1
"13751","fastsailing",1,0,0,0,1
"13752","fate”",1,0,0,0,1
"13753","fated",0,1,0,0,1
"13754","fatherhumbly",1,0,0,0,1
"13755","fatherinlaw’s",1,0,0,0,1
"13756","fathom",0,1,0,0,1
"13757","fatigued",1,0,0,0,1
"13758","fattening",1,0,0,0,1
"13759","fatting",0,1,0,0,1
"13760","faultfindingshameful",1,0,0,0,1
"13761","faultit",1,0,0,0,1
"13762","favor_",0,1,0,0,1
"13763","favour",0,0,0,1,1
"13764","favourable",0,0,0,1,1
"13765","fawn",0,1,0,0,1
"13766","fawnlike",1,0,0,0,1
"13767","fayerweathers",1,0,0,0,1
"13768","fealty",0,1,0,0,1
"13769","feasts",0,0,1,0,1
"13770","feats",0,1,0,0,1
"13771","febrymonday",0,0,0,1,1
"13772","feddy",0,1,0,0,1
"13773","fee_",0,1,0,0,1
"13774","feel”",1,0,0,0,1
"13775","feel”letter",1,0,0,0,1
"13776","feik",0,0,0,1,1
"13777","felicitous",0,0,1,0,1
"13778","felicity",1,0,0,0,1
"13779","felling",1,0,0,0,1
"13780","fellowapprentices",1,0,0,0,1
"13781","fellowmortal",1,0,0,0,1
"13782","fellowpassenger",1,0,0,0,1
"13783","fellowpassengers",1,0,0,0,1
"13784","fellowshiping",0,1,0,0,1
"13785","fellowshipping",0,0,1,0,1
"13786","fellowworkers",1,0,0,0,1
"13787","fells",0,0,1,0,1
"13788","feminine",1,0,0,0,1
"13789","fencerailed",1,0,0,0,1
"13790","ferguson",0,1,0,0,1
"13791","ferret",0,1,0,0,1
"13792","ferreting",0,1,0,0,1
"13793","ferretting",1,0,0,0,1
"13794","ferrisburgh",1,0,0,0,1
"13795","fertilizer",0,0,0,1,1
"13796","fervently",1,0,0,0,1
"13797","fervid",1,0,0,0,1
"13798","fervor",0,1,0,0,1
"13799","festal",1,0,0,0,1
"13800","fester",0,1,0,0,1
"13801","festivals",1,0,0,0,1
"13802","fetched",0,1,0,0,1
"13803","fettering",0,0,1,0,1
"13804","feudal",0,0,0,1,1
"13805","feuds",1,0,0,0,1
"13806","fezed",0,0,0,1,1
"13807","fiat",0,1,0,0,1
"13808","fibre",0,1,0,0,1
"13809","fiction",1,0,0,0,1
"13810","fictitious",0,1,0,0,1
"13811","field”",1,0,0,0,1
"13812","fieldwork",1,0,0,0,1
"13813","fiend",1,0,0,0,1
"13814","fiercer",1,0,0,0,1
"13815","fiercest",1,0,0,0,1
"13816","fifthly",1,0,0,0,1
"13817","fiftysix",1,0,0,0,1
"13818","fight_",0,1,0,0,1
"13819","fight”",1,0,0,0,1
"13820","fightthe",1,0,0,0,1
"13821","figured",1,0,0,0,1
"13822","filial",0,1,0,0,1
"13823","finelyfeatured",1,0,0,0,1
"13824","finer",0,0,1,0,1
"13825","fingers”",1,0,0,0,1
"13826","fining",0,1,0,0,1
"13827","finishings",1,0,0,0,1
"13828","fip",1,0,0,0,1
"13829","fire”",1,0,0,0,1
"13830","fireproof",1,0,0,0,1
"13831","firewood",1,0,0,0,1
"13832","firing",1,0,0,0,1
"13833","firmament",1,0,0,0,1
"13834","first”",1,0,0,0,1
"13835","firtile",0,0,0,1,1
"13836","firtility",0,0,0,1,1
"13837","fisherman",0,0,0,1,1
"13838","fishes",0,1,0,0,1
"13839","fishingground",1,0,0,0,1
"13840","fishingtackle",1,0,0,0,1
"13841","fisted",0,1,0,0,1
"13842","fitful",1,0,0,0,1
"13843","fits",0,1,0,0,1
"13844","five ",0,0,0,1,1
"13845","fives",1,0,0,0,1
"13846","fix",0,1,0,0,1
"13847","flagcaused",1,0,0,0,1
"13848","flagellation",0,0,1,0,1
"13849","flail",1,0,0,0,1
"13850","flaming",0,1,0,0,1
"13851","flancked",0,0,0,1,1
"13852","flare",1,0,0,0,1
"13853","flashy",1,0,0,0,1
"13854","flasks",1,0,0,0,1
"13855","flatboat",1,0,0,0,1
"13856","flatter",0,1,0,0,1
"13857","flattered",1,0,0,0,1
"13858","fleeing",1,0,0,0,1
"13859","fleetest",0,1,0,0,1
"13860","flies",0,1,0,0,1
"13861","flirts",0,0,1,0,1
"13862","flocks",0,1,0,0,1
"13863","floggable",0,1,0,0,1
"13864","flogging”",1,0,0,0,1
"13865","floodgates",1,0,0,0,1
"13866","floods",0,1,0,0,1
"13867","floors",0,1,0,0,1
"13868","floorwhich",1,0,0,0,1
"13869","flourbarrel",1,0,0,0,1
"13870","flows",0,1,0,0,1
"13871","floyd",1,0,0,0,1
"13872","flunkeys",0,1,0,0,1
"13873","flunkies",1,0,0,0,1
"13874","foamcrested",1,0,0,0,1
"13875","fodder",0,0,1,0,1
"13876","folk",0,0,0,1,1
"13877","follower",0,1,0,0,1
"13878","footraces",1,0,0,0,1
"13879","foray",0,1,0,0,1
"13880","forcible",1,0,0,0,1
"13881","forcing",1,0,0,0,1
"13882","ford",1,0,0,0,1
"13883","fords",1,0,0,0,1
"13884","foreboding",0,1,0,0,1
"13885","forebodings",1,0,0,0,1
"13886","forecastledeck",1,0,0,0,1
"13887","foreheads",0,0,0,1,1
"13888","foreigner",0,1,0,0,1
"13889","foreigners",1,0,0,0,1
"13890","forenoon",0,0,0,1,1
"13891","foresight",1,0,0,0,1
"13892","foretop",1,0,0,0,1
"13893","forgetful",0,1,0,0,1
"13894","forging",1,0,0,0,1
"13895","forgiving",0,1,0,0,1
"13896","forgotlen",0,0,0,1,1
"13897","fork",0,1,0,0,1
"13898","form_",0,1,0,0,1
"13899","formerly”",1,0,0,0,1
"13900","forming",0,1,0,0,1
"13901","formly",0,0,0,1,1
"13902","formula",1,0,0,0,1
"13903","formulas",0,1,0,0,1
"13904","formulate",1,0,0,0,1
"13905","forsook",1,0,0,0,1
"13906","forster",1,0,0,0,1
"13907","fortification",1,0,0,0,1
"13908","fortifying",1,0,0,0,1
"13909","fortitude",1,0,0,0,1
"13910","fortress",1,0,0,0,1
"13911","fortune”",1,0,0,0,1
"13912","fortyfive",1,0,0,0,1
"13913","fortythree",1,0,0,0,1
"13914","forward”“",1,0,0,0,1
"13915","forwarded",1,0,0,0,1
"13916","forwarders",1,0,0,0,1
"13917","fosters",0,1,0,0,1
"13918","foulmouthed",1,0,0,0,1
"13919","fountain",0,1,0,0,1
"13920","fourfold",1,0,0,0,1
"13921","foward",0,0,0,1,1
"13922","foxes",1,0,0,0,1
"13923","fraction",0,1,0,0,1
"13924","fragant",0,1,0,0,1
"13925","fragile",0,1,0,0,1
"13926","fragrance",0,1,0,0,1
"13927","fragranceto",1,0,0,0,1
"13928","frail",0,1,0,0,1
"13929","frantic",1,0,0,0,1
"13930","fraternization",0,1,0,0,1
"13931","fraternize",1,0,0,0,1
"13932","fraught",1,0,0,0,1
"13933","freaks",0,1,0,0,1
"13934","fred”",1,0,0,0,1
"13935","freday",0,0,0,1,1
"13936","frederic",1,0,0,0,1
"13937","fredericksburg",1,0,0,0,1
"13938","free_",0,1,0,0,1
"13939","free”",1,0,0,0,1
"13940","freedom”rendered",1,0,0,0,1
"13941","freedomloving",1,0,0,0,1
"13942","freefrom",1,0,0,0,1
"13943","freeis",1,0,0,0,1
"13944","freeland’smy",1,0,0,0,1
"13945","freelandprisonbrutal",1,0,0,0,1
"13946","freeman_",0,1,0,0,1
"13947","freemanhaving",1,0,0,0,1
"13948","freeno",1,0,0,0,1
"13949","freesoilers",1,0,0,0,1
"13950","freest",0,1,0,0,1
"13951","freetrader",1,0,0,0,1
"13952","freeworking",1,0,0,0,1
"13953","freezing”",1,0,0,0,1
"13954","frémont",1,0,0,0,1
"13955","fremont’s",1,0,0,0,1
"13956","frenchman",1,0,0,0,1
"13957","frenzied",0,1,0,0,1
"13958","freshly",1,0,0,0,1
"13959","freshness",0,1,0,0,1
"13960","fresored",0,0,0,1,1
"13961","fretted",0,1,0,0,1
"13962","frienda",1,0,0,0,1
"13963","friendliness",0,0,1,0,1
"13964","friends”",1,0,0,0,1
"13965","friendsembracing",1,0,0,0,1
"13966","friendsfinal",1,0,0,0,1
"13967","friendssupport",1,0,0,0,1
"13968","frigate",1,0,0,0,1
"13969","frivolity",0,1,0,0,1
"13970","fro",1,0,0,0,1
"13971","frocked",0,0,0,1,1
"13972","fromage",0,0,0,1,1
"13973","fromwhat",1,0,0,0,1
"13974","frontier",1,0,0,0,1
"13975","frontispiece",1,0,0,0,1
"13976","frostiest",1,0,0,0,1
"13977","frowning",0,0,0,1,1
"13978","frowns",0,1,0,0,1
"13979","fruitful",1,0,0,0,1
"13980","fry",0,0,0,1,1
"13981","fulfilment",1,0,0,0,1
"13982","fullgrown",1,0,0,0,1
"13983","fulness",0,0,1,0,1
"13984","furore",1,0,0,0,1
"13985","fussell",1,0,0,0,1
"13986","futile",1,0,0,0,1
"13987","future”",1,0,0,0,1
"13988","futurea",1,0,0,0,1
"13989","g j",1,0,0,0,1
"13990","gage",1,0,0,0,1
"13991","gags",0,1,0,0,1
"13992","gainsay",0,1,0,0,1
"13993","gales",0,1,0,0,1
"13994","galion",0,0,0,1,1
"13995","gallileo",0,0,0,1,1
"13996","gamble",0,1,0,0,1
"13997","gambler",1,0,0,0,1
"13998","gamblers",0,1,0,0,1
"13999","games",0,1,0,0,1
"14000","gangs",0,1,0,0,1
"14001","gangway",1,0,0,0,1
"14002","garb",0,0,1,0,1
"14003","garfield’s",1,0,0,0,1
"14004","garfieldconcluding",1,0,0,0,1
"14005","garnered",1,0,0,0,1
"14006","garnetts",1,0,0,0,1
"14007","garret",0,1,0,0,1
"14008","garrets",1,0,0,0,1
"14009","garrisoning",1,0,0,0,1
"14010","garrisonism",0,1,0,0,1
"14011","gatea",1,0,0,0,1
"14012","gatebreaking",1,0,0,0,1
"14013","gathers",0,0,1,0,1
"14014","gauge",0,0,1,0,1
"14015","gauntsided",1,0,0,0,1
"14016","gazes",0,1,0,0,1
"14017","gear",0,0,0,1,1
"14018","gee",0,1,0,0,1
"14019","gehezeh",0,0,0,1,1
"14020","generala",1,0,0,0,1
"14021","generalizations",0,1,0,0,1
"14022","generals",1,0,0,0,1
"14023","generalship",1,0,0,0,1
"14024","generalties",0,1,0,0,1
"14025","generators",1,0,0,0,1
"14026","generis",1,0,0,0,1
"14027","geneva",1,0,0,0,1
"14028","genoa",0,1,0,0,1
"14029","genova",0,0,0,1,1
"14030","gentleman’s",1,0,0,0,1
"14031","gentlemeni",1,0,0,0,1
"14032","gentlest",0,1,0,0,1
"14033","gentlewomen",0,1,0,0,1
"14034","genuene",0,0,0,1,1
"14035","genus",0,0,0,1,1
"14036","geometry",0,1,0,0,1
"14037","georges",0,0,0,1,1
"14038","geoti",0,0,0,1,1
"14039","germany",0,1,0,0,1
"14040","germs",0,1,0,0,1
"14041","gether",0,0,0,1,1
"14042","gewgaws",0,0,1,0,1
"14043","ghezireh",0,0,0,1,1
"14044","ghost",1,0,0,0,1
"14045","giant",0,1,0,0,1
"14046","gibberish",0,0,1,0,1
"14047","gibsons",1,0,0,0,1
"14048","gid",1,0,0,0,1
"14049","gideon",1,0,0,0,1
"14050","gidion",0,0,0,1,1
"14051","gifford",1,0,0,0,1
"14052","gilds",0,1,0,0,1
"14053","gipsons",0,1,0,0,1
"14054","girlhood",1,0,0,0,1
"14055","girlnamely",1,0,0,0,1
"14056","give”",1,0,0,0,1
"14057","given“",1,0,0,0,1
"14058","givenas",1,0,0,0,1
"14059","givendescription",1,0,0,0,1
"14060","giver",0,1,0,0,1
"14061","gizeh",0,0,0,1,1
"14062","gladdened",0,0,1,0,1
"14063","gladdens",0,0,0,1,1
"14064","glared",1,0,0,0,1
"14065","glass",0,0,0,1,1
"14066","glasses",1,0,0,0,1
"14067","glazed",0,1,0,0,1
"14068","glean",1,0,0,0,1
"14069","gleaned",1,0,0,0,1
"14070","gleeful",1,0,0,0,1
"14071","glib",0,1,0,0,1
"14072","glidden",1,0,0,0,1
"14073","glided",0,1,0,0,1
"14074","glides",0,0,0,1,1
"14075","glimmer",1,0,0,0,1
"14076","glimps",0,0,0,1,1
"14077","glorifying",0,1,0,0,1
"14078","gloriouswhen",1,0,0,0,1
"14079","gloves",1,0,0,0,1
"14080","glowing",0,1,0,0,1
"14081","gluts",1,0,0,0,1
"14082","gnawing",0,1,0,0,1
"14083","go_",0,1,0,0,1
"14084","goat",0,1,0,0,1
"14085","goats",0,0,1,0,1
"14086","god”",1,0,0,0,1
"14087","godfearing",1,0,0,0,1
"14088","godwhen",1,0,0,0,1
"14089","godwin",1,0,0,0,1
"14090","gogo",1,0,0,0,1
"14091","goin",0,1,0,0,1
"14092","goin’",1,0,0,0,1
"14093","going ",0,0,0,1,1
"14094","goldboroughs",1,0,0,0,1
"14095","goldswept",1,0,0,0,1
"14096","gondolas",0,0,0,1,1
"14097","gonenearly",1,0,0,0,1
"14098","good”",1,0,0,0,1
"14099","goodhearted",1,0,0,0,1
"14100","goodman",1,0,0,0,1
"14101","goodto",1,0,0,0,1
"14102","goodwill",1,0,0,0,1
"14103","goold",1,0,0,0,1
"14104","goolds",1,0,0,0,1
"14105","gorehis",1,0,0,0,1
"14106","gorge",0,0,1,0,1
"14107","gorges",0,0,0,1,1
"14108","gorgiousness",0,0,0,1,1
"14109","gormandizers",0,1,0,0,1
"14110","goshen",0,0,0,1,1
"14111","goslin",1,0,0,0,1
"14112","gotten",1,0,0,0,1
"14113","gough",1,0,0,0,1
"14114","gourmandizer",1,0,0,0,1
"14115","governed",1,0,0,0,1
"14116","gowned",0,0,0,1,1
"14117","grades",1,0,0,0,1
"14118","graduallywe",1,0,0,0,1
"14119","grafting",0,1,0,0,1
"14120","grained",0,1,0,0,1
"14121","grammar",1,0,0,0,1
"14122","grandeurs",1,0,0,0,1
"14123","grandmammy’s",0,1,0,0,1
"14124","grandsonfinding",1,0,0,0,1
"14125","grant’s",1,0,0,0,1
"14126","grappling",1,0,0,0,1
"14127","grasps",0,1,0,0,1
"14128","grass",0,0,0,1,1
"14129","gratifiedand",1,0,0,0,1
"14130","gratings",1,0,0,0,1
"14131","gratuitous",1,0,0,0,1
"14132","gravehad",1,0,0,0,1
"14133","gravitation",0,1,0,0,1
"14134","grays",0,1,0,0,1
"14135","greated",0,0,0,1,1
"14136","greately",0,0,0,1,1
"14137","greatgrandmother",1,0,0,0,1
"14138","greatgreatgrandmother",1,0,0,0,1
"14139","greed",0,1,0,0,1
"14140","greediness",0,0,1,0,1
"14141","green”",1,0,0,0,1
"14142","greene",1,0,0,0,1
"14143","greenhouses",1,0,0,0,1
"14144","greenishgray",1,0,0,0,1
"14145","greenwich",1,0,0,0,1
"14146","greenwood",1,0,0,0,1
"14147","greided",0,0,0,1,1
"14148","gret",0,0,0,1,1
"14149","grey",0,1,0,0,1
"14150","grimke",1,0,0,0,1
"14151","grindstone”“come",1,0,0,0,1
"14152","grinnells",1,0,0,0,1
"14153","groaning",0,0,1,0,1
"14154","grope",0,1,0,0,1
"14155","grosser",1,0,0,0,1
"14156","grounded",0,1,0,0,1
"14157","groundlings”",1,0,0,0,1
"14158","group",1,0,0,0,1
"14159","groups",0,0,0,1,1
"14160","grudgingly",0,1,0,0,1
"14161","guess",1,0,0,0,1
"14162","guides",0,0,1,0,1
"14163","guiltiest",1,0,0,0,1
"14164","guilty”",1,0,0,0,1
"14165","guthrie",1,0,0,0,1
"14166","gutters",0,1,0,0,1
"14167","h w",1,0,0,0,1
"14168","habitual",1,0,0,0,1
"14169","hacked",1,0,0,0,1
"14170","hackman",1,0,0,0,1
"14171","hadalthough",1,0,0,0,1
"14172","hadaway",0,1,0,0,1
"14173","hadmost",1,0,0,0,1
"14174","hailing",0,0,1,0,1
"14175","hair”",1,0,0,0,1
"14176","haiti",0,0,1,0,1
"14177","halfbrother",1,0,0,0,1
"14178","halfbushel",1,0,0,0,1
"14179","halfpast",1,0,0,0,1
"14180","halfstarved",1,0,0,0,1
"14181","hall”",1,0,0,0,1
"14182","halla",1,0,0,0,1
"14183","hallelujahs",0,1,0,0,1
"14184","hallooing",1,0,0,0,1
"14185","hallowed",0,1,0,0,1
"14186","hallside",1,0,0,0,1
"14187","hallthe",1,0,0,0,1
"14188","halo",1,0,0,0,1
"14189","hamlin",1,0,0,0,1
"14190","hammered",1,0,0,0,1
"14191","hampshiresweet",1,0,0,0,1
"14192","hams",0,1,0,0,1
"14193","handcuffs",1,0,0,0,1
"14194","handsome",0,1,0,0,1
"14195","handspikes",0,0,1,0,1
"14196","hanged_",0,1,0,0,1
"14197","hapless",0,1,0,0,1
"14198","happens",1,0,0,0,1
"14199","harass",1,0,0,0,1
"14200","harassing",0,1,0,0,1
"14201","harboring",1,0,0,0,1
"14202","hard”",1,0,0,0,1
"14203","hardhearted",1,0,0,0,1
"14204","hardheartedness",1,0,0,0,1
"14205","hardlyearned",1,0,0,0,1
"14206","hardywho",1,0,0,0,1
"14207","hares",0,0,1,0,1
"14208","harmful",1,0,0,0,1
"14209","harmonious",0,1,0,0,1
"14210","harnessing",1,0,0,0,1
"14211","harper’sferryinsurrectiontest",1,0,0,0,1
"14212","harps",0,1,0,0,1
"14213","harrisonto",1,0,0,0,1
"14214","harrowed",0,1,0,0,1
"14215","harry’s",0,1,0,0,1
"14216","harshness",1,0,0,0,1
"14217","hart",0,1,0,0,1
"14218","harvard",1,0,0,0,1
"14219","harvesttime",1,0,0,0,1
"14220","hassen",0,0,0,1,1
"14221","hastening",0,0,1,0,1
"14222","hatch",0,1,0,0,1
"14223","hatched",1,0,0,0,1
"14224","hatchway",0,1,0,0,1
"14225","hatefor",1,0,0,0,1
"14226","hatefulness",0,1,0,0,1
"14227","hater",1,0,0,0,1
"14228","hateth",0,1,0,0,1
"14229","haul",1,0,0,0,1
"14230","hauled",1,0,0,0,1
"14231","hauling",0,1,0,0,1
"14232","haunt",1,0,0,0,1
"14233","haunts",0,1,0,0,1
"14234","hav",0,0,0,1,1
"14235","havingof",1,0,0,0,1
"14236","havn’t",0,1,0,0,1
"14237","haywood’s",0,1,0,0,1
"14238","haze",1,0,0,0,1
"14239","he’d",0,1,0,0,1
"14240","he’s",0,1,0,0,1
"14241","headlong",0,0,0,1,1
"14242","heads”",1,0,0,0,1
"14243","headship",1,0,0,0,1
"14244","headstone",0,0,0,1,1
"14245","headstrong",1,0,0,0,1
"14246","healthier",0,0,1,0,1
"14247","healthseeking",1,0,0,0,1
"14248","heand",1,0,0,0,1
"14249","heap",0,1,0,0,1
"14250","heap”",1,0,0,0,1
"14251","hear”",1,0,0,0,1
"14252","heards",0,0,0,1,1
"14253","hearer",1,0,0,0,1
"14254","heart’",1,0,0,0,1
"14255","heartbreaking",0,0,0,1,1
"14256","heartedness",0,1,0,0,1
"14257","hearthstone",1,0,0,0,1
"14258","hearthstones",1,0,0,0,1
"14259","heartily",1,0,0,0,1
"14260","heartiness",1,0,0,0,1
"14261","heartlessness",0,1,0,0,1
"14262","heartrending",1,0,0,0,1
"14263","heartsaddening",1,0,0,0,1
"14264","heartsearching",1,0,0,0,1
"14265","heartthe",1,0,0,0,1
"14266","heave",0,1,0,0,1
"14267","heavers",0,1,0,0,1
"14268","heaviest",0,1,0,0,1
"14269","hebrews",1,0,0,0,1
"14270","hebrewsince",1,0,0,0,1
"14271","hectoring",0,0,1,0,1
"14272","hedge",0,1,0,0,1
"14273","hedged",1,0,0,0,1
"14274","hedges",1,0,0,0,1
"14275","heir",1,0,0,0,1
"14276","helmsley’s",1,0,0,0,1
"14277","helper",1,0,0,0,1
"14278","helpmate",0,1,0,0,1
"14279","helps",1,0,0,0,1
"14280","hemisphere",0,1,0,0,1
"14281","hemsley’s",0,1,0,0,1
"14282","henhouses",1,0,0,0,1
"14283","henrys",0,0,1,0,1
"14284","henshaws",1,0,0,0,1
"14285","her’s",0,1,0,0,1
"14286","heralded",1,0,0,0,1
"14287","herbs",1,0,0,0,1
"14288","herculanium",0,0,0,1,1
"14289","here’s",0,1,0,0,1
"14290","hereford",0,0,0,1,1
"14291","heresies",1,0,0,0,1
"14292","heresy",1,0,0,0,1
"14293","heritage",1,0,0,0,1
"14294","hern",1,0,0,0,1
"14295","heroically",1,0,0,0,1
"14296","heroism",0,0,0,1,1
"14297","heroworshiper",1,0,0,0,1
"14298","herrculeesium",0,0,0,1,1
"14299","hesitancy",0,0,1,0,1
"14300","hesitatingly",1,0,0,0,1
"14301","hewers",1,0,0,0,1
"14302","hicks’",1,0,0,0,1
"14303","hidingplace",1,0,0,0,1
"14304","highligted",0,0,0,1,1
"14305","highlyfavored",1,0,0,0,1
"14306","highlyprized",1,0,0,0,1
"14307","hight",0,0,0,1,1
"14308","hightreason",1,0,0,0,1
"14309","highwayfirmly",1,0,0,0,1
"14310","hileopolis",0,0,0,1,1
"14311","hilles’",1,0,0,0,1
"14312","hillsboro",0,1,0,0,1
"14313","hillside",0,1,0,0,1
"14314","hilping",0,0,0,1,1
"14315","him_",0,1,0,0,1
"14316","himas",1,0,0,0,1
"14317","himbut",1,0,0,0,1
"14318","himhis",1,0,0,0,1
"14319","himselfcertainly",1,0,0,0,1
"14320","himselfhe",1,0,0,0,1
"14321","himtake",1,0,0,0,1
"14322","himthere",1,0,0,0,1
"14323","hinders",1,0,0,0,1
"14324","hindrances",1,0,0,0,1
"14325","hinted",1,0,0,0,1
"14326","hiram",1,0,0,0,1
"14327","hiredman",0,1,0,0,1
"14328","hirelings",1,0,0,0,1
"14329","hissing",1,0,0,0,1
"14330","historian’s",1,0,0,0,1
"14331","historic",1,0,0,0,1
"14332","hither",1,0,0,0,1
"14333","hitting",1,0,0,0,1
"14334","hive",1,0,0,0,1
"14335","hoary",0,0,0,1,1
"14336","hodges",1,0,0,0,1
"14337","hoe_",0,1,0,0,1
"14338","hoeded",0,0,0,1,1
"14339","holders",0,1,0,0,1
"14340","holiday’s",0,1,0,0,1
"14341","hollowness",0,0,0,1,1
"14342","holly",1,0,0,0,1
"14343","hols",0,0,0,1,1
"14344","home“",1,0,0,0,1
"14345","homefarm",1,0,0,0,1
"14346","homelike",1,0,0,0,1
"14347","homeliness",1,0,0,0,1
"14348","hominy",1,0,0,0,1
"14349","hood’s",0,1,0,0,1
"14350","hooded",0,0,0,1,1
"14351","hooks",0,1,0,0,1
"14352","hooted",1,0,0,0,1
"14353","hope”",1,0,0,0,1
"14354","hoped”",1,0,0,0,1
"14355","hopessuspicionsthe",1,0,0,0,1
"14356","horsebreakers",1,0,0,0,1
"14357","horsejockey",1,0,0,0,1
"14358","horseman",1,0,0,0,1
"14359","horses’",1,0,0,0,1
"14360","horsesslave",1,0,0,0,1
"14361","horsesslavetradersalone",1,0,0,0,1
"14362","horsewhip",1,0,0,0,1
"14363","hospitable",1,0,0,0,1
"14364","hospitalityentertainments",1,0,0,0,1
"14365","hospitalitygracious",1,0,0,0,1
"14366","hotbed",1,0,0,0,1
"14367","hoteli",1,0,0,0,1
"14368","hour”",1,0,0,0,1
"14369","hours’",1,0,0,0,1
"14370","houseburning",1,0,0,0,1
"14371","housefamily",1,0,0,0,1
"14372","houseless",0,0,1,0,1
"14373","houseservant",1,0,0,0,1
"14374","houseservants",1,0,0,0,1
"14375","hovel",0,1,0,0,1
"14376","hovels",0,1,0,0,1
"14377","hover",0,0,1,0,1
"14378","howitts",1,0,0,0,1
"14379","howl",1,0,0,0,1
"14380","howland’s",1,0,0,0,1
"14381","howled",1,0,0,0,1
"14382","howsoever",0,1,0,0,1
"14383","hug",0,0,1,0,1
"14384","hughslavery",1,0,0,0,1
"14385","hulda",1,0,0,0,1
"14386","humane”",1,0,0,0,1
"14387","humanizing",0,0,1,0,1
"14388","humbert",0,0,0,1,1
"14389","humiliated",1,0,0,0,1
"14390","humorous",1,0,0,0,1
"14391","humphry",0,0,1,0,1
"14392","hungarian",0,1,0,0,1
"14393","hungersmitten",1,0,0,0,1
"14394","hungry”",1,0,0,0,1
"14395","hunkers",0,1,0,0,1
"14396","hurlburt",1,0,0,0,1
"14397","hurries",0,1,0,0,1
"14398","hurtful",1,0,0,0,1
"14399","husband’s",0,0,1,0,1
"14400","hutchinsonsjudson",1,0,0,0,1
"14401","hyatt",1,0,0,0,1
"14402","hyde",0,0,0,1,1
"14403","hydra",0,1,0,0,1
"14404","hydropathy",0,1,0,0,1
"14405","hymnbook",1,0,0,0,1
"14406","hyper",0,1,0,0,1
"14407","ice",0,1,0,0,1
"14408","iches",0,0,0,1,1
"14409","ideathough",1,0,0,0,1
"14410","identical",0,1,0,0,1
"14411","identification",1,0,0,0,1
"14412","identifying",0,1,0,0,1
"14413","idler",0,1,0,0,1
"14414","idlers",0,0,0,1,1
"14415","idly",0,0,1,0,1
"14416","idols",0,1,0,0,1
"14417","ignoramus",1,0,0,0,1
"14418","ignoring",1,0,0,0,1
"14419","illadvised",1,0,0,0,1
"14420","illarranged",1,0,0,0,1
"14421","illegal",0,0,1,0,1
"14422","illegality",0,1,0,0,1
"14423","illescapes",1,0,0,0,1
"14424","illfated",1,0,0,0,1
"14425","illfeeling",1,0,0,0,1
"14426","illiberality",0,0,1,0,1
"14427","illimitable",0,1,0,0,1
"14428","illinois”",1,0,0,0,1
"14429","illiterate",0,1,0,0,1
"14430","illogical",1,0,0,0,1
"14431","illshapen",1,0,0,0,1
"14432","illtempered",1,0,0,0,1
"14433","illtimed",1,0,0,0,1
"14434","illuminated",0,1,0,0,1
"14435","illumined",1,0,0,0,1
"14436","imagenation",0,0,0,1,1
"14437","imagery",0,1,0,0,1
"14438","images",0,0,0,1,1
"14439","imaginary",0,1,0,0,1
"14440","imbrute",0,1,0,0,1
"14441","imitated",1,0,0,0,1
"14442","imitates",0,1,0,0,1
"14443","imitator",0,0,1,0,1
"14444","immensely",0,1,0,0,1
"14445","immensily",0,0,0,1,1
"14446","immortality",0,1,0,0,1
"14447","immortalize",0,1,0,0,1
"14448","immoveable",0,1,0,0,1
"14449","immunity",1,0,0,0,1
"14450","immutable",0,0,1,0,1
"14451","impared",0,0,0,1,1
"14452","impartment",0,1,0,0,1
"14453","impassioned",0,1,0,0,1
"14454","impeachment",1,0,0,0,1
"14455","impelled",0,1,0,0,1
"14456","impels",0,0,1,0,1
"14457","impenetrable",1,0,0,0,1
"14458","imperatively",1,0,0,0,1
"14459","imperfections",0,1,0,0,1
"14460","imperial",0,1,0,0,1
"14461","imperishable",1,0,0,0,1
"14462","impertinent",0,0,1,0,1
"14463","impiety",0,1,0,0,1
"14464","implement",0,1,0,0,1
"14465","implicate",0,1,0,0,1
"14466","implicitly",0,1,0,0,1
"14467","impliedly",1,0,0,0,1
"14468","implies",1,0,0,0,1
"14469","implored",1,0,0,0,1
"14470","imploring",1,0,0,0,1
"14471","imploringly",0,1,0,0,1
"14472","imployed",0,0,0,1,1
"14473","importunate",0,0,0,1,1
"14474","imposingly",0,0,0,1,1
"14475","impossibility",0,0,1,0,1
"14476","impossiblenow",1,0,0,0,1
"14477","impotency",1,0,0,0,1
"14478","impotent",0,1,0,0,1
"14479","impracticability",1,0,0,0,1
"14480","impregnate",0,1,0,0,1
"14481","imprints",0,1,0,0,1
"14482","improbable",1,0,0,0,1
"14483","improper",0,0,1,0,1
"14484","improves",0,1,0,0,1
"14485","improvises",0,1,0,0,1
"14486","improvising",0,1,0,0,1
"14487","imprudence",1,0,0,0,1
"14488","imprudent",0,0,1,0,1
"14489","impulses",1,0,0,0,1
"14490","imputed",1,0,0,0,1
"14491","inaction",1,0,0,0,1
"14492","inactivity",1,0,0,0,1
"14493","inadmissible",1,0,0,0,1
"14494","inanimate",0,0,1,0,1
"14495","inapplicable",0,1,0,0,1
"14496","inaptly",1,0,0,0,1
"14497","incantations",0,0,0,1,1
"14498","incapacity",1,0,0,0,1
"14499","incarnation",0,1,0,0,1
"14500","incensed",1,0,0,0,1
"14501","incessantly",0,1,0,0,1
"14502","incest",0,0,1,0,1
"14503","incidentexpressed",1,0,0,0,1
"14504","incipient",0,1,0,0,1
"14505","inclinations",1,0,0,0,1
"14506","inclosure",0,1,0,0,1
"14507","include",0,1,0,0,1
"14508","incompany",0,0,0,1,1
"14509","incomparable",0,1,0,0,1
"14510","incomprehensibility",1,0,0,0,1
"14511","incomprehensible",0,1,0,0,1
"14512","incongruities",0,1,0,0,1
"14513","incongruous",0,1,0,0,1
"14514","inconsistency",0,0,1,0,1
"14515","incontinently",0,1,0,0,1
"14516","inconvenience",1,0,0,0,1
"14517","inconveniently",0,1,0,0,1
"14518","incorporation",1,0,0,0,1
"14519","increases",1,0,0,0,1
"14520","increasingliberty",1,0,0,0,1
"14521","increasinglibertysingingsadnessunhappiness",1,0,0,0,1
"14522","incredibly",1,0,0,0,1
"14523","incredulity",0,0,1,0,1
"14524","incredulous",0,0,1,0,1
"14525","incrustation",0,1,0,0,1
"14526","inculpating",1,0,0,0,1
"14527","incurable",1,0,0,0,1
"14528","ind",0,0,0,1,1
"14529","indefinitely",0,0,0,1,1
"14530","indescribably",0,1,0,0,1
"14531","index",1,0,0,0,1
"14532","indian”",1,0,0,0,1
"14533","indicates",1,0,0,0,1
"14534","indignatory",0,1,0,0,1
"14535","indirectly",0,1,0,0,1
"14536","indiscretion",1,0,0,0,1
"14537","indiscriminate",1,0,0,0,1
"14538","indispensably",0,1,0,0,1
"14539","indisposition",1,0,0,0,1
"14540","indisputable",1,0,0,0,1
"14541","induction",0,1,0,0,1
"14542","ineffaceable",0,1,0,0,1
"14543","inefficient",0,1,0,0,1
"14544","inexcusable",0,1,0,0,1
"14545","inexhaustible",1,0,0,0,1
"14546","inexorable",0,1,0,0,1
"14547","inextricable",0,1,0,0,1
"14548","infallible",0,1,0,0,1
"14549","infamously",1,0,0,0,1
"14550","infatuation",1,0,0,0,1
"14551","infected",1,0,0,0,1
"14552","inference",1,0,0,0,1
"14553","inferiors",0,1,0,0,1
"14554","infest",0,1,0,0,1
"14555","infidel",0,0,1,0,1
"14556","infidelity",0,1,0,0,1
"14557","infidels",0,1,0,0,1
"14558","infirmities",0,1,0,0,1
"14559","inflame",1,0,0,0,1
"14560","inflated",1,0,0,0,1
"14561","influence”",1,0,0,0,1
"14562","informer",1,0,0,0,1
"14563","infuse",1,0,0,0,1
"14564","ingersoll”",1,0,0,0,1
"14565","ingersollreflections",1,0,0,0,1
"14566","ingorsol",0,0,0,1,1
"14567","inhabit",0,1,0,0,1
"14568","inhabitant",1,0,0,0,1
"14569","inhabitantsgenealogical",1,0,0,0,1
"14570","inhabiting",0,1,0,0,1
"14571","inhale",0,1,0,0,1
"14572","inheritancehis",1,0,0,0,1
"14573","inimical",1,0,0,0,1
"14574","inimitable",1,0,0,0,1
"14575","iniquitous",1,0,0,0,1
"14576","initiate",1,0,0,0,1
"14577","injudicious",1,0,0,0,1
"14578","inoffensive",1,0,0,0,1
"14579","inopportune",1,0,0,0,1
"14580","inquistion",0,0,0,1,1
"14581","insatiable",1,0,0,0,1
"14582","inscribe",0,0,1,0,1
"14583","insincere",0,0,0,1,1
"14584","insinuations",1,0,0,0,1
"14585","insist",0,0,1,0,1
"14586","insisting",1,0,0,0,1
"14587","insolence",0,1,0,0,1
"14588","insolvency",1,0,0,0,1
"14589","insolvent",1,0,0,0,1
"14590","inspector",1,0,0,0,1
"14591","instinctive",1,0,0,0,1
"14592","institution_",0,0,1,0,1
"14593","institutions_",0,1,0,0,1
"14594","insubordination",1,0,0,0,1
"14595","insufferable",1,0,0,0,1
"14596","insufficiency",1,0,0,0,1
"14597","insufficiently",1,0,0,0,1
"14598","insurgentsthat",1,0,0,0,1
"14599","insurrectionary",0,1,0,0,1
"14600","insurrectioncholerareligion",1,0,0,0,1
"14601","insurrectioncholerareligionmethodist",1,0,0,0,1
"14602","insurrections",0,1,0,0,1
"14603","intact",1,0,0,0,1
"14604","intellection",0,1,0,0,1
"14605","intellectuality",1,0,0,0,1
"14606","intellectually",1,0,0,0,1
"14607","intelligible",0,1,0,0,1
"14608","intemated",0,0,0,1,1
"14609","intends",0,1,0,0,1
"14610","intentional",1,0,0,0,1
"14611","intently",1,0,0,0,1
"14612","intercepted",0,0,1,0,1
"14613","intereor",0,0,0,1,1
"14614","interests”",1,0,0,0,1
"14615","interjection",0,0,0,1,1
"14616","interlinked",0,0,1,0,1
"14617","intermeddlers",1,0,0,0,1
"14618","interminable",1,0,0,0,1
"14619","interned",0,0,0,1,1
"14620","interposing",1,0,0,0,1
"14621","interred",0,0,0,1,1
"14622","interrogate",1,0,0,0,1
"14623","interrupt”",1,0,0,0,1
"14624","interrupted",1,0,0,0,1
"14625","interrupting",1,0,0,0,1
"14626","interspersed",0,1,0,0,1
"14627","intervention",0,1,0,0,1
"14628","interwoven",0,1,0,0,1
"14629","intimations",1,0,0,0,1
"14630","intolerably",1,0,0,0,1
"14631","intoxicated",1,0,0,0,1
"14632","intrenchments",1,0,0,0,1
"14633","introdnced",0,0,0,1,1
"14634","introductions",1,0,0,0,1
"14635","intuitive",0,1,0,0,1
"14636","inured",1,0,0,0,1
"14637","invade",0,1,0,0,1
"14638","invaded",1,0,0,0,1
"14639","invalidated",0,1,0,0,1
"14640","invaluable",0,0,1,0,1
"14641","invasions",0,1,0,0,1
"14642","invectives",1,0,0,0,1
"14643","invented",1,0,0,0,1
"14644","inventors",1,0,0,0,1
"14645","investment",1,0,0,0,1
"14646","invitations",1,0,0,0,1
"14647","invites",1,0,0,0,1
"14648","inwardly",1,0,0,0,1
"14649","ione",1,0,0,0,1
"14650","ira",0,1,0,0,1
"14651","ireland”",1,0,0,0,1
"14652","ireson",1,0,0,0,1
"14653","irishamerican",1,0,0,0,1
"14654","ironclad",1,0,0,0,1
"14655","ironsexperiences",1,0,0,0,1
"14656","irrational",0,1,0,0,1
"14657","irrefutable",0,1,0,0,1
"14658","irrespective",1,0,0,0,1
"14659","isaac’s",0,1,0,0,1
"14660","isabella",0,0,0,1,1
"14661","isaiah",1,0,0,0,1
"14662","islands",0,1,0,0,1
"14663","isles",1,0,0,0,1
"14664","ismaila",0,0,0,1,1
"14665","israel’s",0,0,1,0,1
"14666","israelitish",1,0,0,0,1
"14667","issac",0,1,0,0,1
"14668","ita",1,0,0,0,1
"14669","italian",0,0,0,1,1
"14670","items",1,0,0,0,1
"14671","itself_",0,1,0,0,1
"14672","itselfa",1,0,0,0,1
"14673","itselfand",1,0,0,0,1
"14674","itselffor",1,0,0,0,1
"14675","itselfhis",1,0,0,0,1
"14676","itthose",1,0,0,0,1
"14677","itwas",1,0,0,0,1
"14678","ivy",1,0,0,0,1
"14679","j ",1,0,0,0,1
"14680","j d",1,0,0,0,1
"14681","j h",1,0,0,0,1
"14682","j p",1,0,0,0,1
"14683","j r",1,0,0,0,1
"14684","j s",1,0,0,0,1
"14685","j w c",1,0,0,0,1
"14686","jack’s",0,1,0,0,1
"14687","jackknife",1,0,0,0,1
"14688","jacks",0,1,0,0,1
"14689","jailneat",1,0,0,0,1
"14690","jake”",1,0,0,0,1
"14691","jamaica",1,0,0,0,1
"14692","jane",1,0,0,0,1
"14693","janu",0,0,0,1,1
"14694","jarring",0,1,0,0,1
"14695","jars",0,0,0,1,1
"14696","jeer",1,0,0,0,1
"14697","jeff",1,0,0,0,1
"14698","jehial",1,0,0,0,1
"14699","jehovah",1,0,0,0,1
"14700","jenny",0,1,0,0,1
"14701","jeopardy",1,0,0,0,1
"14702","jeremiah",1,0,0,0,1
"14703","jew",1,0,0,0,1
"14704","jewelled",0,0,0,1,1
"14705","jewish",0,0,0,1,1
"14706","jews",1,0,0,0,1
"14707","jims",0,1,0,0,1
"14708","jinny",0,1,0,0,1
"14709","jobbers",0,1,0,0,1
"14710","joe",0,0,0,1,1
"14711","john’s",1,0,0,0,1
"14712","johns",0,0,0,1,1
"14713","johnsonpresidential",1,0,0,0,1
"14714","johnston",1,0,0,0,1
"14715","jostle",1,0,0,0,1
"14716","jostling",0,0,0,1,1
"14717","jot",1,0,0,0,1
"14718","journal_",0,1,0,0,1
"14719","journeying",1,0,0,0,1
"14720","journeys",0,0,1,0,1
"14721","jr",0,0,1,0,1
"14722","juba",0,1,0,0,1
"14723","jubilant",0,1,0,0,1
"14724","judged",1,0,0,0,1
"14725","juicy",0,1,0,0,1
"14726","julian",1,0,0,0,1
"14727","jump",1,0,0,0,1
"14728","jumping",0,0,0,1,1
"14729","jungles",1,0,0,0,1
"14730","jupiter",0,0,0,1,1
"14731","jurors",1,0,0,0,1
"14732","jurybox",1,0,0,0,1
"14733","juryman",1,0,0,0,1
"14734","jurymen",1,0,0,0,1
"14735","just_",0,1,0,0,1
"14736","justfy",0,1,0,0,1
"14737","kansas”",1,0,0,0,1
"14738","keat",1,0,0,0,1
"14739","keenest",0,1,0,0,1
"14740","keeps",1,0,0,0,1
"14741","keltons",1,0,0,0,1
"14742","kemp’s",0,0,1,0,1
"14743","kent",0,1,0,0,1
"14744","kentuckians",1,0,0,0,1
"14745","kenyon",1,0,0,0,1
"14746","keynote",1,0,0,0,1
"14747","kid",1,0,0,0,1
"14748","kidnapper",0,0,1,0,1
"14749","kidnapper’s",0,0,1,0,1
"14750","killed”",1,0,0,0,1
"14751","kills",0,1,0,0,1
"14752","kin",0,1,0,0,1
"14753","kinder",0,0,1,0,1
"14754","kindest",0,0,1,0,1
"14755","kindliness",0,0,1,0,1
"14756","kindnesses",1,0,0,0,1
"14757","kingly",0,0,0,1,1
"14758","kings",0,0,0,1,1
"14759","kinney",0,1,0,0,1
"14760","kinsfolk",1,0,0,0,1
"14761","kinsman",1,0,0,0,1
"14762","kinsmone",0,0,0,1,1
"14763","kiss",1,0,0,0,1
"14764","kissed",1,0,0,0,1
"14765","kissid",0,0,0,1,1
"14766","kneeled",1,0,0,0,1
"14767","kneelingplace",1,0,0,0,1
"14768","knees”",1,0,0,0,1
"14769","knibb",1,0,0,0,1
"14770","knit",1,0,0,0,1
"14771","knitting",0,1,0,0,1
"14772","knockdown",1,0,0,0,1
"14773","knot",0,1,0,0,1
"14774","knotted",0,1,0,0,1
"14775","knoweth",0,0,1,0,1
"14776","knowledgeto",1,0,0,0,1
"14777","knoxville",1,0,0,0,1
"14778","korall",0,0,0,1,1
"14779","l p",1,0,0,0,1
"14780","l’outrance_",0,1,0,0,1
"14781","l’overture",1,0,0,0,1
"14782","labelled",0,0,1,0,1
"14783","lable",0,0,0,1,1
"14784","labor”",1,0,0,0,1
"14785","laboriously",1,0,0,0,1
"14786","labormarket",1,0,0,0,1
"14787","laboroutragetestimony",1,0,0,0,1
"14788","laboroutragetestimonymaster",1,0,0,0,1
"14789","labrador",1,0,0,0,1
"14790","lacerations",0,1,0,0,1
"14791","lady’s",1,0,0,0,1
"14792","ladymrs",1,0,0,0,1
"14793","lag",1,0,0,0,1
"14794","lake”",1,0,0,0,1
"14795","lamb”",1,0,0,0,1
"14796","lamblike",0,0,1,0,1
"14797","lament",0,1,0,0,1
"14798","lamenting",0,1,0,0,1
"14799","lamest",0,1,0,0,1
"14800","lamp",1,0,0,0,1
"14801","lancaster",1,0,0,0,1
"14802","lance",0,1,0,0,1
"14803","land_",0,0,1,0,1
"14804","landa",1,0,0,0,1
"14805","landless",1,0,0,0,1
"14806","landowners",1,0,0,0,1
"14807","landscape",0,0,0,1,1
"14808","landslides",0,0,0,1,1
"14809","laps",0,0,0,1,1
"14810","larder",1,0,0,0,1
"14811","lashing",0,0,1,0,1
"14812","last”",1,0,0,0,1
"14813","lasted",1,0,0,0,1
"14814","lastnamed",1,0,0,0,1
"14815","lasts”",1,0,0,0,1
"14816","late ",0,0,0,1,1
"14817","late_",0,1,0,0,1
"14818","latest",1,0,0,0,1
"14819","latham",1,0,0,0,1
"14820","latter’s",0,1,0,0,1
"14821","laughable",1,0,0,0,1
"14822","laught",0,0,0,1,1
"14823","laughter",0,0,0,1,1
"14824","lausanne",0,0,0,1,1
"14825","laut",1,0,0,0,1
"14826","lava",0,0,0,1,1
"14827","lawgiver",1,0,0,0,1
"14828","lawrence",1,0,0,0,1
"14829","lawyer",0,1,0,0,1
"14830","lawyer’s",1,0,0,0,1
"14831","lawyer”",1,0,0,0,1
"14832","lax",0,0,1,0,1
"14833","layers",0,1,0,0,1
"14834","lays",0,1,0,0,1
"14835","lazerrus",0,0,0,1,1
"14836","laziest",1,0,0,0,1
"14837","leaguethe",1,0,0,0,1
"14838","leaning ",0,0,0,1,1
"14839","leaped",0,1,0,0,1
"14840","lear”",1,0,0,0,1
"14841","learned”",1,0,0,0,1
"14842","learner",1,0,0,0,1
"14843","learningit",1,0,0,0,1
"14844","leas",0,1,0,0,1
"14845","lease",1,0,0,0,1
"14846","leased",0,1,0,0,1
"14847","leasure",0,0,0,1,1
"14848","ledger_",0,1,0,0,1
"14849","legalized",0,0,1,0,1
"14850","legalizing",1,0,0,0,1
"14851","legion",0,1,0,0,1
"14852","legislate",1,0,0,0,1
"14853","legislator",1,0,0,0,1
"14854","legislators",1,0,0,0,1
"14855","legitimately",1,0,0,0,1
"14856","legless",1,0,0,0,1
"14857","legree",1,0,0,0,1
"14858","lemoyne",1,0,0,0,1
"14859","lender",1,0,0,0,1
"14860","leniency",1,0,0,0,1
"14861","lenore",0,0,0,1,1
"14862","lenox",0,0,1,0,1
"14863","lespenard",0,0,1,0,1
"14864","lespremonts",0,0,0,1,1
"14865","lessened",0,1,0,0,1
"14866","lettered",0,1,0,0,1
"14867","levees",1,0,0,0,1
"14868","leveled",1,0,0,0,1
"14869","leveler",1,0,0,0,1
"14870","levity",1,0,0,0,1
"14871","liberalize",1,0,0,0,1
"14872","liberator”",1,0,0,0,1
"14873","liberia",1,0,0,0,1
"14874","libraries",1,0,0,0,1
"14875","libyan",0,0,0,1,1
"14876","licentious",1,0,0,0,1
"14877","licentiousness",0,1,0,0,1
"14878","lien",0,1,0,0,1
"14879","lieutenant",0,1,0,0,1
"14880","lieutenantgovernor",1,0,0,0,1
"14881","life’s",1,0,0,0,1
"14882","lifeblood",1,0,0,0,1
"14883","lifeconstant",1,0,0,0,1
"14884","lifegiving",1,0,0,0,1
"14885","lifenecessaries",1,0,0,0,1
"14886","lifeslaveholder",1,0,0,0,1
"14887","liffey",0,1,0,0,1
"14888","lightcolored",1,0,0,0,1
"14889","lightened",1,0,0,0,1
"14890","lightness",0,1,0,0,1
"14891","lightning”",1,0,0,0,1
"14892","limbstook",1,0,0,0,1
"14893","limitation",1,0,0,0,1
"14894","limiting",1,0,0,0,1
"14895","limitless",1,0,0,0,1
"14896","linar",0,0,0,1,1
"14897","lincoln”",1,0,0,0,1
"14898","lincolnhis",1,0,0,0,1
"14899","lineaments",1,0,0,0,1
"14900","lines”",1,0,0,0,1
"14901","linger",1,0,0,0,1
"14902","lingers",1,0,0,0,1
"14903","links",1,0,0,0,1
"14904","lion’s",0,0,1,0,1
"14905","lions”",1,0,0,0,1
"14906","lisp",0,0,1,0,1
"14907","lisped",1,0,0,0,1
"14908","lispenard",1,0,0,0,1
"14909","lisps",0,1,0,0,1
"14910","listeners",1,0,0,0,1
"14911","lithe",0,1,0,0,1
"14912","littlei",1,0,0,0,1
"14913","littlesandy",1,0,0,0,1
"14914","live”",1,0,0,0,1
"14915","lived”",1,0,0,0,1
"14916","liveliest",0,0,1,0,1
"14917","livened",0,0,0,1,1
"14918","liveth",1,0,0,0,1
"14919","lloyda",1,0,0,0,1
"14920","lloydi",1,0,0,0,1
"14921","lo",0,1,0,0,1
"14922","loads",0,1,0,0,1
"14923","loafers",1,0,0,0,1
"14924","loan",1,0,0,0,1
"14925","loathe",0,1,0,0,1
"14926","loaves",0,1,0,0,1
"14927","localization",1,0,0,0,1
"14928","locomotion",0,1,0,0,1
"14929","locomotive",1,0,0,0,1
"14930","lodgings",0,0,0,1,1
"14931","loftier",1,0,0,0,1
"14932","lombardy",1,0,0,0,1
"14933","longabused",1,0,0,0,1
"14934","longcowed",1,0,0,0,1
"14935","longe",0,1,0,0,1
"14936","longenslaved",1,0,0,0,1
"14937","longer_",0,1,0,0,1
"14938","longer”",1,0,0,0,1
"14939","longetude",0,0,0,1,1
"14940","longhopedfor",1,0,0,0,1
"14941","longlegged",1,0,0,0,1
"14942","longneglected",1,0,0,0,1
"14943","longston",1,0,0,0,1
"14944","lookers",1,0,0,0,1
"14945","lords",0,1,0,0,1
"14946","loring",1,0,0,0,1
"14947","losses",1,0,0,0,1
"14948","lossing",1,0,0,0,1
"14949","louden",0,0,1,0,1
"14950","loudest",1,0,0,0,1
"14951","louisa",1,0,0,0,1
"14952","lounger",0,1,0,0,1
"14953","lovejoy",1,0,0,0,1
"14954","lover",1,0,0,0,1
"14955","lovingly",1,0,0,0,1
"14956","low_",0,1,0,0,1
"14957","lowe",0,0,1,0,1
"14958","lowell",0,1,0,0,1
"14959","lowndes",0,0,1,0,1
"14960","lucinda",1,0,0,0,1
"14961","lucretiaafter",1,0,0,0,1
"14962","lucretiaas",1,0,0,0,1
"14963","lucretiashe",1,0,0,0,1
"14964","ludmilla",0,0,0,1,1
"14965","luggage",1,0,0,0,1
"14966","lugged",1,0,0,0,1
"14967","luke",0,0,0,1,1
"14968","lumber",0,1,0,0,1
"14969","lump",0,0,1,0,1
"14970","lumps",0,1,0,0,1
"14971","lungs",1,0,0,0,1
"14972","lures",1,0,0,0,1
"14973","lurks",1,0,0,0,1
"14974","luster",1,0,0,0,1
"14975","lustre",0,0,0,1,1
"14976","lusts",0,0,1,0,1
"14977","luxomborg",0,0,0,1,1
"14978","luxuriant",0,1,0,0,1
"14979","luxuriously",0,1,0,0,1
"14980","lybian",0,0,0,1,1
"14981","lycabettus",0,0,0,1,1
"14982","lydia",1,0,0,0,1
"14983","lyon",0,0,0,1,1
"14984","m b",1,0,0,0,1
"14985","m w",1,0,0,0,1
"14986","m’cune",0,1,0,0,1
"14987","m’durmond",0,0,1,0,1
"14988","mable",0,0,0,1,1
"14989","macauley",1,0,0,0,1
"14990","machines",0,1,0,0,1
"14991","mad”",1,0,0,0,1
"14992","madam”",1,0,0,0,1
"14993","madame",0,0,0,1,1
"14994","madison",1,0,0,0,1
"14995","madman",1,0,0,0,1
"14996","magazine",1,0,0,0,1
"14997","magic”",1,0,0,0,1
"14998","magnetic",0,1,0,0,1
"14999","magnifies",1,0,0,0,1
"15000","mahometan",1,0,0,0,1
"15001","maiden",0,1,0,0,1
"15002","maidens",0,1,0,0,1
"15003","maids",0,0,1,0,1
"15004","maidservant",1,0,0,0,1
"15005","mailing",1,0,0,0,1
"15006","maiming",1,0,0,0,1
"15007","maintain”",1,0,0,0,1
"15008","majestically",1,0,0,0,1
"15009","makeing",0,0,0,1,1
"15010","maker",0,1,0,0,1
"15011","malefactors",1,0,0,0,1
"15012","maligners",1,0,0,0,1
"15013","malignity_",0,1,0,0,1
"15014","mallets",1,0,0,0,1
"15015","mamelukes",0,0,0,1,1
"15016","mammon",0,0,1,0,1
"15017","man’s_",0,1,0,0,1
"15018","mana",1,0,0,0,1
"15019","manacled",0,0,1,0,1
"15020","manageable",1,0,0,0,1
"15021","manfully",0,1,0,0,1
"15022","mange",0,0,1,0,1
"15023","mangling",0,0,1,0,1
"15024","mankind_",0,1,0,0,1
"15025","manlyhearted",1,0,0,0,1
"15026","mannercovey’s",1,0,0,0,1
"15027","mannot",1,0,0,0,1
"15028","manstealers",1,0,0,0,1
"15029","manthe",1,0,0,0,1
"15030","mantoo",1,0,0,0,1
"15031","manufactures",1,0,0,0,1
"15032","manuscripts",0,0,0,1,1
"15033","many ",0,0,0,1,1
"15034","manycolored",1,0,0,0,1
"15035","maple",0,1,0,0,1
"15036","marathon",0,0,0,1,1
"15037","marchthe",1,0,0,0,1
"15038","marco",0,0,0,1,1
"15039","mariele",0,0,0,1,1
"15040","marines",1,0,0,0,1
"15041","marketplace",1,0,0,0,1
"15042","marko",0,0,0,1,1
"15043","maropolis",0,0,0,1,1
"15044","marriagehad",1,0,0,0,1
"15045","marriageright",1,0,0,0,1
"15046","marriages",0,1,0,0,1
"15047","mars",0,1,0,0,1
"15048","marshaled",1,0,0,0,1
"15049","marshallgrace",1,0,0,0,1
"15050","mart",0,1,0,0,1
"15051","martha",0,0,0,1,1
"15052","martines",0,0,0,1,1
"15053","martyred",1,0,0,0,1
"15054","marvelled",1,0,0,0,1
"15055","maryi",1,0,0,0,1
"15056","mas’r",1,0,0,0,1
"15057","mase",0,0,0,1,1
"15058","mask",0,1,0,0,1
"15059","mast",0,1,0,0,1
"15060","master_",0,1,0,0,1
"15061","mastera",1,0,0,0,1
"15062","masterclasses",1,0,0,0,1
"15063","mastering",0,1,0,0,1
"15064","masters”",1,0,0,0,1
"15065","mastersandy’s",1,0,0,0,1
"15066","masterssubjecting",1,0,0,0,1
"15067","masterswhen",1,0,0,0,1
"15068","masts",0,1,0,0,1
"15069","matchless",1,0,0,0,1
"15070","matrimony",0,0,1,0,1
"15071","matrons",0,0,1,0,1
"15072","matter”",1,0,0,0,1
"15073","matured",1,0,0,0,1
"15074","maurais",0,0,0,1,1
"15075","maws",0,0,1,0,1
"15076","may_",0,1,0,0,1
"15077","mazzini",0,1,0,0,1
"15078","mcclellana",1,0,0,0,1
"15079","mccune",1,0,0,0,1
"15080","mckim",1,0,0,0,1
"15081","md”",1,0,0,0,1
"15082","meager",1,0,0,0,1
"15083","meagher",1,0,0,0,1
"15084","meal_",0,1,0,0,1
"15085","meaningconsultation",1,0,0,0,1
"15086","meaningconsultationpasswordhope",1,0,0,0,1
"15087","meanings",0,1,0,0,1
"15088","measurable",1,0,0,0,1
"15089","measureb",1,0,0,0,1
"15090","measureless",1,0,0,0,1
"15091","meathouse",1,0,0,0,1
"15092","mecca",1,0,0,0,1
"15093","mechanically",0,1,0,0,1
"15094","medes",0,0,0,1,1
"15095","medetareanion",0,0,0,1,1
"15096","medeteranian",0,0,0,1,1
"15097","medicines",0,1,0,0,1
"15098","medicio",0,0,0,1,1
"15099","mediteranean",0,0,0,1,1
"15100","mediterranean",0,1,0,0,1
"15101","mei",1,0,0,0,1
"15102","meigs",1,0,0,0,1
"15103","mein",1,0,0,0,1
"15104","melace",0,0,0,1,1
"15105","melanchthon",0,1,0,0,1
"15106","mêlee",1,0,0,0,1
"15107","mêlée",1,0,0,0,1
"15108","melloe",1,0,0,0,1
"15109","melt",0,1,0,0,1
"15110","memento",1,0,0,0,1
"15111","memoirs",0,0,1,0,1
"15112","memorial",1,0,0,0,1
"15113","memorialized",1,0,0,0,1
"15114","memoriesburialground",1,0,0,0,1
"15115","memoriesburialgroundhospitalitygracious",1,0,0,0,1
"15116","men_",0,1,0,0,1
"15117","mena",1,0,0,0,1
"15118","menaced",1,0,0,0,1
"15119","menacing",0,1,0,0,1
"15120","menamely",1,0,0,0,1
"15121","menbut",1,0,0,0,1
"15122","mend",0,1,0,0,1
"15123","mendenhall",1,0,0,0,1
"15124","meni",0,0,0,1,1
"15125","menial",1,0,0,0,1
"15126","menin",1,0,0,0,1
"15127","mennot",1,0,0,0,1
"15128","menofwarsmen",1,0,0,0,1
"15129","menpassengers",1,0,0,0,1
"15130","mentioning",1,0,0,0,1
"15131","mentions",0,1,0,0,1
"15132","mentone",0,0,0,1,1
"15133","mer",0,0,0,1,1
"15134","mercilessness",0,1,0,0,1
"15135","mercy”",1,0,0,0,1
"15136","merging",0,1,0,0,1
"15137","meridian",1,0,0,0,1
"15138","merited",1,0,0,0,1
"15139","merrimac",1,0,0,0,1
"15140","merriments",0,0,1,0,1
"15141","messina",0,0,0,1,1
"15142","metals",0,1,0,0,1
"15143","meted",0,1,0,0,1
"15144","methat",1,0,0,0,1
"15145","metropolis",0,1,0,0,1
"15146","mexicothe",1,0,0,0,1
"15147","miasma",1,0,0,0,1
"15148","miasmatic",1,0,0,0,1
"15149","michel",0,0,0,1,1
"15150","michelangelo",0,0,0,1,1
"15151","mid",0,1,0,0,1
"15152","miday",0,0,0,1,1
"15153","midday",0,0,1,0,1
"15154","middlebury",1,0,0,0,1
"15155","might_",0,1,0,0,1
"15156","mightier",1,0,0,0,1
"15157","migration",1,0,0,0,1
"15158","migrations”",1,0,0,0,1
"15159","mildly",1,0,0,0,1
"15160","mildspoken",1,0,0,0,1
"15161","militates",0,1,0,0,1
"15162","millard",1,0,0,0,1
"15163","miller’s",0,1,0,0,1
"15164","milliken’s",1,0,0,0,1
"15165","millions’",1,0,0,0,1
"15166","millpond",1,0,0,0,1
"15167","milton",1,0,0,0,1
"15168","mimicry",0,1,0,0,1
"15169","mindedness",1,0,0,0,1
"15170","minding",1,0,0,0,1
"15171","miner",1,0,0,0,1
"15172","minester",0,0,0,1,1
"15173","minethat",1,0,0,0,1
"15174","minewhen",1,0,0,0,1
"15175","mingling",1,0,0,0,1
"15176","ministeray",0,0,0,1,1
"15177","ministered",1,0,0,0,1
"15178","ministering",0,0,1,0,1
"15179","minora",1,0,0,0,1
"15180","mint",0,0,1,0,1
"15181","minutest",0,1,0,0,1
"15182","mirthful",0,1,0,0,1
"15183","misadventure",1,0,0,0,1
"15184","misbehaving",1,0,0,0,1
"15185","mischiefnot",1,0,0,0,1
"15186","mischievously",1,0,0,0,1
"15187","mischievousthe",1,0,0,0,1
"15188","miserably",1,0,0,0,1
"15189","miseries",0,1,0,0,1
"15190","misgiving",1,0,0,0,1
"15191","misled",1,0,0,0,1
"15192","misnomer",1,0,0,0,1
"15193","misnomers",0,0,1,0,1
"15194","misrepresentations",1,0,0,0,1
"15195","misrepresented",0,0,1,0,1
"15196","mississipi",1,0,0,0,1
"15197","missourians",1,0,0,0,1
"15198","misstatements",0,0,1,0,1
"15199","mist",1,0,0,0,1
"15200","mitres",0,0,0,1,1
"15201","mixture",0,1,0,0,1
"15202","moblike",1,0,0,0,1
"15203","mock",0,1,0,0,1
"15204","models",0,0,0,1,1
"15205","moden",0,0,0,1,1
"15206","moderator",0,1,0,0,1
"15207","modest",1,0,0,0,1
"15208","modesty",1,0,0,0,1
"15209","modifies",0,1,0,0,1
"15210","modify",1,0,0,0,1
"15211","mohamden",0,0,0,1,1
"15212","mohamedan",0,0,0,1,1
"15213","mohameden",0,0,0,1,1
"15214","mohomid",0,0,0,1,1
"15215","moisture",1,0,0,0,1
"15216","momentthe",1,0,0,0,1
"15217","momentwhen",1,0,0,0,1
"15218","monarch",0,0,0,1,1
"15219","monarchies",0,1,0,0,1
"15220","monastery",0,0,0,1,1
"15221","moneyless",0,1,0,0,1
"15222","moneyloving",1,0,0,0,1
"15223","moneymy",1,0,0,0,1
"15224","moneys",1,0,0,0,1
"15225","mongols",0,1,0,0,1
"15226","monitor",1,0,0,0,1
"15227","monk",0,0,0,1,1
"15228","monkeys",1,0,0,0,1
"15229","monks",0,0,0,1,1
"15230","monks ",0,0,0,1,1
"15231","monotonous",1,0,0,0,1
"15232","monstrosity",1,0,0,0,1
"15233","month’s",1,0,0,0,1
"15234","months’",1,0,0,0,1
"15235","monument”",1,0,0,0,1
"15236","monuments",1,0,0,0,1
"15237","moreover",1,0,0,0,1
"15238","morning”",1,0,0,0,1
"15239","morningconsidering",1,0,0,0,1
"15240","mornings",1,0,0,0,1
"15241","moropoles",0,0,0,1,1
"15242","morpeth",1,0,0,0,1
"15243","morpeth”",1,0,0,0,1
"15244","morrow",0,1,0,0,1
"15245","morsel",0,1,0,0,1
"15246","mortgage",1,0,0,0,1
"15247","mortgaged",1,0,0,0,1
"15248","mosoleum",0,0,0,1,1
"15249","mosquitoes",0,1,0,0,1
"15250","mosscovered",1,0,0,0,1
"15251","motes",0,0,1,0,1
"15252","mothera",1,0,0,0,1
"15253","motherhood",1,0,0,0,1
"15254","motherless",1,0,0,0,1
"15255","motherthen",1,0,0,0,1
"15256","motly",0,0,0,1,1
"15257","motts",1,0,0,0,1
"15258","moulding",0,1,0,0,1
"15259","mountainous",0,0,0,1,1
"15260","mountan",0,0,0,1,1
"15261","mounte",0,0,0,1,1
"15262","mournfully",1,0,0,0,1
"15263","mouthed",0,1,0,0,1
"15264","movers",0,1,0,0,1
"15265","mow",1,0,0,0,1
"15266","ms",0,0,1,0,1
"15267","much_",0,1,0,0,1
"15268","muchand",1,0,0,0,1
"15269","muchcoveted",1,0,0,0,1
"15270","muchvalued",1,0,0,0,1
"15271","muddiest",1,0,0,0,1
"15272","mulattoes",0,0,0,1,1
"15273","multiply",1,0,0,0,1
"15274","mummies",0,0,0,1,1
"15275","murdering",0,1,0,0,1
"15276","murfreesboro",1,0,0,0,1
"15277","murmuring",1,0,0,0,1
"15278","murry",0,0,0,1,1
"15279","muscleunassisted",1,0,0,0,1
"15280","musings",0,1,0,0,1
"15281","musium",0,0,0,1,1
"15282","muskets",1,0,0,0,1
"15283","mutations",0,1,0,0,1
"15284","mutilating",0,1,0,0,1
"15285","mutterings",0,1,0,0,1
"15286","myrtle",1,0,0,0,1
"15287","myselfmade",1,0,0,0,1
"15288","myth",0,1,0,0,1
"15289","n s t",1,0,0,0,1
"15290","n.y",0,1,0,0,1
"15291","nail",1,0,0,0,1
"15292","nailed",1,0,0,0,1
"15293","naish",0,0,0,1,1
"15294","namessometimes",1,0,0,0,1
"15295","namethe",1,0,0,0,1
"15296","nance",0,1,0,0,1
"15297","nanny",0,0,1,0,1
"15298","napoleon’s",0,1,0,0,1
"15299","napolian",1,0,0,0,1
"15300","narmal",0,0,0,1,1
"15301","narratives",0,0,0,1,1
"15302","narrators",1,0,0,0,1
"15303","nationale",0,0,0,1,1
"15304","nations”",1,0,0,0,1
"15305","nationthe",1,0,0,0,1
"15306","nativeborn",1,0,0,0,1
"15307","naturalists",0,1,0,0,1
"15308","naturedly",0,0,0,1,1
"15309","navigation",0,0,0,1,1
"15310","nearing",1,0,0,0,1
"15311","nearness",0,1,0,0,1
"15312","neater",0,0,1,0,1
"15313","neccessary",0,1,0,0,1
"15314","necessaryaffectionate",1,0,0,0,1
"15315","neck”",1,0,0,0,1
"15316","neds",0,1,0,0,1
"15317","needing",1,0,0,0,1
"15318","needle",0,1,0,0,1
"15319","needless",1,0,0,0,1
"15320","needlessly",1,0,0,0,1
"15321","neglecting",1,0,0,0,1
"15322","negrobreaking",1,0,0,0,1
"15323","negrobut",1,0,0,0,1
"15324","negrobuyers",1,0,0,0,1
"15325","negrohate",1,0,0,0,1
"15326","negroid",0,1,0,0,1
"15327","negrotraders",1,0,0,0,1
"15328","neighborhoodmr",1,0,0,0,1
"15329","nell",0,0,1,0,1
"15330","nellie",1,0,0,0,1
"15331","nelly’s",0,1,0,0,1
"15332","neots",0,0,0,1,1
"15333","nep",0,1,0,0,1
"15334","nephew",0,0,1,0,1
"15335","neptune",0,0,0,1,1
"15336","nest",0,0,0,1,1
"15337","nestled",0,1,0,0,1
"15338","nests",1,0,0,0,1
"15339","net”",1,0,0,0,1
"15340","neutralized",0,0,1,0,1
"15341","never’",1,0,0,0,1
"15342","nevertoberetraced",1,0,0,0,1
"15343","newark",1,0,0,0,1
"15344","newburyport",0,1,0,0,1
"15345","newhampshere",0,0,0,1,1
"15346","newlymended",1,0,0,0,1
"15347","newspaperthe",1,0,0,0,1
"15348","nibbles",1,0,0,0,1
"15349","nicer",1,0,0,0,1
"15350","nichols",1,0,0,0,1
"15351","nicky",1,0,0,0,1
"15352","niggers’”",1,0,0,0,1
"15353","night”",1,0,0,0,1
"15354","nightfall",0,1,0,0,1
"15355","nightingale",0,1,0,0,1
"15356","nightly",0,1,0,0,1
"15357","niles",0,0,0,1,1
"15358","nimble",1,0,0,0,1
"15359","ninetenths",1,0,0,0,1
"15360","ninety",0,1,0,0,1
"15361","ninth",1,0,0,0,1
"15362","niver",0,0,0,1,1
"15363","noblehearted",0,1,0,0,1
"15364","nobleness",1,0,0,0,1
"15365","nobles",0,1,0,0,1
"15366","nobody”",1,0,0,0,1
"15367","noisiest",1,0,0,0,1
"15368","noisily",1,0,0,0,1
"15369","nom",1,0,0,0,1
"15370","nonintercourse",1,0,0,0,1
"15371","nonpaying",1,0,0,0,1
"15372","nonresistants",1,0,0,0,1
"15373","nonsence",0,1,0,0,1
"15374","nonslaveholder",0,1,0,0,1
"15375","nonslaveholderis",1,0,0,0,1
"15376","nontillage",1,0,0,0,1
"15377","normal",1,0,0,0,1
"15378","north_",0,1,0,0,1
"15379","northampton",0,1,0,0,1
"15380","northand",1,0,0,0,1
"15381","northeast",1,0,0,0,1
"15382","northeaster”",1,0,0,0,1
"15383","norththe",1,0,0,0,1
"15384","northwest",1,0,0,0,1
"15385","northwold",0,0,0,1,1
"15386","norwegian",1,0,0,0,1
"15387","nosily",0,1,0,0,1
"15388","nostrils",0,1,0,0,1
"15389","notably",1,0,0,0,1
"15390","notall",1,0,0,0,1
"15391","notbe",1,0,0,0,1
"15392","notes_",0,1,0,0,1
"15393","nothinghe",1,0,0,0,1
"15394","nothwithstanding",0,1,0,0,1
"15395","notified",1,0,0,0,1
"15396","notiing",0,0,0,1,1
"15397","noting",0,0,0,1,1
"15398","nott",1,0,0,0,1
"15399","nov",1,0,0,0,1
"15400","nowspeaking",1,0,0,0,1
"15401","nucleus",1,0,0,0,1
"15402","nullified",1,0,0,0,1
"15403","numberless",1,0,0,0,1
"15404","nursery",0,1,0,0,1
"15405","nurture",0,1,0,0,1
"15406","nutrix",0,1,0,0,1
"15407","nuts",1,0,0,0,1
"15408","o ",1,0,0,0,1
"15409","o’clocknoon",1,0,0,0,1
"15410","o’nine",0,1,0,0,1
"15411","oaks",1,0,0,0,1
"15412","oars",1,0,0,0,1
"15413","oathbound",1,0,0,0,1
"15414","objectionable",1,0,0,0,1
"15415","objectively",1,0,0,0,1
"15416","objectto",1,0,0,0,1
"15417","oblige",1,0,0,0,1
"15418","obliquity",1,0,0,0,1
"15419","obliterate",0,0,1,0,1
"15420","obliterated",0,1,0,0,1
"15421","obliterating",0,1,0,0,1
"15422","oblivion",0,0,0,1,1
"15423","obolisk ",0,0,0,1,1
"15424","obolisque",0,0,0,1,1
"15425","obsequiousness",0,1,0,0,1
"15426","observable",0,1,0,0,1
"15427","observance",1,0,0,0,1
"15428","observant",1,0,0,0,1
"15429","observations",0,1,0,0,1
"15430","observers",1,0,0,0,1
"15431","obstructed",0,1,0,0,1
"15432","obstructing",1,0,0,0,1
"15433","obstruction",0,1,0,0,1
"15434","obtruding",1,0,0,0,1
"15435","obtrusive",1,0,0,0,1
"15436","obtuseness",0,1,0,0,1
"15437","occupants",1,0,0,0,1
"15438","occurrences",1,0,0,0,1
"15439","occurring",1,0,0,0,1
"15440","oclo",0,0,0,1,1
"15441","oclock",0,0,0,1,1
"15442","odd",1,0,0,0,1
"15443","offerings",0,0,0,1,1
"15444","officials",1,0,0,0,1
"15445","officious",0,1,0,0,1
"15446","oft",0,1,0,0,1
"15447","oftentimes",1,0,0,0,1
"15448","oftrepeated",1,0,0,0,1
"15449","ofttimes",0,1,0,0,1
"15450","oldtime",1,0,0,0,1
"15451","olive",0,0,0,1,1
"15452","oliver",1,0,0,0,1
"15453","ollilea",0,0,0,1,1
"15454","omage",0,0,0,1,1
"15455","ominous",0,1,0,0,1
"15456","omnibuses",0,0,0,1,1
"15457","omnipotent",0,1,0,0,1
"15458","oncened",1,0,0,0,1
"15459","ondashing",0,0,0,1,1
"15460","one ",0,0,0,1,1
"15461","one”",1,0,0,0,1
"15462","oneanother",1,0,0,0,1
"15463","onehard",1,0,0,0,1
"15464","oneof",1,0,0,0,1
"15465","ones”",1,0,0,0,1
"15466","oneself",1,0,0,0,1
"15467","oneside",0,0,0,1,1
"15468","onesided",1,0,0,0,1
"15469","onespurwisdom",1,0,0,0,1
"15470","oneto",1,0,0,0,1
"15471","oozy",1,0,0,0,1
"15472","oped",0,0,1,0,1
"15473","opnions",0,0,0,1,1
"15474","oponents",0,1,0,0,1
"15475","opportunity’",1,0,0,0,1
"15476","opportunity”",1,0,0,0,1
"15477","oppositethe",1,0,0,0,1
"15478","oran",0,0,0,1,1
"15479","orator”",1,0,0,0,1
"15480","oratordialogue",1,0,0,0,1
"15481","oratordialoguespeechessheridan",1,0,0,0,1
"15482","oratorical",1,0,0,0,1
"15483","orderly",0,0,0,1,1
"15484","organizedwith",1,0,0,0,1
"15485","orgin",0,1,0,0,1
"15486","oriental",0,0,0,1,1
"15487","originality",0,1,0,0,1
"15488","orignally",0,1,0,0,1
"15489","ornaments",0,0,0,1,1
"15490","orphan",1,0,0,0,1
"15491","orson",1,0,0,0,1
"15492","orthodox",1,0,0,0,1
"15493","orvis",1,0,0,0,1
"15494","ostracised",1,0,0,0,1
"15495","ostritch",0,0,0,1,1
"15496","othelo",0,0,0,1,1
"15497","othermaking",1,0,0,0,1
"15498","otherprotecting",1,0,0,0,1
"15499","others”",1,0,0,0,1
"15500","othersnotably",1,0,0,0,1
"15501","otis",1,0,0,0,1
"15502","ottilia",1,0,0,0,1
"15503","ouly",0,0,0,1,1
"15504","out_",0,1,0,0,1
"15505","outbreak",0,1,0,0,1
"15506","outbuildings",1,0,0,0,1
"15507","outbursts",0,1,0,0,1
"15508","outdoor",1,0,0,0,1
"15509","outer",0,1,0,0,1
"15510","outgeneraled",1,0,0,0,1
"15511","outgoing",1,0,0,0,1
"15512","outgrow",0,1,0,0,1
"15513","outgrowths",0,1,0,0,1
"15514","outline",0,1,0,0,1
"15515","outlines",0,1,0,0,1
"15516","outlooking",1,0,0,0,1
"15517","outlying",1,0,0,0,1
"15518","outobjectionsfrauds",1,0,0,0,1
"15519","outobjectionsfraudspassesanxietiesfear",1,0,0,0,1
"15520","outpourings",0,1,0,0,1
"15521","outrageous",0,1,0,0,1
"15522","outskirts",0,0,1,0,1
"15523","outspoken",1,0,0,0,1
"15524","outstrip",0,1,0,0,1
"15525","outwardly",0,0,1,0,1
"15526","ovens",0,1,0,0,1
"15527","over_",0,1,0,0,1
"15528","overambitious",1,0,0,0,1
"15529","overbearing",0,1,0,0,1
"15530","overborne",0,0,1,0,1
"15531","overcame",0,0,1,0,1
"15532","overclean",0,1,0,0,1
"15533","overcoming",1,0,0,0,1
"15534","overexertion",1,0,0,0,1
"15535","overflowed",1,0,0,0,1
"15536","overhang",1,0,0,0,1
"15537","overhear",1,0,0,0,1
"15538","overheated",1,0,0,0,1
"15539","overjoyed",0,1,0,0,1
"15540","overkind",0,0,1,0,1
"15541","overleaped",1,0,0,0,1
"15542","overrated",1,0,0,0,1
"15543","overruled",1,0,0,0,1
"15544","overseerslaveholder’s",1,0,0,0,1
"15545","overstates",0,0,1,0,1
"15546","overt",1,0,0,0,1
"15547","overtake",1,0,0,0,1
"15548","overwrought",1,0,0,0,1
"15549","oweners",0,0,0,1,1
"15550","owls",1,0,0,0,1
"15551","ownerhis",1,0,0,0,1
"15552","oxcarts",1,0,0,0,1
"15553","oxdriver",1,0,0,0,1
"15554","oxenhairbreadth",1,0,0,0,1
"15555","oxford",1,0,0,0,1
"15556","oxteam",1,0,0,0,1
"15557","oystershells",1,0,0,0,1
"15558","pacas",1,0,0,0,1
"15559","pacific",0,1,0,0,1
"15560","pacified",1,0,0,0,1
"15561","packhorse",1,0,0,0,1
"15562","paddlewheels",1,0,0,0,1
"15563","pagani",0,0,0,1,1
"15564","pageant",1,0,0,0,1
"15565","paine",1,0,0,0,1
"15566","paingiving",1,0,0,0,1
"15567","painting",0,1,0,0,1
"15568","pairs",1,0,0,0,1
"15569","palaces",0,0,0,1,1
"15570","palatable",0,1,0,0,1
"15571","palazzor",0,0,0,1,1
"15572","palfry",1,0,0,0,1
"15573","pall",0,1,0,0,1
"15574","pallbearer",1,0,0,0,1
"15575","palliative",1,0,0,0,1
"15576","palm",0,1,0,0,1
"15577","palmas",0,1,0,0,1
"15578","palmed",0,0,0,1,1
"15579","palpably",0,0,1,0,1
"15580","palpitating",0,1,0,0,1
"15581","pamphlets",1,0,0,0,1
"15582","panic",0,1,0,0,1
"15583","panoply",1,0,0,0,1
"15584","pantheon",1,0,0,0,1
"15585","pantomine",0,0,0,1,1
"15586","papacy",0,0,0,1,1
"15587","papal",1,0,0,0,1
"15588","paper“",1,0,0,0,1
"15589","paper”",1,0,0,0,1
"15590","papers”",1,0,0,0,1
"15591","papersdescribing",1,0,0,0,1
"15592","par",0,0,0,1,1
"15593","paraded",1,0,0,0,1
"15594","paragon",0,1,0,0,1
"15595","paragraph",1,0,0,0,1
"15596","paralyze",1,0,0,0,1
"15597","paralyzing",0,1,0,0,1
"15598","paramount",1,0,0,0,1
"15599","parapets",1,0,0,0,1
"15600","paraphernalia",0,1,0,0,1
"15601","pardoned",1,0,0,0,1
"15602","parentage",0,0,1,0,1
"15603","parentmy",1,0,0,0,1
"15604","parleying",0,1,0,0,1
"15605","parlors",1,0,0,0,1
"15606","parricide",1,0,0,0,1
"15607","partaking",0,1,0,0,1
"15608","participant",0,0,1,0,1
"15609","particle",1,0,0,0,1
"15610","partook",1,0,0,0,1
"15611","partus",0,0,0,1,1
"15612","partyaway",1,0,0,0,1
"15613","partytrue",1,0,0,0,1
"15614","pass”",1,0,0,0,1
"15615","passesanxietiesfear",1,0,0,0,1
"15616","passionapparent",1,0,0,0,1
"15617","passionately",0,1,0,0,1
"15618","passwordhope",1,0,0,0,1
"15619","pastdrawing",1,0,0,0,1
"15620","pastin",1,0,0,0,1
"15621","pastor",1,0,0,0,1
"15622","patch",1,0,0,0,1
"15623","patched",0,1,0,0,1
"15624","pate",1,0,0,0,1
"15625","pateoli",0,0,0,1,1
"15626","paternal",0,1,0,0,1
"15627","paterson",1,0,0,0,1
"15628","patriarch",0,0,0,1,1
"15629","patrician",1,0,0,0,1
"15630","patriotically",1,0,0,0,1
"15631","patrols",0,0,1,0,1
"15632","patronage",1,0,0,0,1
"15633","patronized",0,1,0,0,1
"15634","patton",1,0,0,0,1
"15635","paul’s",1,0,0,0,1
"15636","pauls",0,0,0,1,1
"15637","pawtucket",1,0,0,0,1
"15638","pay”",1,0,0,0,1
"15639","paymaster",1,0,0,0,1
"15640","payne",1,0,0,0,1
"15641","pazzuoli",0,0,0,1,1
"15642","pea",0,1,0,0,1
"15643","peabody",1,0,0,0,1
"15644","peace’”",1,0,0,0,1
"15645","peacefully",0,0,0,1,1
"15646","peaceloving",1,0,0,0,1
"15647","peacemakers",1,0,0,0,1
"15648","peachy",0,1,0,0,1
"15649","peafowls",1,0,0,0,1
"15650","peakers",0,1,0,0,1
"15651","peal",0,1,0,0,1
"15652","pearl",0,1,0,0,1
"15653","peasing",0,0,0,1,1
"15654","pecking",1,0,0,0,1
"15655","pecuniarily",1,0,0,0,1
"15656","peeled",0,1,0,0,1
"15657","peeping",0,0,0,1,1
"15658","peicer",0,0,0,1,1
"15659","pelicans",0,0,0,1,1
"15660","pence",0,1,0,0,1
"15661","pencels",0,0,0,1,1
"15662","peninsula",1,0,0,0,1
"15663","penned",0,1,0,0,1
"15664","penny",0,1,0,0,1
"15665","pent",0,1,0,0,1
"15666","people’s",0,0,1,0,1
"15667","peoplecolored",1,0,0,0,1
"15668","peoplei",1,0,0,0,1
"15669","peoples",0,0,0,1,1
"15670","peoture",0,0,0,1,1
"15671","perambulate",0,1,0,0,1
"15672","perfidious",1,0,0,0,1
"15673","perforce",0,1,0,0,1
"15674","periodically",0,1,0,0,1
"15675","perjury",1,0,0,0,1
"15676","permeated",1,0,0,0,1
"15677","permiss",0,0,0,1,1
"15678","permission”",1,0,0,0,1
"15679","permitting",0,1,0,0,1
"15680","perpetrate",0,1,0,0,1
"15681","perpetratethe",1,0,0,0,1
"15682","perplexity",0,1,0,0,1
"15683","persecuting",1,0,0,0,1
"15684","persecutors",0,1,0,0,1
"15685","persians",0,0,0,1,1
"15686","person’s",0,1,0,0,1
"15687","person”",1,0,0,0,1
"15688","personages",0,0,0,1,1
"15689","personating",1,0,0,0,1
"15690","personify",0,0,0,1,1
"15691","peruse",0,0,1,0,1
"15692","perused",0,1,0,0,1
"15693","perverse",1,0,0,0,1
"15694","perversion",1,0,0,0,1
"15695","pervert",1,0,0,0,1
"15696","pest",0,1,0,0,1
"15697","pestilence",1,0,0,0,1
"15698","pests",0,1,0,0,1
"15699","peterboro",1,0,0,0,1
"15700","petitioners",0,1,0,0,1
"15701","petitionthe",1,0,0,0,1
"15702","petrified",0,1,0,0,1
"15703","petro",0,0,0,1,1
"15704","petulance",0,1,0,0,1
"15705","petulence",1,0,0,0,1
"15706","pew”",1,0,0,0,1
"15707","phaeton",1,0,0,0,1
"15708","phalanx",1,0,0,0,1
"15709","pharaohs",0,0,0,1,1
"15710","pharisaical",0,0,1,0,1
"15711","pharoahs",0,0,0,1,1
"15712","phasesthe",1,0,0,0,1
"15713","phebe",1,0,0,0,1
"15714","philanthropy",1,0,0,0,1
"15715","phillip",1,0,0,0,1
"15716","philosophically",1,0,0,0,1
"15717","philosophize",0,1,0,0,1
"15718","philosophy”",1,0,0,0,1
"15719","phip",0,1,0,0,1
"15720","phonography",1,0,0,0,1
"15721","photographic",1,0,0,0,1
"15722","phraseology",1,0,0,0,1
"15723","phrenology",1,0,0,0,1
"15724","physiologists",0,1,0,0,1
"15725","pick",1,0,0,0,1
"15726","pickaxe",1,0,0,0,1
"15727","pickering",0,1,0,0,1
"15728","picturing",1,0,0,0,1
"15729","pigeon",0,1,0,0,1
"15730","pigeonhouses",1,0,0,0,1
"15731","piles",0,0,0,1,1
"15732","pilgrims",0,0,1,0,1
"15733","pillory",0,1,0,0,1
"15734","pills",0,1,0,0,1
"15735","pilot",0,0,0,1,1
"15736","pilots",0,0,0,1,1
"15737","pinches",0,1,0,0,1
"15738","pincian",0,0,0,1,1
"15739","pined",0,1,0,0,1
"15740","pineknot",1,0,0,0,1
"15741","pines",0,0,0,1,1
"15742","pintor",0,0,0,1,1
"15743","pioneer",1,0,0,0,1
"15744","pioneers",1,0,0,0,1
"15745","piously",1,0,0,0,1
"15746","pipes",0,0,0,1,1
"15747","piratesthe",1,0,0,0,1
"15748","piratical",1,0,0,0,1
"15749","pistol’s",0,1,0,0,1
"15750","pitch”“halloo",1,0,0,0,1
"15751","pitiful",0,0,0,1,1
"15752","pittlords",1,0,0,0,1
"15753","pitts",0,0,0,1,1
"15754","pittsburg",1,0,0,0,1
"15755","pius",0,0,0,1,1
"15756","placarded",1,0,0,0,1
"15757","place”",1,0,0,0,1
"15758","placein",1,0,0,0,1
"15759","placesnot",1,0,0,0,1
"15760","placid",0,1,0,0,1
"15761","plainer",1,0,0,0,1
"15762","plainest",1,0,0,0,1
"15763","plainness",1,0,0,0,1
"15764","plaited",0,1,0,0,1
"15765","plane",1,0,0,0,1
"15766","planed",1,0,0,0,1
"15767","planet",1,0,0,0,1
"15768","plantationand",1,0,0,0,1
"15769","plantingtime",1,0,0,0,1
"15770","plato",0,0,0,1,1
"15771","platter",0,0,1,0,1
"15772","plaudits",1,0,0,0,1
"15773","plausibility",0,1,0,0,1
"15774","plausibilty",0,1,0,0,1
"15775","playedbut",1,0,0,0,1
"15776","playfellows",1,0,0,0,1
"15777","playgrounds",1,0,0,0,1
"15778","playtime",1,0,0,0,1
"15779","pleads",0,1,0,0,1
"15780","pleasantly",0,0,0,1,1
"15781","pleasurable",0,0,1,0,1
"15782","plebeian",1,0,0,0,1
"15783","pledging",0,0,1,0,1
"15784","plies",0,0,0,1,1
"15785","plotted",0,1,0,0,1
"15786","plough",0,0,1,0,1
"15787","pluck",1,0,0,0,1
"15788","plume",1,0,0,0,1
"15789","plus",1,0,0,0,1
"15790","plymouth",1,0,0,0,1
"15791","pocketknife",0,0,1,0,1
"15792","poem",1,0,0,0,1
"15793","poetry",1,0,0,0,1
"15794","pointa",1,0,0,0,1
"15795","pointblank",1,0,0,0,1
"15796","pointsmas’r",1,0,0,0,1
"15797","poisoned",1,0,0,0,1
"15798","poisonous",1,0,0,0,1
"15799","poking",0,1,0,0,1
"15800","poles",1,0,0,0,1
"15801","police",1,0,0,0,1
"15802","policemen",1,0,0,0,1
"15803","polish",0,1,0,0,1
"15804","politely",0,0,0,1,1
"15805","politic",1,0,0,0,1
"15806","politics”",1,0,0,0,1
"15807","polluting",0,1,0,0,1
"15808","pompei",0,0,0,1,1
"15809","pompeys",0,0,0,1,1
"15810","pompians",0,0,0,1,1
"15811","pondered",0,1,0,0,1
"15812","poorfor",1,0,0,0,1
"15813","populous",1,0,0,0,1
"15814","porphose",0,0,0,1,1
"15815","portia",0,0,0,1,1
"15816","portland",1,0,0,0,1
"15817","portland”",1,0,0,0,1
"15818","posibility",0,1,0,0,1
"15819","positionthe",1,0,0,0,1
"15820","positionthis",1,0,0,0,1
"15821","possessive",0,1,0,0,1
"15822","possibleno",1,0,0,0,1
"15823","posterity",1,0,0,0,1
"15824","postpone",1,0,0,0,1
"15825","postponement",1,0,0,0,1
"15826","posturing",0,0,0,1,1
"15827","potato",0,1,0,0,1
"15828","potency",0,1,0,0,1
"15829","potentate",1,0,0,0,1
"15830","potpie",0,1,0,0,1
"15831","pounced",1,0,0,0,1
"15832","pounding",0,1,0,0,1
"15833","poundingbarrels",1,0,0,0,1
"15834","pours",0,1,0,0,1
"15835","powder",1,0,0,0,1
"15836","powders",0,1,0,0,1
"15837","powell",1,0,0,0,1
"15838","powerhaving",1,0,0,0,1
"15839","powerlessness",0,1,0,0,1
"15840","practicable",0,1,0,0,1
"15841","practise",0,0,1,0,1
"15842","pratt",0,1,0,0,1
"15843","praycapt",1,0,0,0,1
"15844","prayer_",0,1,0,0,1
"15845","prayermeeting",1,0,0,0,1
"15846","prayes",0,0,0,1,1
"15847","pre",0,1,0,0,1
"15848","preacherstheir",1,0,0,0,1
"15849","precautions",0,1,0,0,1
"15850","precede",0,1,0,0,1
"15851","precedence",0,1,0,0,1
"15852","precept",0,1,0,0,1
"15853","preclude",1,0,0,0,1
"15854","precludes",0,1,0,0,1
"15855","prediction",1,0,0,0,1
"15856","predictions",0,1,0,0,1
"15857","predominate",0,1,0,0,1
"15858","predominates",0,1,0,0,1
"15859","preëminence",1,0,0,0,1
"15860","preeminently",0,1,0,0,1
"15861","preest",0,0,0,1,1
"15862","prefixes",1,0,0,0,1
"15863","pregnable",0,1,0,0,1
"15864","prejudged",1,0,0,0,1
"15865","prejudice”",1,0,0,0,1
"15866","prejudiced",0,1,0,0,1
"15867","premaere",0,0,0,1,1
"15868","premium",1,0,0,0,1
"15869","prepares",1,0,0,0,1
"15870","preponderate",1,0,0,0,1
"15871","preposterous”",1,0,0,0,1
"15872","prequalial",0,0,0,1,1
"15873","prerogative",0,1,0,0,1
"15874","pres",1,0,0,0,1
"15875","presbyteran",0,0,0,1,1
"15876","presedent",0,0,0,1,1
"15877","presentimentcoincidencebetrayalarrests",1,0,0,0,1
"15878","preserving",1,0,0,0,1
"15879","preseveres",0,1,0,0,1
"15880","presidentelect",1,0,0,0,1
"15881","presidenti",1,0,0,0,1
"15882","preston",1,0,0,0,1
"15883","prests",0,0,0,1,1
"15884","presumptions",1,0,0,0,1
"15885","pretence",0,0,1,0,1
"15886","pretend",1,0,0,0,1
"15887","pretending",0,0,0,1,1
"15888","prevails",0,1,0,0,1
"15889","prevention",0,1,0,0,1
"15890","priestess",0,1,0,0,1
"15891","priesthood",0,1,0,0,1
"15892","prime",1,0,0,0,1
"15893","prince’s",0,1,0,0,1
"15894","princely",1,0,0,0,1
"15895","principle_",0,1,0,0,1
"15896","printed",1,0,0,0,1
"15897","printers",1,0,0,0,1
"15898","prisonbrutal",1,0,0,0,1
"15899","prisonhouse",1,0,0,0,1
"15900","pritchard’s",1,0,0,0,1
"15901","priveleged",0,0,0,1,1
"15902","probabably",0,0,0,1,1
"15903","probableno",1,0,0,0,1
"15904","probation",1,0,0,0,1
"15905","proceeds",1,0,0,0,1
"15906","procession”",1,0,0,0,1
"15907","proclaiming",0,0,0,1,1
"15908","proclamation”",1,0,0,0,1
"15909","proclivity",0,1,0,0,1
"15910","procrastination",1,0,0,0,1
"15911","procured",1,0,0,0,1
"15912","prodigious",1,0,0,0,1
"15913","produces",0,1,0,0,1
"15914","producing",0,0,1,0,1
"15915","profess",0,1,0,0,1
"15916","professes",1,0,0,0,1
"15917","professors’",1,0,0,0,1
"15918","profile",0,1,0,0,1
"15919","profoundest",1,0,0,0,1
"15920","progressmeasures",1,0,0,0,1
"15921","progresswhat",1,0,0,0,1
"15922","prohibiting",1,0,0,0,1
"15923","prolic",0,0,0,1,1
"15924","prolific",1,0,0,0,1
"15925","prolonged",0,0,1,0,1
"15926","promenading",0,0,0,1,1
"15927","promenently",0,0,0,1,1
"15928","prominencethe",1,0,0,0,1
"15929","prominently",1,0,0,0,1
"15930","promptings",1,0,0,0,1
"15931","promptitude",0,1,0,0,1
"15932","prompts",0,1,0,0,1
"15933","promulged",0,1,0,0,1
"15934","pronouncing",0,0,1,0,1
"15935","prop",1,0,0,0,1
"15936","propagandist",0,1,0,0,1
"15937","propagation",1,0,0,0,1
"15938","propertythe",1,0,0,0,1
"15939","prophecies",0,1,0,0,1
"15940","prophert",0,0,0,1,1
"15941","prophesies",1,0,0,0,1
"15942","prophetic",1,0,0,0,1
"15943","propitiate",1,0,0,0,1
"15944","proportionally",1,0,0,0,1
"15945","proportionate",1,0,0,0,1
"15946","proprietors",1,0,0,0,1
"15947","prosecuting",1,0,0,0,1
"15948","proselyte",0,0,1,0,1
"15949","proselytes",0,0,1,0,1
"15950","prospectsmaster",1,0,0,0,1
"15951","prosper",1,0,0,0,1
"15952","prostitution",0,0,1,0,1
"15953","protectionist",1,0,0,0,1
"15954","protectionists",0,1,0,0,1
"15955","protest",1,0,0,0,1
"15956","protests",1,0,0,0,1
"15957","protract",1,0,0,0,1
"15958","protracting",1,0,0,0,1
"15959","prots",0,0,0,1,1
"15960","proudest",0,0,0,1,1
"15961","provident",0,1,0,0,1
"15962","province",0,1,0,0,1
"15963","provoking",0,1,0,0,1
"15964","prow",0,0,0,1,1
"15965","prowling",1,0,0,0,1
"15966","psychological",0,1,0,0,1
"15967","publications",1,0,0,0,1
"15968","publish”",1,0,0,0,1
"15969","publishes",0,1,0,0,1
"15970","puffedout",1,0,0,0,1
"15971","pulses",0,0,1,0,1
"15972","pumps",0,1,0,0,1
"15973","punch”",1,0,0,0,1
"15974","punishmenti",1,0,0,0,1
"15975","pupels",0,0,0,1,1
"15976","pupilage",0,1,0,0,1
"15977","purchasemoney",1,0,0,0,1
"15978","purer",0,1,0,0,1
"15979","puritan",1,0,0,0,1
"15980","purported",1,0,0,0,1
"15981","purpose ",0,0,0,1,1
"15982","pursued”",1,0,0,0,1
"15983","puts",1,0,0,0,1
"15984","pyramids",0,0,0,1,1
"15985","pyyramids",0,0,0,1,1
"15986","quaint",1,0,0,0,1
"15987","quaintest",0,0,0,1,1
"15988","quakerism",1,0,0,0,1
"15989","qualifying",1,0,0,0,1
"15990","quanties",0,1,0,0,1
"15991","quantities",1,0,0,0,1
"15992","quarreling",1,0,0,0,1
"15993","quarter“old",1,0,0,0,1
"15994","quarterdeck",1,0,0,0,1
"15995","quartered",0,1,0,0,1
"15996","quebec",1,0,0,0,1
"15997","queen’s",1,0,0,0,1
"15998","quest",0,0,1,0,1
"15999","questiondenied",1,0,0,0,1
"16000","questioning",0,1,0,0,1
"16001","quick”",1,0,0,0,1
"16002","quieting",1,0,0,0,1
"16003","quietted",0,0,0,1,1
"16004","quits",0,1,0,0,1
"16005","quitt",0,0,0,1,1
"16006","quota",1,0,0,0,1
"16007","quoted",1,0,0,0,1
"16008","r g",1,0,0,0,1
"16009","race_",0,1,0,0,1
"16010","race”",1,0,0,0,1
"16011","raceprejudice",1,0,0,0,1
"16012","races”",1,0,0,0,1
"16013","raceswhite",1,0,0,0,1
"16014","radicalism",1,0,0,0,1
"16015","radically",1,0,0,0,1
"16016","rafters",0,1,0,0,1
"16017","rag",0,0,0,1,1
"16018","ragamuffins”",1,0,0,0,1
"16019","raging",1,0,0,0,1
"16020","raiders",1,0,0,0,1
"16021","railroad”",1,0,0,0,1
"16022","railroada",1,0,0,0,1
"16023","railways",1,0,0,0,1
"16024","raisedthe",1,0,0,0,1
"16025","rake",1,0,0,0,1
"16026","rakes",0,0,1,0,1
"16027","raking",0,1,0,0,1
"16028","ralph",1,0,0,0,1
"16029","ram",1,0,0,0,1
"16030","ramifications",0,1,0,0,1
"16031","rampant",1,0,0,0,1
"16032","ramsey",0,1,0,0,1
"16033","ranged",0,1,0,0,1
"16034","ranting",0,0,1,0,1
"16035","rapacity",0,1,0,0,1
"16036","rapt",0,1,0,0,1
"16037","rarer",0,0,1,0,1
"16038","rascally",1,0,0,0,1
"16039","rash",1,0,0,0,1
"16040","rashness",0,1,0,0,1
"16041","rated",0,1,0,0,1
"16042","rations",1,0,0,0,1
"16043","rattle",0,1,0,0,1
"16044","rattles",0,1,0,0,1
"16045","rattling",0,0,1,0,1
"16046","rauselear",1,0,0,0,1
"16047","raving",0,0,1,0,1
"16048","reaches",0,1,0,0,1
"16049","readmy",1,0,0,0,1
"16050","reads",0,0,1,0,1
"16051","readville",1,0,0,0,1
"16052","realization",1,0,0,0,1
"16053","reaped",1,0,0,0,1
"16054","reaping",0,1,0,0,1
"16055","rears",1,0,0,0,1
"16056","rebellion”",1,0,0,0,1
"16057","rebellionthat",1,0,0,0,1
"16058","rebelswhen",1,0,0,0,1
"16059","rebuffs",1,0,0,0,1
"16060","rebuked",1,0,0,0,1
"16061","rebukes",0,1,0,0,1
"16062","recalling",1,0,0,0,1
"16063","recapturing",1,0,0,0,1
"16064","receide",0,0,0,1,1
"16065","receivedimpressions",1,0,0,0,1
"16066","receivedof",1,0,0,0,1
"16067","receptions",1,0,0,0,1
"16068","recess",1,0,0,0,1
"16069","recesses",0,1,0,0,1
"16070","recetations",0,0,0,1,1
"16071","rechard",0,0,0,1,1
"16072","recieved",0,0,0,1,1
"16073","recieving",0,0,0,1,1
"16074","recipient",1,0,0,0,1
"16075","reciprocated",1,0,0,0,1
"16076","reckon",1,0,0,0,1
"16077","reclamation",1,0,0,0,1
"16078","reclined",1,0,0,0,1
"16079","reclines",0,1,0,0,1
"16080","recognizes",0,1,0,0,1
"16081","recollect",0,0,1,0,1
"16082","recollected",1,0,0,0,1
"16083","recollecting",1,0,0,0,1
"16084","recommending",0,1,0,0,1
"16085","reconcile",0,1,0,0,1
"16086","reconsidered",1,0,0,0,1
"16087","reconstruct",1,0,0,0,1
"16088","recording",0,1,0,0,1
"16089","recover",1,0,0,0,1
"16090","recruits",1,0,0,0,1
"16091","recurring",0,1,0,0,1
"16092","reddening",0,1,0,0,1
"16093","redeemer",0,1,0,0,1
"16094","redressed",1,0,0,0,1
"16095","reel",0,1,0,0,1
"16096","reelected",1,0,0,0,1
"16097","reelection",1,0,0,0,1
"16098","reenforcement",0,1,0,0,1
"16099","reenslavement",0,1,0,0,1
"16100","reenslavementavarice",1,0,0,0,1
"16101","ref",0,0,0,1,1
"16102","referring",0,1,0,0,1
"16103","refinery",1,0,0,0,1
"16104","reflected",0,0,1,0,1
"16105","reflective",0,0,1,0,1
"16106","reformatory",1,0,0,0,1
"16107","reformed",0,0,1,0,1
"16108","refought",0,1,0,0,1
"16109","refresh",1,0,0,0,1
"16110","refreshments",0,1,0,0,1
"16111","refunded ",0,0,0,1,1
"16112","refute",0,1,0,0,1
"16113","regards",1,0,0,0,1
"16114","regime",1,0,0,0,1
"16115","regimentsthe",1,0,0,0,1
"16116","register",0,1,0,0,1
"16117","regretful",1,0,0,0,1
"16118","regulation",1,0,0,0,1
"16119","reinforced",0,1,0,0,1
"16120","reins”",1,0,0,0,1
"16121","rejecting",0,0,0,1,1
"16122","rejoinder",1,0,0,0,1
"16123","rekindle",1,0,0,0,1
"16124","relating",0,1,0,0,1
"16125","relax",0,1,0,0,1
"16126","releasing",0,1,0,0,1
"16127","relegious",0,0,0,1,1
"16128","reliable",1,0,0,0,1
"16129","reliant",0,1,0,0,1
"16130","relict",1,0,0,0,1
"16131","relieve”",1,0,0,0,1
"16132","relieves",1,0,0,0,1
"16133","relighting",0,1,0,0,1
"16134","religion_",0,0,1,0,1
"16135","relinquish",0,0,1,0,1
"16136","relished",1,0,0,0,1
"16137","relishes",0,1,0,0,1
"16138","remainds",0,0,0,1,1
"16139","remainedsleep",1,0,0,0,1
"16140","remarkablyreligiouslymissionarylooking",1,0,0,0,1
"16141","remembers",1,0,0,0,1
"16142","remond_",0,0,1,0,1
"16143","remonstrate",1,0,0,0,1
"16144","remonstrated",1,0,0,0,1
"16145","remorse",1,0,0,0,1
"16146","remote",1,0,0,0,1
"16147","removalthe",1,0,0,0,1
"16148","removedto",1,0,0,0,1
"16149","remuses",0,1,0,0,1
"16150","renders",0,0,1,0,1
"16151","rendezvous",1,0,0,0,1
"16152","rendition",1,0,0,0,1
"16153","renew",1,0,0,0,1
"16154","renown’",1,0,0,0,1
"16155","renunciation",1,0,0,0,1
"16156","reorganized",1,0,0,0,1
"16157","repairs",1,0,0,0,1
"16158","repass",1,0,0,0,1
"16159","repast",0,1,0,0,1
"16160","repealed",1,0,0,0,1
"16161","repealing",1,0,0,0,1
"16162","repeating",1,0,0,0,1
"16163","repentant",1,0,0,0,1
"16164","reperused",0,1,0,0,1
"16165","repetition",1,0,0,0,1
"16166","reporters",1,0,0,0,1
"16167","repose”",1,0,0,0,1
"16168","reposes",1,0,0,0,1
"16169","reposing",1,0,0,0,1
"16170","reprehensible",0,1,0,0,1
"16171","represents",1,0,0,0,1
"16172","reprimanded",0,1,0,0,1
"16173","reprobated",1,0,0,0,1
"16174","reproduce",0,1,0,0,1
"16175","reprove",0,1,0,0,1
"16176","reproved",0,1,0,0,1
"16177","reproving",0,0,1,0,1
"16178","reptile",0,0,1,0,1
"16179","reptiles",0,1,0,0,1
"16180","republic’”",1,0,0,0,1
"16181","republics",1,0,0,0,1
"16182","republishing",0,1,0,0,1
"16183","repudiation",1,0,0,0,1
"16184","requested",1,0,0,0,1
"16185","requesting",0,0,0,1,1
"16186","requirement",1,0,0,0,1
"16187","requisite",1,0,0,0,1
"16188","rescue”",1,0,0,0,1
"16189","rescuing",1,0,0,0,1
"16190","reseded",0,0,0,1,1
"16191","resembles",0,1,0,0,1
"16192","resented",1,0,0,0,1
"16193","reservations",1,0,0,0,1
"16194","reserved",0,1,0,0,1
"16195","resignation",1,0,0,0,1
"16196","resigned",1,0,0,0,1
"16197","resist_",0,1,0,0,1
"16198","resistance”",1,0,0,0,1
"16199","resistancedeath",1,0,0,0,1
"16200","resistancemrs",1,0,0,0,1
"16201","resistances",0,1,0,0,1
"16202","resisted”",1,0,0,0,1
"16203","resists",0,1,0,0,1
"16204","resorts",1,0,0,0,1
"16205","resound",0,1,0,0,1
"16206","resounded",1,0,0,0,1
"16207","respect”",1,0,0,0,1
"16208","respecter",0,1,0,0,1
"16209","respond",1,0,0,0,1
"16210","responding",1,0,0,0,1
"16211","responds",0,1,0,0,1
"16212","rest”",1,0,0,0,1
"16213","restful",1,0,0,0,1
"16214","restingplace",1,0,0,0,1
"16215","restlessness",1,0,0,0,1
"16216","restoration",1,0,0,0,1
"16217","restrained",1,0,0,0,1
"16218","resultant",0,1,0,0,1
"16219","retains",0,1,0,0,1
"16220","retard",0,1,0,0,1
"16221","retention",1,0,0,0,1
"16222","rethink",1,0,0,0,1
"16223","retire",1,0,0,0,1
"16224","retirement",0,1,0,0,1
"16225","retiring",0,1,0,0,1
"16226","retouching",1,0,0,0,1
"16227","retraced",0,1,0,0,1
"16228","retreats",1,0,0,0,1
"16229","retributive",0,1,0,0,1
"16230","reunbrook",0,0,0,1,1
"16231","rev_",0,1,0,0,1
"16232","reveal",1,0,0,0,1
"16233","reveiling",0,0,0,1,1
"16234","revels",1,0,0,0,1
"16235","review”",1,0,0,0,1
"16236","revising",1,0,0,0,1
"16237","revive",1,0,0,0,1
"16238","revoked",1,0,0,0,1
"16239","revolver",1,0,0,0,1
"16240","revs",1,0,0,0,1
"16241","rewarding",1,0,0,0,1
"16242","rewell",1,0,0,0,1
"16243","reynolds",1,0,0,0,1
"16244","rhone",0,0,0,1,1
"16245","rialto",0,0,0,1,1
"16246","ribs",0,0,1,0,1
"16247","riceswamps",1,0,0,0,1
"16248","richardsona",1,0,0,0,1
"16249","richer",0,1,0,0,1
"16250","richetson’s",1,0,0,0,1
"16251","richmondstage",1,0,0,0,1
"16252","richone",1,0,0,0,1
"16253","ricketson’s",0,1,0,0,1
"16254","ricketsonwho",1,0,0,0,1
"16255","riddle",1,0,0,0,1
"16256","ridiculed",0,0,1,0,1
"16257","riding”",1,0,0,0,1
"16258","ridingwhip",1,0,0,0,1
"16259","rifled",1,0,0,0,1
"16260","rigging",0,1,0,0,1
"16261","righted",0,0,1,0,1
"16262","righteously",0,1,0,0,1
"16263","righthand",1,0,0,0,1
"16264","ringold",1,0,0,0,1
"16265","riot",1,0,0,0,1
"16266","ripening",0,1,0,0,1
"16267","risked",1,0,0,0,1
"16268","risks",1,0,0,0,1
"16269","rite",1,0,0,0,1
"16270","rites",1,0,0,0,1
"16271","rivitted",0,0,0,1,1
"16272","rivoli",0,0,0,1,1
"16273","roaches",1,0,0,0,1
"16274","road”",1,0,0,0,1
"16275","roaming",1,0,0,0,1
"16276","roberts”",1,0,0,0,1
"16277","robeson",1,0,0,0,1
"16278","robesons",1,0,0,0,1
"16279","rochdale",1,0,0,0,1
"16280","rod",0,0,1,0,1
"16281","roderick",1,0,0,0,1
"16282","rodman",1,0,0,0,1
"16283","rodmans",1,0,0,0,1
"16284","rolls",1,0,0,0,1
"16285","romanceand",1,0,0,0,1
"16286","romanism",0,0,0,1,1
"16287","romantic",1,0,0,0,1
"16288","romuluses",0,1,0,0,1
"16289","rooms",0,0,0,1,1
"16290","rootpreventive",1,0,0,0,1
"16291","rootstrange",1,0,0,0,1
"16292","roscoe",1,0,0,0,1
"16293","rosetta",0,0,0,1,1
"16294","ross",1,0,0,0,1
"16295","rosy",0,1,0,0,1
"16296","rosycheeked",1,0,0,0,1
"16297","rotunda",1,0,0,0,1
"16298","rougher",1,0,0,0,1
"16299","roughhanded",1,0,0,0,1
"16300","roundabout",1,0,0,0,1
"16301","rounding",1,0,0,0,1
"16302","rounds",0,1,0,0,1
"16303","roundshouldered",1,0,0,0,1
"16304","row”",1,0,0,0,1
"16305","rowe",0,0,1,0,1
"16306","rowed",0,0,0,1,1
"16307","rowena’s",0,1,0,0,1
"16308","rowland",1,0,0,0,1
"16309","royalty",0,0,0,1,1
"16310","rubbed",0,0,1,0,1
"16311","rubbish",1,0,0,0,1
"16312","ruddy",1,0,0,0,1
"16313","rudeness",0,1,0,0,1
"16314","rudiments",0,1,0,0,1
"16315","ruffian",0,1,0,0,1
"16316","ruffled",0,0,0,1,1
"16317","ruggles_",0,0,1,0,1
"16318","ruin”",1,0,0,0,1
"16319","rule”",1,0,0,0,1
"16320","ruleorruin",1,0,0,0,1
"16321","ruler",1,0,0,0,1
"16322","rumored",1,0,0,0,1
"16323","rumors",1,0,0,0,1
"16324","runaways",0,0,1,0,1
"16325","runawayslaves",1,0,0,0,1
"16326","rushes",0,1,0,0,1
"16327","russia",1,0,0,0,1
"16328","russworm",0,1,0,0,1
"16329","russwurms",1,0,0,0,1
"16330","rusting",0,1,0,0,1
"16331","rye",0,0,1,0,1
"16332","rynders",1,0,0,0,1
"16333","sabbathschoolhow",1,0,0,0,1
"16334","sackwell",1,0,0,0,1
"16335","saco",1,0,0,0,1
"16336","sacrificing",0,1,0,0,1
"16337","sacrilegious",0,1,0,0,1
"16338","sad ",0,0,0,1,1
"16339","saddening",0,1,0,0,1
"16340","sadness”",1,0,0,0,1
"16341","safeguard",0,0,1,0,1
"16342","safetyvalves",1,0,0,0,1
"16343","said“",1,0,0,0,1
"16344","saidand",1,0,0,0,1
"16345","sailordavid",1,0,0,0,1
"16346","sailorwho",1,0,0,0,1
"16347","sakar",0,0,0,1,1
"16348","sakes",0,1,0,0,1
"16349","salamis",0,0,0,1,1
"16350","salem",1,0,0,0,1
"16351","sallie",1,0,0,0,1
"16352","sallied",0,1,0,0,1
"16353","sallow",1,0,0,0,1
"16354","salmon",1,0,0,0,1
"16355","saloonoalan",0,0,0,1,1
"16356","salt”",1,0,0,0,1
"16357","salts_",0,1,0,0,1
"16358","saltwater",1,0,0,0,1
"16359","salutations",1,0,0,0,1
"16360","saluted",0,1,0,0,1
"16361","sam’l",1,0,0,0,1
"16362","sample",0,0,1,0,1
"16363","sanborn",1,0,0,0,1
"16364","sanctified",0,1,0,0,1
"16365","sanctioner",0,1,0,0,1
"16366","sanctioning",0,1,0,0,1
"16367","sanctions",0,1,0,0,1
"16368","sandals",0,0,0,1,1
"16369","sandwiched",1,0,0,0,1
"16370","sanguine",0,0,1,0,1
"16371","sap",1,0,0,0,1
"16372","sapping",0,1,0,0,1
"16373","saratoga",1,0,0,0,1
"16374","sargent",0,0,0,1,1
"16375","sash",0,1,0,0,1
"16376","saticfaction",0,1,0,0,1
"16377","satire",0,1,0,0,1
"16378","satisfactorily",1,0,0,0,1
"16379","saucy",0,1,0,0,1
"16380","sauntered",0,1,0,0,1
"16381","savagely",0,0,1,0,1
"16382","savages",0,1,0,0,1
"16383","savor",1,0,0,0,1
"16384","saw ",0,0,0,1,1
"16385","sawyer",0,1,0,0,1
"16386","say“”",1,0,0,0,1
"16387","scaffold",1,0,0,0,1
"16388","scaffolding",1,0,0,0,1
"16389","scales",0,1,0,0,1
"16390","scalp",1,0,0,0,1
"16391","scampering",1,0,0,0,1
"16392","scandalized",1,0,0,0,1
"16393","scape",0,1,0,0,1
"16394","scapegoat",1,0,0,0,1
"16395","scarcelyworn",1,0,0,0,1
"16396","scarlet",1,0,0,0,1
"16397","scathing",0,0,1,0,1
"16398","scatters",0,0,1,0,1
"16399","scenery",0,0,0,1,1
"16400","scent",0,1,0,0,1
"16401","scepticism",1,0,0,0,1
"16402","sceptre",1,0,0,0,1
"16403","scheother",0,0,0,1,1
"16404","schoolmaster",1,0,0,0,1
"16405","schooner",0,0,1,0,1
"16406","scientists",1,0,0,0,1
"16407","scoars",0,0,0,1,1
"16408","scoffer",0,1,0,0,1
"16409","scool",0,0,0,1,1
"16410","scorns",0,1,0,0,1
"16411","scotia",1,0,0,0,1
"16412","scotland_",0,1,0,0,1
"16413","scotland’s",0,1,0,0,1
"16414","scotlandwere",1,0,0,0,1
"16415","scottish",0,1,0,0,1
"16416","scoundrel”",1,0,0,0,1
"16417","scoured",1,0,0,0,1
"16418","scouts",1,0,0,0,1
"16419","screamed",0,0,1,0,1
"16420","screami",1,0,0,0,1
"16421","scripturally",0,0,1,0,1
"16422","scriptures”",1,0,0,0,1
"16423","scrub",0,1,0,0,1
"16424","scruples",0,1,0,0,1
"16425","scrutiny",1,0,0,0,1
"16426","sculpturer",0,0,0,1,1
"16427","scutari",0,1,0,0,1
"16428","scythe",1,0,0,0,1
"16429","sea ",0,0,0,1,1
"16430","seaman’s",1,0,0,0,1
"16431","seamanship",1,0,0,0,1
"16432","seamed",1,0,0,0,1
"16433","seams",0,1,0,0,1
"16434","seaports",1,0,0,0,1
"16435","sears’s",1,0,0,0,1
"16436","seasoned",0,1,0,0,1
"16437","seasthe",1,0,0,0,1
"16438","seat”",1,0,0,0,1
"16439","seata",1,0,0,0,1
"16440","secerts",0,1,0,0,1
"16441","seclusion",0,1,0,0,1
"16442","seconded",0,0,1,0,1
"16443","seconds",1,0,0,0,1
"16444","secresy",1,0,0,0,1
"16445","secretive",1,0,0,0,1
"16446","sect",0,1,0,0,1
"16447","sectarianism",1,0,0,0,1
"16448","sectarism",0,1,0,0,1
"16449","sections”",1,0,0,0,1
"16450","seekers",0,0,1,0,1
"16451","seen”",1,0,0,0,1
"16452","seething",0,1,0,0,1
"16453","seine",0,0,0,1,1
"16454","seinehauling",1,0,0,0,1
"16455","seizes",0,0,1,0,1
"16456","selden",1,0,0,0,1
"16457","selections",1,0,0,0,1
"16458","selerno",0,0,0,1,1
"16459","selfabasement",1,0,0,0,1
"16460","selfassertion",1,0,0,0,1
"16461","selfconfidence",1,0,0,0,1
"16462","selfdeceived",1,0,0,0,1
"16463","selfdefence",1,0,0,0,1
"16464","selfdeluded",1,0,0,0,1
"16465","selfdenial",1,0,0,0,1
"16466","selfdevelopment",1,0,0,0,1
"16467","selfesteem",1,0,0,0,1
"16468","selfgovernment",1,0,0,0,1
"16469","selfgratulation",1,0,0,0,1
"16470","selfpreservationa",1,0,0,0,1
"16471","selfprotection",1,0,0,0,1
"16472","selfreliance",1,0,0,0,1
"16473","selfrespecting",1,0,0,0,1
"16474","selfsacrifice",1,0,0,0,1
"16475","selfshutting",1,0,0,0,1
"16476","selfsupporting",1,0,0,0,1
"16477","sellers",0,1,0,0,1
"16478","sells",0,0,1,0,1
"16479","semibarbarous",1,0,0,0,1
"16480","semicivilized",1,0,0,0,1
"16481","semilying",1,0,0,0,1
"16482","seminary",1,0,0,0,1
"16483","sending ",0,0,0,1,1
"16484","sends",0,1,0,0,1
"16485","sensationextraordinary",1,0,0,0,1
"16486","sensationhow",1,0,0,0,1
"16487","sensei",1,0,0,0,1
"16488","senses",0,1,0,0,1
"16489","sensible",0,0,0,1,1
"16490","separates",1,0,0,0,1
"16491","sept_",0,0,1,0,1
"16492","sepulchres",0,0,1,0,1
"16493","serento",0,0,0,1,1
"16494","serfdom",1,0,0,0,1
"16495","serfs",1,0,0,0,1
"16496","seriousminded",1,0,0,0,1
"16497","servant_",0,1,0,0,1
"16498","servant”",1,0,0,0,1
"16499","setback",1,0,0,0,1
"16500","settembre",0,0,0,1,1
"16501","settles",1,0,0,0,1
"16502","seventyfive",1,0,0,0,1
"16503","seventyfour",1,0,0,0,1
"16504","seventytwo",1,0,0,0,1
"16505","severe’s",0,0,1,0,1
"16506","severities",1,0,0,0,1
"16507","sewell",1,0,0,0,1
"16508","sewing",1,0,0,0,1
"16509","seynagauge",0,0,0,1,1
"16510","shadesthe",1,0,0,0,1
"16511","shading",1,0,0,0,1
"16512","shadowy",0,1,0,0,1
"16513","shadrack",1,0,0,0,1
"16514","shakehands",1,0,0,0,1
"16515","shakes",0,1,0,0,1
"16516","shaketh",0,1,0,0,1
"16517","shame”",1,0,0,0,1
"16518","shamed",1,0,0,0,1
"16519","shan’t",1,0,0,0,1
"16520","shankland",0,0,0,1,1
"16521","shapen",0,1,0,0,1
"16522","shapethe",1,0,0,0,1
"16523","shares",1,0,0,0,1
"16524","sharpen",1,0,0,0,1
"16525","sharpened",1,0,0,0,1
"16526","sharpness",1,0,0,0,1
"16527","shaved",1,0,0,0,1
"16528","shawand",1,0,0,0,1
"16529","shawl",1,0,0,0,1
"16530","sheba",1,0,0,0,1
"16531","shelters",0,0,0,1,1
"16532","shenandoah",1,0,0,0,1
"16533","shepherd",0,1,0,0,1
"16534","shielded",1,0,0,0,1
"16535","shin",0,0,0,1,1
"16536","shines",1,0,0,0,1
"16537","shingle",0,0,1,0,1
"16538","shipboard",0,0,0,1,1
"16539","shiprepairing",1,0,0,0,1
"16540","ships”",1,0,0,0,1
"16541","shipsan",1,0,0,0,1
"16542","shipyardmaster",1,0,0,0,1
"16543","shivered",1,0,0,0,1
"16544","shod",1,0,0,0,1
"16545","shoe",0,0,0,1,1
"16546","shoeing",0,1,0,0,1
"16547","shoeless",1,0,0,0,1
"16548","shoemaker’s",1,0,0,0,1
"16549","shoemaking",0,0,1,0,1
"16550","shone",0,0,1,0,1
"16551","shootingcrackers",1,0,0,0,1
"16552","shorn",1,0,0,0,1
"16553","shortnecked",1,0,0,0,1
"16554","shortsighted",1,0,0,0,1
"16555","shotgun",1,0,0,0,1
"16556","shouldered",0,0,1,0,1
"16557","shouting",1,0,0,0,1
"16558","shoveling",1,0,0,0,1
"16559","shovels",1,0,0,0,1
"16560","shower",0,1,0,0,1
"16561","showered",1,0,0,0,1
"16562","showy",0,1,0,0,1
"16563","shrink",1,0,0,0,1
"16564","shrubbery",0,1,0,0,1
"16565","shrunk",0,1,0,0,1
"16566","shunning",1,0,0,0,1
"16567","shuns",1,0,0,0,1
"16568","shy",0,1,0,0,1
"16569","sicilily",0,0,0,1,1
"16570","sicily",0,0,0,1,1
"16571","sicken",0,1,0,0,1
"16572","sickens",0,1,0,0,1
"16573","sicknesslaziness",1,0,0,0,1
"16574","side_",0,1,0,0,1
"16575","sideboard",1,0,0,0,1
"16576","sidney",0,0,0,1,1
"16577","siever",0,1,0,0,1
"16578","sight ",0,0,0,1,1
"16579","signally",1,0,0,0,1
"16580","signature",0,1,0,0,1
"16581","signification",0,1,0,0,1
"16582","signifying",1,0,0,0,1
"16583","silencefor",1,0,0,0,1
"16584","silent”",1,0,0,0,1
"16585","silverthe",1,0,0,0,1
"16586","simms",1,0,0,0,1
"16587","simon",1,0,0,0,1
"16588","simpleminded",1,0,0,0,1
"16589","sin”",1,0,0,0,1
"16590","sincerety",0,0,0,1,1
"16591","sinew",1,0,0,0,1
"16592","sinewy",1,0,0,0,1
"16593","singingsadnessunhappiness",1,0,0,0,1
"16594","sings",0,1,0,0,1
"16595","sip",0,0,1,0,1
"16596","sire",0,1,0,0,1
"16597","sires",0,0,1,0,1
"16598","sirhaving",1,0,0,0,1
"16599","sissons",1,0,0,0,1
"16600","sisterhood",1,0,0,0,1
"16601","sisterinlaw",1,0,0,0,1
"16602","sisterly",0,1,0,0,1
"16603","site",0,0,0,1,1
"16604","sites",1,0,0,0,1
"16605","sits",0,0,1,0,1
"16606","sixandforty",1,0,0,0,1
"16607","sixteenth",0,1,0,0,1
"16608","sixth",0,1,0,0,1
"16609","sjour",0,0,0,1,1
"16610","skeptical",1,0,0,0,1
"16611","skeptics",0,0,1,0,1
"16612","sketching",0,1,0,0,1
"16613","skilful",0,0,1,0,1
"16614","skilfully",1,0,0,0,1
"16615","skirmish",0,1,0,0,1
"16616","skirt",0,0,0,1,1
"16617","skirts_",0,1,0,0,1
"16618","skirts”",1,0,0,0,1
"16619","sky”",1,0,0,0,1
"16620","skyhigh",1,0,0,0,1
"16621","skyward",0,1,0,0,1
"16622","skywardpointing",1,0,0,0,1
"16623","slade",1,0,0,0,1
"16624","slanderer",0,1,0,0,1
"16625","slanderously",1,0,0,0,1
"16626","slang",1,0,0,0,1
"16627","slashing",0,0,1,0,1
"16628","slat",0,0,1,0,1
"16629","slaughtered",1,0,0,0,1
"16630","slaughterhouse",0,0,1,0,1
"16631","slave”discontent",1,0,0,0,1
"16632","slave”discontentsuspicions",1,0,0,0,1
"16633","slaveboy",1,0,0,0,1
"16634","slavebreeding",1,0,0,0,1
"16635","slavebrought",1,0,0,0,1
"16636","slavebuyers",1,0,0,0,1
"16637","slavecatcher",1,0,0,0,1
"16638","slavedealers",1,0,0,0,1
"16639","slavedrivers",1,0,0,0,1
"16640","slavedriving",1,0,0,0,1
"16641","slaveholdera",1,0,0,0,1
"16642","slaveholdernot",1,0,0,0,1
"16643","slaveholders”",1,0,0,0,1
"16644","slaveholderssuspicion",1,0,0,0,1
"16645","slavehounds",1,0,0,0,1
"16646","slavehunt",0,0,0,1,1
"16647","slavehunter",1,0,0,0,1
"16648","slavehunters",1,0,0,0,1
"16649","slavehunting",1,0,0,0,1
"16650","slavekept",1,0,0,0,1
"16651","slavelife",1,0,0,0,1
"16652","slaveman",0,1,0,0,1
"16653","slavemother",1,0,0,0,1
"16654","slavepower",1,0,0,0,1
"16655","slaverya",1,0,0,0,1
"16656","slaveryand",1,0,0,0,1
"16657","slaverydistorted",1,0,0,0,1
"16658","slaverydoomed",1,0,0,0,1
"16659","slaverye",1,0,0,0,1
"16660","slaverypolluted",1,0,0,0,1
"16661","slaverytelling",1,0,0,0,1
"16662","slaverythat",1,0,0,0,1
"16663","slaveryto",1,0,0,0,1
"16664","slaves_",0,1,0,0,1
"16665","slavesa",1,0,0,0,1
"16666","slavesand",1,0,0,0,1
"16667","slavescontrastsexceptions",1,0,0,0,1
"16668","slavescontrastsexceptionsmr",1,0,0,0,1
"16669","slavescountry",1,0,0,0,1
"16670","slaveselling",1,0,0,0,1
"16671","slaveshas",1,0,0,0,1
"16672","slavesmrs",1,0,0,0,1
"16673","slavesthe",1,0,0,0,1
"16674","slavesuffered",1,0,0,0,1
"16675","slavesuperior",1,0,0,0,1
"16676","slaveswhen",1,0,0,0,1
"16677","slavesystem",1,0,0,0,1
"16678","slavethought",1,0,0,0,1
"16679","slavetraders",1,0,0,0,1
"16680","slavetraderswho",1,0,0,0,1
"16681","slavewomen",0,1,0,0,1
"16682","slay",1,0,0,0,1
"16683","slayers",1,0,0,0,1
"16684","slazily",0,1,0,0,1
"16685","slearce",0,0,0,1,1
"16686","sledgehammer",1,0,0,0,1
"16687","sleepcare",1,0,0,0,1
"16688","sleepingplace",1,0,0,0,1
"16689","sleigh",1,0,0,0,1
"16690","slew",1,0,0,0,1
"16691","slice",0,1,0,0,1
"16692","slide”",1,0,0,0,1
"16693","slip",0,1,0,0,1
"16694","slipknot",1,0,0,0,1
"16695","slipping",1,0,0,0,1
"16696","sloopto",1,0,0,0,1
"16697","slowness",1,0,0,0,1
"16698","slums",1,0,0,0,1
"16699","smaller",1,0,0,0,1
"16700","smallness",1,0,0,0,1
"16701","smallpox",1,0,0,0,1
"16702","smitted",0,1,0,0,1
"16703","smoking",0,0,0,1,1
"16704","smyth",1,0,0,0,1
"16705","snake”",1,0,0,0,1
"16706","snakelike",1,0,0,0,1
"16707","snapped",0,1,0,0,1
"16708","snatches",0,1,0,0,1
"16709","snatching",0,1,0,0,1
"16710","snowcapped",1,0,0,0,1
"16711","snowflakes",1,0,0,0,1
"16712","snubbed",0,1,0,0,1
"16713","snuffed",0,1,0,0,1
"16714","soane",0,0,0,1,1
"16715","soars",0,1,0,0,1
"16716","society”",1,0,0,0,1
"16717","societyrestraints",1,0,0,0,1
"16718","socratic",0,1,0,0,1
"16719","sodereni",0,0,0,1,1
"16720","softest",0,1,0,0,1
"16721","softspoken",1,0,0,0,1
"16722","sojourning",1,0,0,0,1
"16723","solace",0,1,0,0,1
"16724","soldierly",1,0,0,0,1
"16725","soliloquizing",0,0,1,0,1
"16726","solution",0,1,0,0,1
"16727","solve",0,1,0,0,1
"16728","somalia",0,0,0,1,1
"16729","somebody’s",1,0,0,0,1
"16730","sometime",1,0,0,0,1
"16731","someting",0,0,0,1,1
"16732","sonsandrew",1,0,0,0,1
"16733","sopha”",1,0,0,0,1
"16734","sophia’s",0,1,0,0,1
"16735","sophistical",1,0,0,0,1
"16736","sophy",0,1,0,0,1
"16737","sorely",0,1,0,0,1
"16738","sorrowful",1,0,0,0,1
"16739","sort”",1,0,0,0,1
"16740","soulcrushing",1,0,0,0,1
"16741","souldevouring",1,0,0,0,1
"16742","souldrivers",1,0,0,0,1
"16743","soulless",1,0,0,0,1
"16744","soulshuddering",1,0,0,0,1
"16745","soup",1,0,0,0,1
"16746","soured",1,0,0,0,1
"16747","sourness",0,1,0,0,1
"16748","south”",1,0,0,0,1
"16749","southand",1,0,0,0,1
"16750","southbut",1,0,0,0,1
"16751","southeast",1,0,0,0,1
"16752","southeasterly",1,0,0,0,1
"16753","southward",0,0,1,0,1
"16754","southwesterly",1,0,0,0,1
"16755","southwick",1,0,0,0,1
"16756","southwicks",1,0,0,0,1
"16757","sowed",1,0,0,0,1
"16758","spades",1,0,0,0,1
"16759","spake",1,0,0,0,1
"16760","spanish",1,0,0,0,1
"16761","spans",1,0,0,0,1
"16762","sparingly",0,0,1,0,1
"16763","sparkled",0,1,0,0,1
"16764","sparkling",0,1,0,0,1
"16765","sparrowtailed",1,0,0,0,1
"16766","sparta",0,0,0,1,1
"16767","speak”",1,0,0,0,1
"16768","speaker’s",1,0,0,0,1
"16769","speakerbusy",1,0,0,0,1
"16770","speaketh",0,1,0,0,1
"16771","specially",1,0,0,0,1
"16772","specified",1,0,0,0,1
"16773","specious",0,0,1,0,1
"16774","speck",0,1,0,0,1
"16775","spectacles",1,0,0,0,1
"16776","spectator",0,1,0,0,1
"16777","spectators",0,0,0,1,1
"16778","speculate",0,1,0,0,1
"16779","sped",1,0,0,0,1
"16780","speech”",1,0,0,0,1
"16781","speechabounding",1,0,0,0,1
"16782","speechessheridanpittlords",1,0,0,0,1
"16783","speechless",1,0,0,0,1
"16784","speechsoutherners",1,0,0,0,1
"16785","speechthe",1,0,0,0,1
"16786","speeding",1,0,0,0,1
"16787","spended",0,0,0,1,1
"16788","spends",1,0,0,0,1
"16789","spentsharp",1,0,0,0,1
"16790","sphere”",1,0,0,0,1
"16791","spheres",0,1,0,0,1
"16792","spirit”",1,0,0,0,1
"16793","spiritual”",1,0,0,0,1
"16794","spiteful",1,0,0,0,1
"16795","splender",0,0,0,1,1
"16796","splendour",0,0,0,1,1
"16797","splitter",1,0,0,0,1
"16798","spokesman",1,0,0,0,1
"16799","spoon",0,1,0,0,1
"16800","spooner",1,0,0,0,1
"16801","spooners",1,0,0,0,1
"16802","sportsman’s",0,1,0,0,1
"16803","spotless",1,0,0,0,1
"16804","spotted",0,0,0,1,1
"16805","spotthe",1,0,0,0,1
"16806","spouse",0,1,0,0,1
"16807","spouted",0,0,0,1,1
"16808","sprague",1,0,0,0,1
"16809","sprang",0,0,1,0,1
"16810","sprawling",0,0,1,0,1
"16811","spray",0,0,0,1,1
"16812","springling",0,0,0,1,1
"16813","springtime",1,0,0,0,1
"16814","springy",0,1,0,0,1
"16815","spung",0,0,0,1,1
"16816","spurgeon",0,0,0,1,1
"16817","spurning",1,0,0,0,1
"16818","squadron",0,1,0,0,1
"16819","squaler",0,0,0,1,1
"16820","squandered",1,0,0,0,1
"16821","squandering",1,0,0,0,1
"16822","squares",0,0,0,1,1
"16823","squirming",1,0,0,0,1
"16824","stablefloor",1,0,0,0,1
"16825","stagecoach",1,0,0,0,1
"16826","stagedriver",1,0,0,0,1
"16827","stagefriends",1,0,0,0,1
"16828","stages",1,0,0,0,1
"16829","staggers",0,0,1,0,1
"16830","stain",0,1,0,0,1
"16831","stains",0,1,0,0,1
"16832","stakes",1,0,0,0,1
"16833","stamina",0,1,0,0,1
"16834","stamps",0,1,0,0,1
"16835","standard_",0,1,0,0,1
"16836","standards",0,1,0,0,1
"16837","standers",0,1,0,0,1
"16838","standpoint",1,0,0,0,1
"16839","standwhere",1,0,0,0,1
"16840","stanley",0,0,1,0,1
"16841","stanton’s",1,0,0,0,1
"16842","stantons",0,0,0,1,1
"16843","star”",1,0,0,0,1
"16844","starch",0,1,0,0,1
"16845","starcrowned",1,0,0,0,1
"16846","startle",1,0,0,0,1
"16847","starve”",1,0,0,0,1
"16848","starves",0,0,1,0,1
"16849","state”",1,0,0,0,1
"16850","stateroom",0,0,0,1,1
"16851","statesinaugurated",1,0,0,0,1
"16852","statesnot",1,0,0,0,1
"16853","statesone",1,0,0,0,1
"16854","statistics",1,0,0,0,1
"16855","statues",1,0,0,0,1
"16856","steadiness",1,0,0,0,1
"16857","stealth",1,0,0,0,1
"16858","steamed",1,0,0,0,1
"16859","steamships",0,1,0,0,1
"16860","steel”",1,0,0,0,1
"16861","steeltrap",1,0,0,0,1
"16862","steer",1,0,0,0,1
"16863","steet",0,0,0,1,1
"16864","stem",1,0,0,0,1
"16865","stepchildren",1,0,0,0,1
"16866","stepmother",1,0,0,0,1
"16867","stepping",1,0,0,0,1
"16868","stereotype",0,0,1,0,1
"16869","stereotyped",0,0,1,0,1
"16870","sterner",1,0,0,0,1
"16871","sterrotyped",0,0,0,1,1
"16872","steve",0,1,0,0,1
"16873","stevens",1,0,0,0,1
"16874","steward",1,0,0,0,1
"16875","stickney",1,0,0,0,1
"16876","stigmatized",0,1,0,0,1
"16877","still”",1,0,0,0,1
"16878","stimulates",0,1,0,0,1
"16879","stinting",0,0,1,0,1
"16880","stipulate",1,0,0,0,1
"16881","stirs",1,0,0,0,1
"16882","stocked",1,0,0,0,1
"16883","stocks",0,1,0,0,1
"16884","stole",1,0,0,0,1
"16885","stolid",0,1,0,0,1
"16886","stomach",1,0,0,0,1
"16887","stooped",1,0,0,0,1
"16888","stored",1,0,0,0,1
"16889","storehouses",1,0,0,0,1
"16890","storrs",1,0,0,0,1
"16891","story”",1,0,0,0,1
"16892","stoutly",0,1,0,0,1
"16893","stowed",0,0,1,0,1
"16894","stoweother",1,0,0,0,1
"16895","straight”",1,0,0,0,1
"16896","straightened",1,0,0,0,1
"16897","straightforward",1,0,0,0,1
"16898","straightway",0,0,1,0,1
"16899","strains",0,0,0,1,1
"16900","strand",0,0,0,1,1
"16901","strangeness",0,1,0,0,1
"16902","stranger”",1,0,0,0,1
"16903","strangersstrangers",1,0,0,0,1
"16904","straps",1,0,0,0,1
"16905","strata",1,0,0,0,1
"16906","stratford",0,0,0,1,1
"16907","straying",1,0,0,0,1
"16908","streaded",0,0,0,1,1
"16909","stream”",1,0,0,0,1
"16910","streamer",0,0,0,1,1
"16911","streams",1,0,0,0,1
"16912","streetgutters",1,0,0,0,1
"16913","streetsong",1,0,0,0,1
"16914","strengthhuman",1,0,0,0,1
"16915","stretch",1,0,0,0,1
"16916","strew",1,0,0,0,1
"16917","strewed",0,1,0,0,1
"16918","strictest",0,1,0,0,1
"16919","strictlytemperate",1,0,0,0,1
"16920","strictness",0,0,1,0,1
"16921","string",0,1,0,0,1
"16922","stringing",0,1,0,0,1
"16923","stripes”",1,0,0,0,1
"16924","stripped",0,0,1,0,1
"16925","stroll",0,0,0,1,1
"16926","strolled",0,0,1,0,1
"16927","strongthe",1,0,0,0,1
"16928","structural",0,1,0,0,1
"16929","struggles",0,1,0,0,1
"16930","strumboli",0,0,0,1,1
"16931","strut",1,0,0,0,1
"16932","strutting",1,0,0,0,1
"16933","stuart",1,0,0,0,1
"16934","stubborn",0,1,0,0,1
"16935","stubbornly",0,0,1,0,1
"16936","stuggle",0,0,0,1,1
"16937","stultified",0,0,1,0,1
"16938","stumbled",0,1,0,0,1
"16939","stumbles",0,1,0,0,1
"16940","stumbling",1,0,0,0,1
"16941","stupidity",0,0,1,0,1
"16942","sturdy",1,0,0,0,1
"16943","sturge",0,1,0,0,1
"16944","styee",0,0,0,1,1
"16945","styled",1,0,0,0,1
"16946","subdelegates",1,0,0,0,1
"16947","subdividing",0,1,0,0,1
"16948","subdue",0,1,0,0,1
"16949","subjectively",1,0,0,0,1
"16950","sublimity",0,0,1,0,1
"16951","subordinates",1,0,0,0,1
"16952","subra",0,0,0,1,1
"16953","subservient",1,0,0,0,1
"16954","subsistence”",1,0,0,0,1
"16955","substitute",1,0,0,0,1
"16956","substituted",0,1,0,0,1
"16957","substitutes",1,0,0,0,1
"16958","substitution",1,0,0,0,1
"16959","subversion",0,0,1,0,1
"16960","subversive",0,1,0,0,1
"16961","successes",1,0,0,0,1
"16962","succession",0,1,0,0,1
"16963","successive",1,0,0,0,1
"16964","successors",1,0,0,0,1
"16965","succored",0,1,0,0,1
"16966","sucessfully",0,1,0,0,1
"16967","such_",0,1,0,0,1
"16968","sud",0,0,0,1,1
"16969","suffrage”",1,0,0,0,1
"16970","suggesting",1,0,0,0,1
"16971","suggests",0,1,0,0,1
"16972","sui",1,0,0,0,1
"16973","suitors",0,1,0,0,1
"16974","sullenly",1,0,0,0,1
"16975","sum_",0,1,0,0,1
"16976","summarily",1,0,0,0,1
"16977","summer”",1,0,0,0,1
"16978","summerhouses",1,0,0,0,1
"16979","summit",0,0,0,1,1
"16980","summits",1,0,0,0,1
"16981","summon",0,1,0,0,1
"16982","sumnerthe",1,0,0,0,1
"16983","sumter",1,0,0,0,1
"16984","sund",0,0,0,1,1
"16985","sundaypious",1,0,0,0,1
"16986","sundering",0,0,1,0,1
"16987","sunken",1,0,0,0,1
"16988","superb",1,0,0,0,1
"16989","superbly",0,1,0,0,1
"16990","supererogation",1,0,0,0,1
"16991","superfluitythe",1,0,0,0,1
"16992","superfluous",1,0,0,0,1
"16993","supernatural",0,1,0,0,1
"16994","superstitions",1,0,0,0,1
"16995","supplanting",1,0,0,0,1
"16996","supplicating",1,0,0,0,1
"16997","supports",0,1,0,0,1
"16998","supposable",1,0,0,0,1
"16999","suppose”",1,0,0,0,1
"17000","surged",1,0,0,0,1
"17001","surging",1,0,0,0,1
"17002","surpassingly",0,0,0,1,1
"17003","surplus",0,1,0,0,1
"17004","surroundingslloyd",1,0,0,0,1
"17005","surroundingslloydburialplacesuperstition",1,0,0,0,1
"17006","susceptibilities",0,1,0,0,1
"17007","susceptible",0,1,0,0,1
"17008","suspects",0,0,1,0,1
"17009","suspicionsmaster’s",1,0,0,0,1
"17010","suspicious",0,1,0,0,1
"17011","suspiciously",1,0,0,0,1
"17012","susquehanna",1,0,0,0,1
"17013","sustains",0,0,1,0,1
"17014","sustentation",0,1,0,0,1
"17015","swallows",1,0,0,0,1
"17016","swarms",0,0,1,0,1
"17017","sway",0,0,1,0,1
"17018","swaying",1,0,0,0,1
"17019","swear",0,0,1,0,1
"17020","swede",1,0,0,0,1
"17021","sweeps",0,0,1,0,1
"17022","sweetened",0,0,1,0,1
"17023","swelled",1,0,0,0,1
"17024","swelling",0,1,0,0,1
"17025","swiftwinged",1,0,0,0,1
"17026","swindled",1,0,0,0,1
"17027","swiss",0,0,0,1,1
"17028","switches_",0,1,0,0,1
"17029","swollen",0,0,1,0,1
"17030","sydney",1,0,0,0,1
"17031","syllables",0,1,0,0,1
"17032","symbol",1,0,0,0,1
"17033","symmetryno",1,0,0,0,1
"17034","sympathizer",1,0,0,0,1
"17035","sympathizes",0,1,0,0,1
"17036","tabernacle",1,0,0,0,1
"17037","tableand",1,0,0,0,1
"17038","tablets ",0,0,0,1,1
"17039","tabooed",0,1,0,0,1
"17040","taccillo",0,0,0,1,1
"17041","tackle",1,0,0,0,1
"17042","tactics",1,0,0,0,1
"17043","tailed",0,1,0,0,1
"17044","taints",0,1,0,0,1
"17045","talker",0,0,0,1,1
"17046","talks",0,0,0,1,1
"17047","tallbacked",1,0,0,0,1
"17048","taller",0,1,0,0,1
"17049","tamboreenes",0,0,0,1,1
"17050","tangled",1,0,0,0,1
"17051","tank’ee",0,1,0,0,1
"17052","tapering",0,1,0,0,1
"17053","tapers",0,1,0,0,1
"17054","tapped",1,0,0,0,1
"17055","target",1,0,0,0,1
"17056","tarpaulin",1,0,0,0,1
"17057","tarried",1,0,0,0,1
"17058","tarring",0,0,1,0,1
"17059","taska",1,0,0,0,1
"17060","tasked",0,0,1,0,1
"17061","taskmasters",1,0,0,0,1
"17062","tasks",1,0,0,0,1
"17063","tasted",1,0,0,0,1
"17064","tatters",1,0,0,0,1
"17065","tavern",1,0,0,0,1
"17066","tavernsthat",1,0,0,0,1
"17067","teache",0,0,0,1,1
"17068","teacher”",1,0,0,0,1
"17069","teachings",0,1,0,0,1
"17070","teardrop",1,0,0,0,1
"17071","teaspoon",1,0,0,0,1
"17072","teemed",1,0,0,0,1
"17073","teetotal",1,0,0,0,1
"17074","teh",0,0,0,1,1
"17075","telltale",1,0,0,0,1
"17076","temperance”",1,0,0,0,1
"17077","temperately",1,0,0,0,1
"17078","temporizing",0,1,0,0,1
"17079","tenacity",0,1,0,0,1
"17080","tend",1,0,0,0,1
"17081","tenderhearted",1,0,0,0,1
"17082","tendernesssuch",1,0,0,0,1
"17083","tenn",1,0,0,0,1
"17084","tens",0,1,0,0,1
"17085","tension",1,0,0,0,1
"17086","tenth",0,1,0,0,1
"17087","termed",0,1,0,0,1
"17088","terminated",0,1,0,0,1
"17089","terrace",0,0,0,1,1
"17090","terraced",0,0,0,1,1
"17091","terrific",1,0,0,0,1
"17092","territory”",1,0,0,0,1
"17093","terrorstricken",1,0,0,0,1
"17094","terseness",0,1,0,0,1
"17095","tes",0,0,0,1,1
"17096","tests",0,0,1,0,1
"17097","teuck",0,0,0,1,1
"17098","th ",0,0,0,1,1
"17099","th took",0,0,0,1,1
"17100","th’s",1,0,0,0,1
"17101","thand",1,0,0,0,1
"17102","thankfully",0,1,0,0,1
"17103","thanksgivings",0,1,0,0,1
"17104","that’s",0,1,0,0,1
"17105","thawed",1,0,0,0,1
"17106","thayer",1,0,0,0,1
"17107","theatre",1,0,0,0,1
"17108","theatricals",0,0,0,1,1
"17109","thelious",0,0,0,1,1
"17110","them_",0,1,0,0,1
"17111","theme",0,1,0,0,1
"17112","themthat",1,0,0,0,1
"17113","themthree",1,0,0,0,1
"17114","then_",0,1,0,0,1
"17115","thenceforward",1,0,0,0,1
"17116","theological",0,1,0,0,1
"17117","theoretical",1,0,0,0,1
"17118","therby",0,1,0,0,1
"17119","thereat",0,1,0,0,1
"17120","therehopessuspicionsthe",1,0,0,0,1
"17121","therein",1,0,0,0,1
"17122","thereof”",1,0,0,0,1
"17123","theretimeworn",1,0,0,0,1
"17124","theretofore",1,0,0,0,1
"17125","therewith",0,1,0,0,1
"17126","they_",0,1,0,0,1
"17127","theyfree",1,0,0,0,1
"17128","thieve",0,0,1,0,1
"17129","things”",1,0,0,0,1
"17130","thinkwas",1,0,0,0,1
"17131","thinned",0,1,0,0,1
"17132","thirds",0,0,0,1,1
"17133","thirsted",0,1,0,0,1
"17134","thirtyfive",1,0,0,0,1
"17135","thirtyfour",1,0,0,0,1
"17136","thisthe",1,0,0,0,1
"17137","thomas_",0,1,0,0,1
"17138","thomas’",1,0,0,0,1
"17139","thong",0,1,0,0,1
"17140","thorough",1,0,0,0,1
"17141","though ",0,0,0,1,1
"17142","thoughtfully",0,1,0,0,1
"17143","thoughtlessness",0,0,1,0,1
"17144","thoughtno",1,0,0,0,1
"17145","thralled",1,0,0,0,1
"17146","threaded",0,0,0,1,1
"17147","threatre",0,0,0,1,1
"17148","threefifths",1,0,0,0,1
"17149","threelegged",1,0,0,0,1
"17150","threshold",0,1,0,0,1
"17151","thrice",0,1,0,0,1
"17152","thricecursed",1,0,0,0,1
"17153","thrift",1,0,0,0,1
"17154","thrist",0,1,0,0,1
"17155","thrives",0,1,0,0,1
"17156","thriving",1,0,0,0,1
"17157","throbbing",0,0,1,0,1
"17158","throve",1,0,0,0,1
"17159","thrust",1,0,0,0,1
"17160","thucydides",1,0,0,0,1
"17161","thugs",1,0,0,0,1
"17162","thump",1,0,0,0,1
"17163","thunderbolt",1,0,0,0,1
"17164","thunderbolts",1,0,0,0,1
"17165","thunderous",1,0,0,0,1
"17166","thundershower",1,0,0,0,1
"17167","thunderstruck",1,0,0,0,1
"17168","thurlow",0,1,0,0,1
"17169","tick",1,0,0,0,1
"17170","tied_",0,1,0,0,1
"17171","tied”",1,0,0,0,1
"17172","tilgman",0,1,0,0,1
"17173","timber”",1,0,0,0,1
"17174","timbrel",1,0,0,0,1
"17175","time_",0,1,0,0,1
"17176","time”“come",1,0,0,0,1
"17177","timehonored",1,0,0,0,1
"17178","timethis",1,0,0,0,1
"17179","timing",1,0,0,0,1
"17180","tinge",0,1,0,0,1
"17181","tirade",1,0,0,0,1
"17182","tire",1,0,0,0,1
"17183","tithe",0,0,1,0,1
"17184","titles",1,0,0,0,1
"17185","tobaccohouses",1,0,0,0,1
"17186","today”",1,0,0,0,1
"17187","toes",0,0,1,0,1
"17188","toilhonest",1,0,0,0,1
"17189","toiling",1,0,0,0,1
"17190","toilworn",1,0,0,0,1
"17191","tokens",0,1,0,0,1
"17192","tombs”",1,0,0,0,1
"17193","toney",1,0,0,0,1
"17194","tongued",0,1,0,0,1
"17195","tonne",0,0,0,1,1
"17196","tools”",1,0,0,0,1
"17197","topp",0,1,0,0,1
"17198","tornado",0,1,0,0,1
"17199","toronto",1,0,0,0,1
"17200","torrents",1,0,0,0,1
"17201","torrey",1,0,0,0,1
"17202","tortures",0,0,1,0,1
"17203","torturing",1,0,0,0,1
"17204","tory",1,0,0,0,1
"17205","toted",0,1,0,0,1
"17206","toting",0,1,0,0,1
"17207","toughness",1,0,0,0,1
"17208","tought",0,0,0,1,1
"17209","toussaint",1,0,0,0,1
"17210","towels",0,1,0,0,1
"17211","towered",0,1,0,0,1
"17212","towers",0,0,0,1,1
"17213","town”",1,0,0,0,1
"17214","townhouse",1,0,0,0,1
"17215","townsend",0,0,1,0,1
"17216","toyet",1,0,0,0,1
"17217","tracks",1,0,0,0,1
"17218","trade_",0,1,0,0,1
"17219","traders”",1,0,0,0,1
"17220","tradersalone",1,0,0,0,1
"17221","tradition",1,0,0,0,1
"17222","traditional",1,0,0,0,1
"17223","traditions",1,0,0,0,1
"17224","trafficers",1,0,0,0,1
"17225","trafficker",0,0,1,0,1
"17226","trafficking",0,1,0,0,1
"17227","trainers",0,1,0,0,1
"17228","trajen",0,0,0,1,1
"17229","trammel",0,1,0,0,1
"17230","tramp",1,0,0,0,1
"17231","tramples",0,1,0,0,1
"17232","tranquility",1,0,0,0,1
"17233","tranquillity",0,1,0,0,1
"17234","transact",0,1,0,0,1
"17235","transactionthe",1,0,0,0,1
"17236","transcend",1,0,0,0,1
"17237","transcended",0,0,0,1,1
"17238","translated",1,0,0,0,1
"17239","transpiring",1,0,0,0,1
"17240","transport",1,0,0,0,1
"17241","trash_",0,1,0,0,1
"17242","trash”",1,0,0,0,1
"17243","travel”",1,0,0,0,1
"17244","travelled",0,0,1,0,1
"17245","traveller",0,0,0,1,1
"17246","treadingyard",1,0,0,0,1
"17247","treats",1,0,0,0,1
"17248","tremblingly",1,0,0,0,1
"17249","trenched",0,1,0,0,1
"17250","trenches",1,0,0,0,1
"17251","tres",0,0,0,1,1
"17252","trespassed",1,0,0,0,1
"17253","trespassers",1,0,0,0,1
"17254","tribes",0,1,0,0,1
"17255","tribunals",0,1,0,0,1
"17256","trifler",1,0,0,0,1
"17257","trifling_",0,1,0,0,1
"17258","trigger",0,0,1,0,1
"17259","trimmed”",1,0,0,0,1
"17260","trimmers",1,0,0,0,1
"17261","trimming",0,0,1,0,1
"17262","trio",1,0,0,0,1
"17263","trips",1,0,0,0,1
"17264","trite",1,0,0,0,1
"17265","troop",0,1,0,0,1
"17266","trot",0,1,0,0,1
"17267","trouble ",0,0,0,1,1
"17268","troublesome",1,0,0,0,1
"17269","truant",0,1,0,0,1
"17270","trumbull",1,0,0,0,1
"17271","trusting",1,0,0,0,1
"17272","trusty",0,0,1,0,1
"17273","tucel",0,0,0,1,1
"17274","tucked",0,0,0,1,1
"17275","tuesd",0,0,0,1,1
"17276","tumble”",1,0,0,0,1
"17277","tumblers",1,0,0,0,1
"17278","tune",0,0,1,0,1
"17279","turbined",0,0,0,1,1
"17280","turkey",0,1,0,0,1
"17281","turkeyhouses",1,0,0,0,1
"17282","turmoil",1,0,0,0,1
"17283","turner’s",0,1,0,0,1
"17284","turnera",1,0,0,0,1
"17285","tutors",0,1,0,0,1
"17286","twentyfour",1,0,0,0,1
"17287","twentyone",1,0,0,0,1
"17288","twentyseven",1,0,0,0,1
"17289","twilight",0,0,1,0,1
"17290","twin",1,0,0,0,1
"17291","twine",1,0,0,0,1
"17292","twinkle",1,0,0,0,1
"17293","twisting",1,0,0,0,1
"17294","twitch",1,0,0,0,1
"17295","twofold",0,0,1,0,1
"17296","twothat",1,0,0,0,1
"17297","twothirds",1,0,0,0,1
"17298","tyler",1,0,0,0,1
"17299","tyler’s",1,0,0,0,1
"17300","typical",0,0,0,1,1
"17301","ufizzi",0,0,0,1,1
"17302","ultra",1,0,0,0,1
"17303","ultraist",1,0,0,0,1
"17304","ulysses",1,0,0,0,1
"17305","umberella",0,0,0,1,1
"17306","umbrageous",1,0,0,0,1
"17307","umbrl",0,0,0,1,1
"17308","unabated",0,0,1,0,1
"17309","unaccountable",0,0,1,0,1
"17310","unaided",1,0,0,0,1
"17311","unannounced",1,0,0,0,1
"17312","unanswerable",1,0,0,0,1
"17313","unanswered",1,0,0,0,1
"17314","unapproachablethe",1,0,0,0,1
"17315","unascertained",1,0,0,0,1
"17316","unassailable",1,0,0,0,1
"17317","unassailed",1,0,0,0,1
"17318","unassisted",0,1,0,0,1
"17319","unbending",0,0,1,0,1
"17320","unbidden",1,0,0,0,1
"17321","unborn",1,0,0,0,1
"17322","uncared",0,1,0,0,1
"17323","uncertainties",0,1,0,0,1
"17324","unchanging",1,0,0,0,1
"17325","unchecked",0,1,0,0,1
"17326","unchristian",1,0,0,0,1
"17327","uncivil",1,0,0,0,1
"17328","uncivilized",1,0,0,0,1
"17329","uncleanness",0,0,1,0,1
"17330","uncomfortableabout",1,0,0,0,1
"17331","unconditional",0,1,0,0,1
"17332","uncongenial",1,0,0,0,1
"17333","unconquerable",0,1,0,0,1
"17334","unconsciously",1,0,0,0,1
"17335","unconsidered",1,0,0,0,1
"17336","uncontrolled",0,1,0,0,1
"17337","uncorrupted",1,0,0,0,1
"17338","uncoverted",0,1,0,0,1
"17339","uncursed",1,0,0,0,1
"17340","undecipherable",1,0,0,0,1
"17341","undefinable",1,0,0,0,1
"17342","under_",0,1,0,0,1
"17343","underling",0,1,0,0,1
"17344","underlings”",1,0,0,0,1
"17345","undermining",0,1,0,0,1
"17346","understandings",0,1,0,0,1
"17347","understands",0,1,0,0,1
"17348","undertakes",0,1,0,0,1
"17349","undertakings",1,0,0,0,1
"17350","undeserved",0,1,0,0,1
"17351","undeservedly",1,0,0,0,1
"17352","undesirableness",1,0,0,0,1
"17353","undevotional",0,1,0,0,1
"17354","undistinguishable",0,1,0,0,1
"17355","undreamed",1,0,0,0,1
"17356","undressing",0,1,0,0,1
"17357","undying",0,1,0,0,1
"17358","unearthed",0,0,0,1,1
"17359","unenlightened",0,1,0,0,1
"17360","unequalled",0,0,0,1,1
"17361","unextinguished",1,0,0,0,1
"17362","unfair",1,0,0,0,1
"17363","unfairness",1,0,0,0,1
"17364","unfaithful",1,0,0,0,1
"17365","unfaithfulness",1,0,0,0,1
"17366","unfaltering",0,1,0,0,1
"17367","unfeigned",0,0,1,0,1
"17368","unfinished",1,0,0,0,1
"17369","unfitness",1,0,0,0,1
"17370","unfolded",0,1,0,0,1
"17371","unfriends",1,0,0,0,1
"17372","unfurl",0,0,1,0,1
"17373","unfurled",1,0,0,0,1
"17374","ungentlemanly",0,1,0,0,1
"17375","ungrateful”",1,0,0,0,1
"17376","unhealed",0,1,0,0,1
"17377","unheard",1,0,0,0,1
"17378","unhesitatingly_",0,1,0,0,1
"17379","uniformity",0,1,0,0,1
"17380","uniformity“",1,0,0,0,1
"17381","uniforms",1,0,0,0,1
"17382","unimpeachable",0,0,1,0,1
"17383","unimproved",1,0,0,0,1
"17384","unintentionally",0,0,1,0,1
"17385","uninviting",1,0,0,0,1
"17386","union’",1,0,0,0,1
"17387","union”",1,0,0,0,1
"17388","unitarian",1,0,0,0,1
"17389","unites",0,1,0,0,1
"17390","univers",0,0,0,1,1
"17391","universally",0,0,1,0,1
"17392","universe_",0,1,0,0,1
"17393","unkindness",1,0,0,0,1
"17394","unloaded",1,0,0,0,1
"17395","unlock",1,0,0,0,1
"17396","unlocked",1,0,0,0,1
"17397","unmade",1,0,0,0,1
"17398","unmake",0,1,0,0,1
"17399","unmannerly",0,0,1,0,1
"17400","unmarked",0,1,0,0,1
"17401","unmeaning",0,0,1,0,1
"17402","unmeasured",1,0,0,0,1
"17403","unmistakably",1,0,0,0,1
"17404","unmixed",1,0,0,0,1
"17405","unmotherly",0,1,0,0,1
"17406","unmoved",0,0,1,0,1
"17407","unobtrusive",1,0,0,0,1
"17408","unpopularity",1,0,0,0,1
"17409","unpractical",1,0,0,0,1
"17410","unprecedented",1,0,0,0,1
"17411","unprejudiced",1,0,0,0,1
"17412","unpropitious",0,1,0,0,1
"17413","unquestioned",1,0,0,0,1
"17414","unraveled",0,1,0,0,1
"17415","unreasonably",0,1,0,0,1
"17416","unrecognized",1,0,0,0,1
"17417","unrepentant",0,1,0,0,1
"17418","unrestrained",0,1,0,0,1
"17419","unrestricted",0,1,0,0,1
"17420","unrighteous",0,1,0,0,1
"17421","unruffled",1,0,0,0,1
"17422","unruly",1,0,0,0,1
"17423","unsaintly",1,0,0,0,1
"17424","unselfish",1,0,0,0,1
"17425","unsettle",1,0,0,0,1
"17426","unskilled",0,1,0,0,1
"17427","unsophisticated",0,1,0,0,1
"17428","unsound",1,0,0,0,1
"17429","unsparing",0,1,0,0,1
"17430","unsparingly",1,0,0,0,1
"17431","unsteady",0,1,0,0,1
"17432","unstinted",1,0,0,0,1
"17433","unsubjected",1,0,0,0,1
"17434","unsubstantial",1,0,0,0,1
"17435","unsuccessfully",0,1,0,0,1
"17436","unsuitable",0,0,1,0,1
"17437","unsupplied",1,0,0,0,1
"17438","unsupported",1,0,0,0,1
"17439","unsurpassed",1,0,0,0,1
"17440","unswerving",1,0,0,0,1
"17441","unsystematized",1,0,0,0,1
"17442","untanned",0,1,0,0,1
"17443","untimely",0,0,1,0,1
"17444","untutored",1,0,0,0,1
"17445","unvarnished",1,0,0,0,1
"17446","unvarying",0,1,0,0,1
"17447","unveiled",1,0,0,0,1
"17448","unwearied",1,0,0,0,1
"17449","unwillingly",1,0,0,0,1
"17450","unwise",1,0,0,0,1
"17451","unwritten",1,0,0,0,1
"17452","upheaval",1,0,0,0,1
"17453","upheld",1,0,0,0,1
"17454","upholds",0,1,0,0,1
"17455","upper_",0,1,0,0,1
"17456","uprightly",0,1,0,0,1
"17457","uproarious",0,1,0,0,1
"17458","upstairs",0,1,0,0,1
"17459","urch",0,0,0,1,1
"17460","urgent",0,1,0,0,1
"17461","urges",0,0,0,1,1
"17462","us_",0,1,0,0,1
"17463","uswithin",1,0,0,0,1
"17464","utensils",0,1,0,0,1
"17465","utility",0,0,0,1,1
"17466","utilizing",1,0,0,0,1
"17467","vacated",1,0,0,0,1
"17468","valentine",1,0,0,0,1
"17469","valid",0,1,0,0,1
"17470","vanish",1,0,0,0,1
"17471","vanishes",0,1,0,0,1
"17472","vanities",1,0,0,0,1
"17473","vapear",0,0,0,1,1
"17474","varianceposition",1,0,0,0,1
"17475","variegated",1,0,0,0,1
"17476","varnish",1,0,0,0,1
"17477","vary",0,1,0,0,1
"17478","vastness",0,0,0,1,1
"17479","vaucluse",0,0,0,1,1
"17480","vault",0,1,0,0,1
"17481","vechies",0,0,0,1,1
"17482","vegetable",0,1,0,0,1
"17483","vegetables",0,0,1,0,1
"17484","vegetation",0,0,0,1,1
"17485","velvet",0,1,0,0,1
"17486","velvetlike",1,0,0,0,1
"17487","veneering",1,0,0,0,1
"17488","vengeful",1,0,0,0,1
"17489","venomous",0,1,0,0,1
"17490","venti sep",0,0,0,1,1
"17491","veracity",0,0,1,0,1
"17492","veranda",1,0,0,0,1
"17493","verandas",1,0,0,0,1
"17494","verbal",0,1,0,0,1
"17495","veretable",0,0,0,1,1
"17496","veriest",0,1,0,0,1
"17497","verified",1,0,0,0,1
"17498","versatility",0,1,0,0,1
"17499","verses",0,1,0,0,1
"17500","vesey",1,0,0,0,1
"17501","vessuvious",0,0,0,1,1
"17502","vesuvious",0,0,0,1,1
"17503","veteran",1,0,0,0,1
"17504","veterans",1,0,0,0,1
"17505","vex",0,1,0,0,1
"17506","vexing",0,1,0,0,1
"17507","via",0,0,0,1,1
"17508","viands",1,0,0,0,1
"17509","vibrations",0,1,0,0,1
"17510","vicchio",0,0,0,1,1
"17511","vicclieo",0,0,0,1,1
"17512","vicepresidentandrew",1,0,0,0,1
"17513","victorea",0,0,0,1,1
"17514","victoria",0,0,0,1,1
"17515","victoria’s",0,1,0,0,1
"17516","vilest",0,1,0,0,1
"17517","ville",0,0,0,1,1
"17518","vincibility",1,0,0,0,1
"17519","vines",0,0,0,1,1
"17520","violating",0,1,0,0,1
"17521","violator",0,1,0,0,1
"17522","violets",0,0,0,1,1
"17523","viper",0,1,0,0,1
"17524","virgil",0,0,0,1,1
"17525","virginiacoarse",1,0,0,0,1
"17526","virginian",0,1,0,0,1
"17527","visaged",0,0,1,0,1
"17528","vitoriea",0,0,0,1,1
"17529","vitriori",0,0,0,1,1
"17530","vivacious",0,1,0,0,1
"17531","vividness",0,0,0,1,1
"17532","vocalists",0,1,0,0,1
"17533","vol",1,0,0,0,1
"17534","volcanic",0,0,0,1,1
"17535","voluntarily",1,0,0,0,1
"17536","voluntary",0,0,1,0,1
"17537","vote”",1,0,0,0,1
"17538","voter",1,0,0,0,1
"17539","w h",1,0,0,0,1
"17540","w w",1,0,0,0,1
"17541","w.h",0,1,0,0,1
"17542","wading",0,1,0,0,1
"17543","waft",0,1,0,0,1
"17544","waging",1,0,0,0,1
"17545","wagon",1,0,0,0,1
"17546","wagoners",0,0,0,1,1
"17547","waif",0,1,0,0,1
"17548","wails",0,1,0,0,1
"17549","waitinggirl",1,0,0,0,1
"17550","waken",0,0,1,0,1
"17551","walketh",0,1,0,0,1
"17552","walpole’s",1,0,0,0,1
"17553","wanderer",0,1,0,0,1
"17554","wanderings",0,1,0,0,1
"17555","wanders",0,0,1,0,1
"17556","wane",0,0,0,1,1
"17557","wanfism",0,0,0,1,1
"17558","wards",1,0,0,0,1
"17559","ware",0,0,0,1,1
"17560","wares",0,0,0,1,1
"17561","warfare",1,0,0,0,1
"17562","warmer",0,0,0,1,1
"17563","warmuch",1,0,0,0,1
"17564","warner",1,0,0,0,1
"17565","warnings",0,1,0,0,1
"17566","warrior",1,0,0,0,1
"17567","wartroubled",1,0,0,0,1
"17568","wasas",1,0,0,0,1
"17569","washhouses",1,0,0,0,1
"17570","washingmachines",1,0,0,0,1
"17571","washington ",0,0,0,1,1
"17572","washington_",0,1,0,0,1
"17573","washingtonthe",1,0,0,0,1
"17574","wasthe",1,0,0,0,1
"17575","watchthe",1,0,0,0,1
"17576","wately",0,0,0,1,1
"17577","water”",1,0,0,0,1
"17578","water”“fred",1,0,0,0,1
"17579","waterfowl",1,0,0,0,1
"17580","watering",1,0,0,0,1
"17581","waterloo",1,0,0,0,1
"17582","watermill",0,1,0,0,1
"17583","waterpowers",1,0,0,0,1
"17584","wattles",1,0,0,0,1
"17585","waukerusia",1,0,0,0,1
"17586","wavea",1,0,0,0,1
"17587","waved",0,0,1,0,1
"17588","waving",0,1,0,0,1
"17589","wax",0,0,0,1,1
"17590","way ",0,0,0,1,1
"17591","way’",1,0,0,0,1
"17592","wayafforded",1,0,0,0,1
"17593","wayand",1,0,0,0,1
"17594","wayfaring",0,1,0,0,1
"17595","wayi",1,0,0,0,1
"17596","we’ve",0,1,0,0,1
"17597","weakthe",1,0,0,0,1
"17598","wealthiest",1,0,0,0,1
"17599","wealthnegro",1,0,0,0,1
"17600","wearily",0,1,0,0,1
"17601","weariness",1,0,0,0,1
"17602","wears",0,1,0,0,1
"17603","weath",0,0,0,1,1
"17604","weathe",0,0,0,1,1
"17605","weatherbeaten",1,0,0,0,1
"17606","weaver",0,0,1,0,1
"17607","websterian",1,0,0,0,1
"17608","wedges",1,0,0,0,1
"17609","wednesdsay",0,0,0,1,1
"17610","weeden’s",0,1,0,0,1
"17611","weedens",0,1,0,0,1
"17612","weekday",1,0,0,0,1
"17613","weigh",0,1,0,0,1
"17614","weights",1,0,0,0,1
"17615","welded",0,1,0,0,1
"17616","wellarmed",1,0,0,0,1
"17617","wellbred",1,0,0,0,1
"17618","welldoing",1,0,0,0,1
"17619","wellformed",1,0,0,0,1
"17620","wellframed",1,0,0,0,1
"17621","wellgreat",1,0,0,0,1
"17622","wellmatched",1,0,0,0,1
"17623","wellmeaning",1,0,0,0,1
"17624","wellmounted",1,0,0,0,1
"17625","wellnigh",1,0,0,0,1
"17626","welloiled",1,0,0,0,1
"17627","wells",1,0,0,0,1
"17628","wellworn",1,0,0,0,1
"17629","wemr",1,0,0,0,1
"17630","wer",0,0,0,1,1
"17631","west”",1,0,0,0,1
"17632","western ",0,0,0,1,1
"17633","wethat",1,0,0,0,1
"17634","wetting",0,1,0,0,1
"17635","wharfconversation",1,0,0,0,1
"17636","what’s",0,1,0,0,1
"17637","whathe",1,0,0,0,1
"17638","whatsoever_",0,1,0,0,1
"17639","whatsoever’",1,0,0,0,1
"17640","wheelwright",1,0,0,0,1
"17641","wher",0,0,0,1,1
"17642","whereby",1,0,0,0,1
"17643","whereon",0,1,0,0,1
"17644","wheresoever",1,0,0,0,1
"17645","whereunto",1,0,0,0,1
"17646","whetstone",1,0,0,0,1
"17647","whichever",0,0,1,0,1
"17648","whigs",1,0,0,0,1
"17649","whim",0,1,0,0,1
"17650","whining",0,0,1,0,1
"17651","whip”",1,0,0,0,1
"17652","whipped_",0,1,0,0,1
"17653","whippers",0,0,1,0,1
"17654","whipscarred",1,0,0,0,1
"17655","whipt",1,0,0,0,1
"17656","whisperings",1,0,0,0,1
"17657","whistle",0,1,0,0,1
"17658","whistled",1,0,0,0,1
"17659","white’s",0,1,0,0,1
"17660","whited",0,0,1,0,1
"17661","whitened",1,0,0,0,1
"17662","whitethe",1,0,0,0,1
"17663","whitewashed",1,0,0,0,1
"17664","whitewashedinterspersed",1,0,0,0,1
"17665","whither",1,0,0,0,1
"17666","whiting",1,0,0,0,1
"17667","whittle",1,0,0,0,1
"17668","wholesome",0,1,0,0,1
"17669","wholesouled",1,0,0,0,1
"17670","whomsoever",1,0,0,0,1
"17671","whosebase",0,0,0,1,1
"17672","whoso",0,1,0,0,1
"17673","wicked”",1,0,0,0,1
"17674","wickedly",0,1,0,0,1
"17675","wid",1,0,0,0,1
"17676","widesweeping",1,0,0,0,1
"17677","wifefor",1,0,0,0,1
"17678","wifes",0,0,0,1,1
"17679","wilburs",1,0,0,0,1
"17680","wildering",1,0,0,0,1
"17681","wilds",1,0,0,0,1
"17682","wilkes",0,0,1,0,1
"17683","will”",1,0,0,0,1
"17684","william’s",0,1,0,0,1
"17685","willingness",1,0,0,0,1
"17686","willis",0,0,1,0,1
"17687","wilmarth",1,0,0,0,1
"17688","windsor”",1,0,0,0,1
"17689","wink",1,0,0,0,1
"17690","winked",0,0,1,0,1
"17691","winter’s",1,0,0,0,1
"17692","wintertime",1,0,0,0,1
"17693","wipwell",0,0,0,1,1
"17694","wires”",1,0,0,0,1
"17695","wisest",0,1,0,0,1
"17696","withdraw",1,0,0,0,1
"17697","withdrawnwhen",1,0,0,0,1
"17698","wither",0,1,0,0,1
"17699","withersoever",1,0,0,0,1
"17700","withholds",0,0,1,0,1
"17701","withstand",0,1,0,0,1
"17702","witnesses”",1,0,0,0,1
"17703","wits",1,0,0,0,1
"17704","wittingly",0,1,0,0,1
"17705","witty",0,0,1,0,1
"17706","woa",0,1,0,0,1
"17707","woes",0,1,0,0,1
"17708","woestricken",1,0,0,0,1
"17709","wolfthe",1,0,0,0,1
"17710","woman’srightsman",1,0,0,0,1
"17711","womanhood",0,1,0,0,1
"17712","women’s",0,0,1,0,1
"17713","won’t_",0,1,0,0,1
"17714","wondered",1,0,0,0,1
"17715","wonderfulness",0,1,0,0,1
"17716","wondering",1,0,0,0,1
"17717","wonderous",0,0,0,1,1
"17718","wondrously",1,0,0,0,1
"17719","wonted",0,1,0,0,1
"17720","wood’s",1,0,0,0,1
"17721","woodford",1,0,0,0,1
"17722","woodhouses",0,1,0,0,1
"17723","woodhull",0,0,0,1,1
"17724","woodsawyer”",1,0,0,0,1
"17725","woodsexpected",1,0,0,0,1
"17726","woodstalk",1,0,0,0,1
"17727","woodsthe",1,0,0,0,1
"17728","wooed",0,0,0,1,1
"17729","wool",0,0,1,0,1
"17730","woolfolk",0,0,1,0,1
"17731","woolly",0,1,0,0,1
"17732","woonsocket",1,0,0,0,1
"17733","word_",0,1,0,0,1
"17734","wordconsults",1,0,0,0,1
"17735","worde",0,0,0,1,1
"17736","words_",0,1,0,0,1
"17737","wordsmighty",1,0,0,0,1
"17738","wordsthis",1,0,0,0,1
"17739","work_",0,1,0,0,1
"17740","workfellows",1,0,0,0,1
"17741","workgood",1,0,0,0,1
"17742","works”",1,0,0,0,1
"17743","world”",1,0,0,0,1
"17744","worldembracing",1,0,0,0,1
"17745","worldsbut",1,0,0,0,1
"17746","worldthe",1,0,0,0,1
"17747","worldwide",1,0,0,0,1
"17748","wormley",1,0,0,0,1
"17749","worseit",1,0,0,0,1
"17750","worshiper",0,1,0,0,1
"17751","worshiping",0,1,0,0,1
"17752","worshipper",0,0,1,0,1
"17753","worships",0,1,0,0,1
"17754","worthily",0,1,0,0,1
"17755","woul",0,0,0,1,1
"17756","wouldbe",1,0,0,0,1
"17757","wrenched",1,0,0,0,1
"17758","wretchedly",1,0,0,0,1
"17759","wright”",1,0,0,0,1
"17760","wringing",0,1,0,0,1
"17761","wringingmachines",1,0,0,0,1
"17762","wrinkled",0,0,1,0,1
"17763","wrist",0,1,0,0,1
"17764","writemy",1,0,0,0,1
"17765","writes",0,1,0,0,1
"17766","wrongfully",0,0,1,0,1
"17767","wrongfulness",0,1,0,0,1
"17768","ws",0,1,0,0,1
"17769","xenophon",1,0,0,0,1
"17770","yale",1,0,0,0,1
"17771","yates",1,0,0,0,1
"17772","yawning",1,0,0,0,1
"17773","ye_",0,1,0,0,1
"17774","ye”",1,0,0,0,1
"17775","years”",1,0,0,0,1
"17776","yearsfrederick",1,0,0,0,1
"17777","yearsfrom",1,0,0,0,1
"17778","yeeld",0,0,0,1,1
"17779","yellof",1,0,0,0,1
"17780","yellowfever",1,0,0,0,1
"17781","yells",0,1,0,0,1
"17782","yes”",1,0,0,0,1
"17783","yoked",0,0,1,0,1
"17784","yon",0,1,0,0,1
"17785","yonder”“fred",1,0,0,0,1
"17786","york_",0,1,0,0,1
"17787","york”",1,0,0,0,1
"17788","yorkand",1,0,0,0,1
"17789","yorkdeath",1,0,0,0,1
"17790","you_",0,1,0,0,1
"17791","youa",1,0,0,0,1
"17792","zero",1,0,0,0,1
"17793","zest",0,1,0,0,1
"17794","zizag",0,0,0,1,1
