"","word","Life and Times (1881)","My Bondage (1855)","Narrative Life (1845)","Travel Diary","sum_word_counts"
"1","slave",398,539,146,2,1085
"2","slavery",471,470,94,1,1036
"3","time",357,248,126,13,744
"4","master",261,355,124,1,741
"5","slaves",229,286,132,1,648
"6","people",313,166,18,31,528
"7","life",206,186,40,15,447
"8","colored",298,108,29,2,437
"9","day",191,127,50,46,414
"10","free",186,132,36,4,358
"11","house",151,119,44,10,324
"12","home",161,105,42,6,314
"13","white",146,107,44,4,301
"14","covey",99,138,61,0,298
"15","country",180,84,11,9,284
"16","found",118,100,47,16,281
"17","power",155,105,14,5,279
"18","friends",150,94,16,2,262
"19","baltimore",91,113,44,0,248
"20","told",116,82,43,7,248
"21","children",80,127,33,4,244
"22","hands",105,93,41,3,242
"23","called",105,77,37,17,236
"24","hand",109,89,26,4,228
"25","american",108,96,8,7,219
"26","slaveholders",65,121,30,1,217
"27","south",134,62,14,2,212
"28","anti",116,78,13,0,207
"29","left",90,71,42,2,205
"30","condition",93,80,26,1,200
"31","freedom",89,79,29,2,199
"32","thomas",90,85,21,1,197
"33","liberty",96,82,13,0,191
"34","heart",75,88,26,1,190
"35","human",75,96,13,4,188
"36","world",85,77,8,10,180
"37","north",107,50,21,0,178
"38","mind",75,77,21,4,177
"39","god",53,92,25,6,176
"40","night",79,62,26,8,175
"41","plantation",41,97,36,0,174
"42","united",115,54,4,0,173
"43","read",70,65,33,3,171
"44","blood",59,75,35,1,170
"45","escape",69,74,24,1,168
"46","law",83,66,16,0,165
"47","city",85,37,12,28,162
"48","spirit",74,69,17,1,161
"49","poor",62,72,23,0,157
"50","brought",79,57,14,6,156
"51","head",66,61,23,6,156
"52","public",72,76,7,0,155
"53","character",62,74,16,2,154
"54","means",75,61,18,0,154
"55","slaveholder",48,84,22,0,154
"56","words",73,59,20,2,154
"57","nature",64,83,6,0,153
"58","john",107,25,13,5,150
"59","morning",52,50,24,23,149
"60","hugh",58,72,18,0,148
"61","reader",53,93,2,0,148
"62","days",64,50,17,16,147
"63","word",76,48,20,3,147
"64","class",97,37,11,1,146
"65","manner",62,65,12,7,146
"66","auld",63,67,14,0,144
"67","field",58,60,25,1,144
"68","lloyd",61,62,21,0,144
"69","col",50,91,0,0,141
"70","black",70,58,9,0,137
"71","death",53,47,32,4,136
"72","hope",67,47,18,2,134
"73","church",47,61,11,14,133
"74","family",57,61,11,2,131
"75","friend",76,41,6,6,129
"76","mother",45,65,15,4,129
"77","heard",56,53,15,4,128
"78","experience",53,65,9,0,127
"79","hard",51,52,18,6,127
"80","henry",57,43,23,4,127
"81","matter",41,65,21,0,127
"82","war",110,12,4,1,127
"83","negro",87,34,4,0,125
"84","met",61,44,13,5,123
"85","moment",57,47,18,1,123
"86","money",65,40,17,1,123
"87","held",70,40,11,1,122
"88","st",41,59,21,0,121
"89","england",66,44,3,6,119
"90","land",46,51,14,8,119
"91","times",54,41,21,3,119
"92","masters",43,52,23,0,118
"93","true",66,42,9,1,118
"94","union",76,25,17,0,118
"95","question",69,45,3,0,117
"96","sense",59,46,9,3,117
"97","feeling",63,38,13,1,115
"98","hold",49,42,23,0,114
"99","whip",28,55,29,2,114
"100","ground",65,36,8,4,113
"101","week",37,47,27,2,113
"102","meeting",63,34,12,3,112
"103","president",107,4,1,0,112
"104","half",45,38,23,5,111
"105","knowledge",48,53,9,1,111
"106","party",67,42,0,2,111
"107","soul",29,57,24,1,111
"108","view",41,51,5,14,111
"109","justice",56,49,5,0,110
"110","set",51,41,15,2,109
"111","dear",46,51,8,3,108
"112","speech",66,36,6,0,108
"113","stand",45,46,13,4,108
"114","william",51,44,13,0,108
"115","douglass",49,46,11,1,107
"116","lived",39,36,31,1,107
"117","speak",54,39,11,3,107
"118","woman",34,52,17,4,107
"119","subject",51,50,5,0,106
"120","chapter",18,64,23,0,105
"121","overseer",30,59,16,0,105
"122","presence",52,34,15,4,105
"123","brother",35,50,17,2,104
"124","lloyd’s",32,51,21,0,104
"125","government",78,21,3,1,103
"126","moral",44,52,6,0,102
"127","ship",32,43,15,12,102
"128","system",40,56,6,0,102
"129","common",51,39,9,2,101
"130","religious",32,52,15,2,101
"131","school",47,37,14,3,101
"132","race",73,22,5,0,100
"133","woods",35,47,18,0,100
"134","york",62,29,9,0,100
"135","fellow",43,38,15,3,99
"136","received",54,24,15,6,99
"137","wife",38,45,14,2,99
"138","religion",20,54,18,6,98
"139","strong",53,35,5,5,98
"140","ofthe",97,0,0,0,97
"141","stood",42,36,15,4,97
"142","blow",40,44,12,0,96
"143","light",34,49,10,3,96
"144","mistress",32,46,17,1,96
"145","property",43,43,10,0,96
"146","society",40,48,8,0,96
"147","nation",52,39,3,1,95
"148","natural",40,47,8,0,95
"149","reason",47,39,7,2,95
"150","lincoln",93,0,0,1,94
"151","maryland",36,43,15,0,94
"152","bedford",27,46,19,1,93
"153","easily",47,44,1,1,93
"154","labor",51,37,5,0,93
"155","leave",51,26,11,5,93
"156","frederick",43,31,18,0,92
"157","circumstances",40,40,11,0,91
"158","single",31,45,14,1,91
"159","spent",29,34,11,17,91
"160","cruel",30,41,19,0,90
"161","return",36,37,16,1,90
"162","person",35,41,13,0,89
"163","feel",35,35,14,4,88
"164","respect",53,31,2,2,88
"165","till",44,22,17,5,88
"166","live",38,25,21,3,87
"167","master’s",25,46,16,0,87
"168","color",49,32,1,3,85
"169","father",32,41,12,0,85
"170","purpose",44,26,15,0,85
"171","yard",35,37,13,0,85
"172","body",39,36,7,2,84
"173","cold",41,30,11,2,84
"174","southern",44,34,5,1,84
"175","hear",34,33,12,4,83
"176","love",23,45,13,2,83
"177","persons",38,40,4,1,83
"178","truth",29,41,10,3,83
"179","company",40,29,6,7,82
"180","hour",47,26,6,3,82
"181","occasion",54,23,3,2,82
"182","rights",46,30,6,0,82
"183","learn",31,32,18,0,81
"184","care",33,32,14,1,80
"185","miles",30,27,17,6,80
"186","passed",37,28,12,3,80
"187","peace",53,25,0,2,80
"188","ready",35,24,19,2,80
"189","aunt",32,40,7,0,79
"190","doubt",44,30,5,0,79
"191","effect",43,20,13,3,79
"192","michael’s",1,57,21,0,79
"193","run",27,28,22,2,79
"194","seldom",17,42,20,0,79
"195","slaveholding",33,36,10,0,79
"196","thousand",40,28,2,9,79
"197","allowed",34,32,10,2,78
"198","heavy",32,29,13,4,78
"199","living",34,34,9,1,78
"200","looked",36,28,12,2,78
"201","meet",42,25,9,2,78
"202","regard",26,42,10,0,78
"203","brown",73,3,0,1,77
"204","child",24,44,9,0,77
"205","eyes",35,31,5,6,77
"206","freeland",29,33,15,0,77
"207","write",30,31,15,1,77
"208","bill",33,36,7,0,76
"209","coming",36,29,8,3,76
"210","leaving",24,38,13,1,76
"211","object",39,30,7,0,76
"212","whipped",22,32,22,0,76
"213","broken",36,31,5,3,75
"214","months",33,28,13,1,75
"215","result",34,31,10,0,75
"216","boy",28,37,7,2,74
"217","citizens",61,12,0,1,74
"218","dollars",33,31,9,1,74
"219","equal",43,23,4,4,74
"220","fear",37,31,5,1,74
"221","idea",34,33,6,1,74
"222","paper",47,24,3,0,74
"223","sandy",29,35,9,1,74
"224","women",21,25,17,11,74
"225","food",28,34,10,1,73
"226","glad",35,25,11,2,73
"227","history",41,25,4,3,73
"228","hundred",38,23,3,9,73
"229","rochester",58,14,0,1,73
"230","short",27,23,20,3,73
"231","call",33,30,7,2,72
"232","deep",29,29,12,2,72
"233","miss",35,20,0,17,72
"234","remember",28,31,13,0,72
"235","change",34,29,7,1,71
"236","compelled",37,28,6,0,71
"237","convention",58,8,5,0,71
"238","dark",27,32,10,2,71
"239","door",30,26,15,0,71
"240","farm",27,27,16,1,71
"241","feelings",26,32,13,0,71
"242","humanity",26,35,10,0,71
"243","movement",31,39,0,1,71
"244","succeeded",25,26,20,0,71
"245","book",25,29,13,3,70
"246","distance",26,30,12,2,70
"247","duty",42,23,5,0,70
"248","feet",25,25,9,11,70
"249","lash",22,34,13,1,70
"250","learning",29,27,14,0,70
"251","measure",59,10,1,0,70
"252","twenty",29,26,10,5,70
"253","grandmother",17,44,8,0,69
"254","national",48,19,1,1,69
"255","office",49,13,7,0,69
"256","reached",41,18,7,3,69
"257","business",34,25,7,2,68
"258","colonel",15,10,43,0,68
"259","sunday",24,20,7,17,68
"260","voice",36,25,6,1,68
"261","cruelty",16,38,13,0,67
"262","fugitive",30,27,10,0,67
"263","plan",42,18,7,0,67
"264","story",36,25,4,2,67
"265","strange",28,25,5,9,67
"266","strength",29,24,11,3,67
"267","bound",34,23,6,3,66
"268","bring",29,29,7,1,66
"269","horses",25,28,12,1,66
"270","laws",32,30,2,2,66
"271","opinion",29,31,6,0,66
"272","prejudice",34,27,5,0,66
"273","sir",35,28,3,0,66
"274","sort",28,30,8,0,66
"275","board",28,23,7,7,65
"276","capt",37,28,0,0,65
"277","expected",29,25,9,2,65
"278","giving",34,23,7,1,65
"279","learned",24,31,8,2,65
"280","running",29,29,6,1,65
"281","sentiment",45,17,3,0,65
"282","committed",28,29,7,0,64
"283","constitution",47,12,4,1,64
"284","emancipation",43,14,7,0,64
"285","eye",22,26,13,3,64
"286","street",31,21,8,4,64
"287","supposed",24,30,7,3,64
"288","trouble",31,26,6,1,64
"289","age",22,24,14,3,63
"290","america",22,34,2,5,63
"291","form",22,25,9,7,63
"292","pass",25,26,11,1,63
"293","rest",36,20,6,1,63
"294","abroad",34,24,2,2,62
"295","answer",21,24,11,6,62
"296","bondage",24,32,5,1,62
"297","captain",40,8,10,4,62
"298","direction",28,26,7,1,62
"299","lucretia",30,24,8,0,62
"300","noble",30,19,12,1,62
"301","position",34,26,1,1,62
"302","son",27,24,9,2,62
"303","act",33,21,7,0,61
"304","attempt",30,24,7,0,61
"305","grand",30,22,1,8,61
"306","wild",23,28,7,3,61
"307","account",28,28,3,1,60
"308","bay",17,25,14,4,60
"309","bread",20,32,7,1,60
"310","greatly",30,26,4,0,60
"311","influence",31,22,7,0,60
"312","kitchen",24,32,4,0,60
"313","papers",38,21,1,0,60
"314","rule",32,25,3,0,60
"315","abolition",40,18,1,0,59
"316","ago",27,19,3,10,59
"317","beautiful",28,17,5,9,59
"318","conduct",22,31,6,0,59
"319","sight",20,25,7,7,59
"320","soldiers",56,2,0,1,59
"321","wrong",25,29,5,0,59
"322","bear",25,19,11,3,58
"323","forward",23,26,9,0,58
"324","garrison",31,25,2,0,58
"325","marked",23,22,11,2,58
"326","sea",20,11,1,26,58
"327","visit",39,13,3,3,58
"328","covey’s",19,30,8,0,57
"329","guilty",18,32,7,0,57
"330","pleased",26,21,7,3,57
"331","remained",23,25,9,0,57
"332","road",24,20,4,9,57
"333","standing",28,23,4,2,57
"334","taking",22,23,10,2,57
"335","water",19,26,6,6,57
"336","covered",25,21,6,4,56
"337","crime",25,23,7,1,56
"338","edward",25,25,6,0,56
"339","favor",26,21,7,2,56
"340","future",33,18,5,0,56
"341","horse",20,25,9,2,56
"342","letter",29,18,6,3,56
"343","regarded",23,20,13,0,56
"344","scene",28,24,0,4,56
"345","terrible",31,18,7,0,56
"346","treatment",25,25,6,0,56
"347","wished",32,15,9,0,56
"348","advantage",25,24,5,1,55
"349","arms",36,15,3,1,55
"350","attention",28,18,4,5,55
"351","finding",20,25,8,2,55
"352","massachusetts",29,16,9,1,55
"353","northern",25,26,4,0,55
"354","sought",34,16,5,0,55
"355","town",27,13,6,9,55
"356","written",24,23,5,3,55
"357","boston",30,21,3,0,54
"358","considered",24,20,10,0,54
"359","fine",20,18,3,13,54
"360","iron",27,22,5,0,54
"361","privilege",18,26,9,1,54
"362","reasons",29,21,3,1,54
"363","relation",21,29,4,0,54
"364","sold",17,25,10,2,54
"365","tothe",54,0,0,0,54
"366","washington",47,4,3,0,54
"367","wisdom",31,23,0,0,54
"368","existence",18,27,7,1,53
"369","forever",20,23,10,0,53
"370","send",26,23,4,0,53
"371","service",30,19,3,1,53
"372","stay",30,13,5,5,53
"373","step",29,19,5,0,53
"374","appearance",20,22,7,3,52
"375","boys",15,27,8,2,52
"376","corn",21,21,9,1,52
"377","honor",36,9,6,1,52
"378","led",19,28,3,2,52
"379","opportunity",25,19,8,0,52
"380","paid",29,18,4,1,52
"381","pride",26,20,1,5,52
"382","protection",34,13,5,0,52
"383","bitter",21,26,4,0,51
"384","born",21,21,6,3,51
"385","bright",29,16,1,5,51
"386","deeply",18,24,5,4,51
"387","fire",26,17,7,1,51
"388","impossible",23,22,5,1,51
"389","lost",28,19,4,0,51
"390","piece",16,26,8,1,51
"391","prayer",17,23,10,1,51
"392","rich",20,22,5,4,51
"393","bad",15,29,6,0,50
"394","desire",25,16,9,0,50
"395","evidence",18,24,7,1,50
"396","fell",21,17,11,1,50
"397","force",31,14,5,0,50
"398","hours",25,11,9,5,50
"399","inthe",50,0,0,0,50
"400","joy",22,20,8,0,50
"401","lady",29,14,1,6,50
"402","lay",22,15,13,0,50
"403","powerful",24,16,6,4,50
"404","speaking",25,19,5,1,50
"405","success",29,13,8,0,50
"406","abolitionists",23,21,5,0,49
"407","address",26,16,1,6,49
"408","christian",17,23,3,6,49
"409","effort",25,17,6,1,49
"410","gore",14,21,14,0,49
"411","hamilton",15,20,14,0,49
"412","ignorance",22,24,2,1,49
"413","kindness",20,25,4,0,49
"414","necessity",25,17,7,0,49
"415","neighborhood",21,25,3,0,49
"416","peculiar",22,19,4,4,49
"417","sabbath",15,23,11,0,49
"418","subjected",17,22,10,0,49
"419","ten",19,24,5,1,49
"420","thirty",25,21,3,0,49
"421","trade",15,27,7,0,49
"422","views",28,15,3,3,49
"423","wood",19,20,9,1,49
"424","beginning",26,15,5,2,48
"425","carried",23,16,9,0,48
"426","eat",10,18,20,0,48
"427","failed",22,19,7,0,48
"428","fight",26,15,6,1,48
"429","forty",26,13,1,8,48
"430","holidays",16,23,9,0,48
"431","mine",17,26,5,0,48
"432","named",19,20,9,0,48
"433","one",0,0,0,48,48
"434","personal",23,23,2,0,48
"435","reaching",19,24,4,1,48
"436","required",27,15,6,0,48
"437","resolved",21,16,11,0,48
"438","abraham",44,0,0,3,47
"439","building",25,16,1,5,47
"440","due",28,15,4,0,47
"441","duties",22,22,3,0,47
"442","education",26,20,1,0,47
"443","fall",23,19,3,2,47
"444","happiness",18,19,10,0,47
"445","katy",20,27,0,0,47
"446","late",24,15,4,4,47
"447","meant",25,16,6,0,47
"448","month",21,19,7,0,47
"449","pay",22,14,11,0,47
"450","progress",30,16,1,0,47
"451","worse",21,17,9,0,47
"452","ability",21,16,8,1,46
"453","anthony",29,13,4,0,46
"454","cabin",22,24,0,0,46
"455","chains",9,24,11,2,46
"456","chief",25,13,6,2,46
"457","dead",19,19,5,3,46
"458","eastern",21,23,0,2,46
"459","employment",15,14,17,0,46
"460","evil",19,20,7,0,46
"461","heaven",18,22,5,1,46
"462","houses",23,14,5,4,46
"463","johnson",21,14,11,0,46
"464","kindly",16,19,11,0,46
"465","lot",16,23,7,0,46
"466","memory",25,20,0,1,46
"467","millions",25,15,4,2,46
"468","names",15,19,12,0,46
"469","outrage",15,26,5,0,46
"470","proper",17,25,4,0,46
"471","quarter",25,18,2,1,46
"472","shore",18,22,3,3,46
"473","simply",25,19,1,1,46
"474","sympathy",22,19,5,0,46
"475","wealth",24,13,7,2,46
"476","altogether",20,22,3,0,45
"477","british",24,19,0,2,45
"478","died",17,14,12,2,45
"479","don’t",21,19,5,0,45
"480","easy",20,23,2,0,45
"481","gentleman",20,17,5,3,45
"482","invited",34,8,2,1,45
"483","pleasure",14,20,8,3,45
"484","political",29,12,4,0,45
"485","principles",19,24,2,0,45
"486","reach",19,19,5,2,45
"487","rebellion",41,4,0,0,45
"488","scarcely",18,19,7,1,45
"489","simple",21,21,3,0,45
"490","spoke",24,11,8,2,45
"491","suffered",18,19,8,0,45
"492","telling",20,16,8,1,45
"493","treated",19,17,6,3,45
"494","west",29,9,3,4,45
"495","audience",24,14,3,3,44
"496","county",15,19,10,0,44
"497","courage",30,11,3,0,44
"498","disposed",18,15,10,1,44
"499","hall",35,6,1,2,44
"500","intended",20,16,8,0,44
"501","line",27,13,3,1,44
"502","lives",22,16,5,1,44
"503","mere",16,21,6,1,44
"504","painful",12,19,12,1,44
"505","policy",34,10,0,0,44
"506","prison",17,19,8,0,44
"507","refused",25,13,6,0,44
"508","reply",26,13,5,0,44
"509","rise",21,16,4,3,44
"510","secure",23,17,2,2,44
"511","thinking",17,18,9,0,44
"512","toil",21,17,5,1,44
"513","tree",18,16,5,5,44
"514","wages",18,18,8,0,44
"515","wise",31,12,1,0,44
"516","adopted",18,17,7,1,43
"517","bloody",15,13,15,0,43
"518","broad",23,17,2,1,43
"519","charles",29,7,5,2,43
"520","conflict",31,12,0,0,43
"521","difficulty",17,19,7,0,43
"522","farms",11,15,17,0,43
"523","finally",18,12,13,0,43
"524","forget",22,15,6,0,43
"525","hunger",12,23,8,0,43
"526","letters",18,14,5,6,43
"527","mental",18,21,4,0,43
"528","minds",15,20,8,0,43
"529","past",21,18,0,4,43
"530","raised",24,15,4,0,43
"531","relations",22,21,0,0,43
"532","seat",21,19,3,0,43
"533","shocking",18,22,3,0,43
"534","social",22,21,0,0,43
"535","stop",21,13,8,1,43
"536","talk",22,14,7,0,43
"537","understand",15,21,7,0,43
"538","usual",21,16,5,1,43
"539","air",27,13,1,1,42
"540","consideration",27,13,1,1,42
"541","faith",26,12,3,1,42
"542","favorable",18,20,1,3,42
"543","flesh",8,27,6,1,42
"544","holding",22,15,4,1,42
"545","hungry",15,20,7,0,42
"546","immediately",13,10,19,0,42
"547","leading",18,21,3,0,42
"548","prevent",20,18,4,0,42
"549","remain",17,17,6,2,42
"550","republic",32,8,1,1,42
"551","served",18,17,7,0,42
"552","shoulders",12,23,7,0,42
"553","struck",18,18,5,1,42
"554","virginia",33,8,1,0,42
"555","whipping",5,17,20,0,42
"556","corner",20,17,3,1,41
"557","disposition",18,16,7,0,41
"558","entire",16,23,2,0,41
"559","escaped",13,13,15,0,41
"560","excellent",13,21,2,5,41
"561","hired",17,16,8,0,41
"562","honest",21,19,1,0,41
"563","lecture",26,15,0,0,41
"564","loved",19,14,8,0,41
"565","michaels",39,0,2,0,41
"566","walk",17,18,4,2,41
"567","blows",20,18,2,0,40
"568","evening",17,10,3,10,40
"569","evidently",16,20,1,3,40
"570","freeman",15,21,4,0,40
"571","happened",16,19,4,1,40
"572","move",12,13,15,0,40
"573","overseers",16,15,9,0,40
"574","oxen",14,16,9,1,40
"575","proved",17,15,8,0,40
"576","river",18,17,2,3,40
"577","sad",16,20,2,2,40
"578","save",27,8,5,0,40
"579","spoken",23,11,4,2,40
"580","acquainted",12,19,8,0,39
"581","brave",32,6,1,0,39
"582","confidence",21,13,5,0,39
"583","connected",17,17,3,2,39
"584","darkness",11,21,5,2,39
"585","daughter",18,14,6,1,39
"586","efforts",26,9,4,0,39
"587","enjoyed",12,18,8,1,39
"588","fair",21,12,4,2,39
"589","gate",14,15,9,1,39
"590","journey",15,19,3,2,39
"591","keeping",14,20,5,0,39
"592","meetings",21,16,2,0,39
"593","play",20,19,0,0,39
"594","soil",29,6,3,1,39
"595","started",16,13,9,1,39
"596","statement",16,17,6,0,39
"597","suppose",16,12,7,4,39
"598","tied",13,13,13,0,39
"599","watched",17,17,5,0,39
"600","winter",16,19,3,1,39
"601","believed",23,9,4,2,38
"602","brothers",15,20,1,2,38
"603","brutal",14,24,0,0,38
"604","continued",19,13,5,1,38
"605","danger",20,14,4,0,38
"606","description",16,13,6,3,38
"607","determined",20,12,6,0,38
"608","dread",18,17,3,0,38
"609","gained",20,11,6,1,38
"610","labors",22,12,3,1,38
"611","laid",13,19,6,0,38
"612","language",19,15,4,0,38
"613","meal",13,20,4,1,38
"614","ox",15,20,3,0,38
"615","passengers",10,14,0,14,38
"616","physical",15,19,1,3,38
"617","possessed",19,15,4,0,38
"618","powers",16,18,4,0,38
"619","rate",19,14,5,0,38
"620","resistance",18,16,3,1,38
"621","rev",14,14,4,6,38
"622","safe",16,16,6,0,38
"623","taught",22,14,2,0,38
"624","train",25,7,1,5,38
"625","uncle",20,17,1,0,38
"626","warm",13,17,7,1,38
"627","allowance",9,19,9,0,37
"628","caused",20,12,3,2,37
"629","chance",17,14,5,1,37
"630","civilization",25,11,0,1,37
"631","cut",12,19,6,0,37
"632","decided",18,11,7,1,37
"633","earnest",27,9,1,0,37
"634","equally",23,11,3,0,37
"635","exercise",13,20,4,0,37
"636","hon",35,2,0,0,37
"637","husband",11,20,6,0,37
"638","killed",16,10,11,0,37
"639","literally",13,20,4,0,37
"640","man’s",22,12,3,0,37
"641","mercy",14,20,3,0,37
"642","severe",9,14,14,0,37
"643","situation",22,5,10,0,37
"644","songs",10,17,10,0,37
"645","summer",16,17,3,1,37
"646","arrest",21,13,2,0,36
"647","bare",14,20,0,2,36
"648","close",18,13,3,2,36
"649","coarse",12,16,8,0,36
"650","command",20,12,3,1,36
"651","degree",19,11,6,0,36
"652","denied",19,15,1,1,36
"653","earth",15,17,1,3,36
"654","entered",14,17,5,0,36
"655","ferry",34,1,1,0,36
"656","floor",17,11,5,3,36
"657","george",24,10,1,1,36
"658","hopes",15,19,2,0,36
"659","impression",16,12,3,5,36
"660","instance",15,17,4,0,36
"661","james",26,9,1,0,36
"662","pious",12,14,9,1,36
"663","prove",18,16,2,0,36
"664","returned",17,12,6,1,36
"665","rough",18,14,1,3,36
"666","saturday",8,11,9,8,36
"667","shown",18,9,4,5,36
"668","sleep",11,20,5,0,36
"669","smith",23,11,2,0,36
"670","support",21,12,3,0,36
"671","table",20,12,3,1,36
"672","worth",17,15,2,2,36
"673","breaking",13,18,4,0,35
"674","childhood",12,20,3,0,35
"675","clothing",12,13,7,3,35
"676","determination",12,10,13,0,35
"677","district",23,9,3,0,35
"678","fields",15,12,2,6,35
"679","gentlemen",25,7,2,1,35
"680","increase",18,14,2,1,35
"681","iwas",35,0,0,0,35
"682","length",14,12,7,2,35
"683","manhood",15,16,3,1,35
"684","owned",16,12,6,1,35
"685","passing",17,14,1,3,35
"686","proof",17,13,2,3,35
"687","skill",20,13,0,2,35
"688","sky",21,9,1,4,35
"689","tommy",17,18,0,0,35
"690","writing",12,14,6,3,35
"691","andrew",18,10,6,0,34
"692","appeared",20,8,6,0,34
"693","armed",18,13,3,0,34
"694","battle",21,10,2,1,34
"695","books",14,12,2,6,34
"696","camp",15,14,5,0,34
"697","community",11,18,5,0,34
"698","complete",16,15,2,1,34
"699","engaged",7,16,11,0,34
"700","events",24,8,1,1,34
"701","fred",12,12,10,0,34
"702","frequently",4,11,18,1,34
"703","front",15,12,3,4,34
"704","happy",10,19,4,1,34
"705","hearing",13,12,9,0,34
"706","hearted",17,13,4,0,34
"707","hotel",11,5,0,18,34
"708","ignorant",11,17,6,0,34
"709","increased",15,16,2,1,34
"710","loyal",33,0,1,0,34
"711","observed",18,14,2,0,34
"712","opposite",16,13,3,2,34
"713","perfect",13,10,4,7,34
"714","railroad",20,12,2,0,34
"715","reading",12,15,5,2,34
"716","receive",23,8,3,0,34
"717","root",14,16,3,1,34
"718","sisters",10,21,2,1,34
"719","special",16,12,4,2,34
"720","strike",16,13,5,0,34
"721","teach",13,14,7,0,34
"722","violence",23,11,0,0,34
"723","attempted",20,11,2,0,33
"724","attend",21,9,3,0,33
"725","attended",11,11,5,6,33
"726","cart",10,15,8,0,33
"727","circumstance",11,18,4,0,33
"728","deemed",10,16,7,0,33
"729","delivered",19,11,3,0,33
"730","democratic",21,12,0,0,33
"731","difference",15,16,2,0,33
"732","distinguished",19,12,2,0,33
"733","dust",17,12,1,3,33
"734","eloquence",17,13,3,0,33
"735","hate",12,16,3,2,33
"736","kansas",33,0,0,0,33
"737","kill",10,15,8,0,33
"738","loss",14,13,5,1,33
"739","moments",14,11,8,0,33
"740","naturally",22,10,1,0,33
"741","offense",15,17,0,1,33
"742","pray",16,14,2,1,33
"743","promptly",18,14,0,1,33
"744","protect",17,11,5,0,33
"745","punishment",11,15,7,0,33
"746","safety",15,10,6,2,33
"747","sell",11,16,6,0,33
"748","separation",13,12,8,0,33
"749","solemn",13,11,3,6,33
"750","sound",9,17,4,3,33
"751","surrounded",15,12,4,2,33
"752","tender",16,11,6,0,33
"753","thousands",22,6,4,1,33
"754","tone",14,12,7,0,33
"755","advice",13,15,4,0,32
"756","affection",9,17,6,0,32
"757","alike",12,17,2,1,32
"758","authority",16,13,3,0,32
"759","bed",12,15,4,1,32
"760","birth",11,14,6,1,32
"761","cast",13,16,2,1,32
"762","changed",20,7,4,1,32
"763","dangerous",16,13,2,1,32
"764","daniel",17,11,4,0,32
"765","die",13,12,6,1,32
"766","easton",12,11,9,0,32
"767","enterprise",17,14,1,0,32
"768","excited",13,17,2,0,32
"769","expressed",22,7,3,0,32
"770","fallen",16,11,1,4,32
"771","fate",11,13,8,0,32
"772","filled",15,11,6,0,32
"773","flung",15,17,0,0,32
"774","girl",12,15,5,0,32
"775","ill",15,16,1,0,32
"776","jail",12,11,9,0,32
"777","moved",14,11,4,3,32
"778","murder",15,15,2,0,32
"779","plain",18,8,3,3,32
"780","population",14,11,7,0,32
"781","prepared",16,10,5,1,32
"782","promise",20,9,1,2,32
"783","real",16,12,3,1,32
"784","singing",9,16,5,2,32
"785","sloop",11,13,8,0,32
"786","suffering",14,13,5,0,32
"787","sufficient",13,15,4,0,32
"788","understood",8,15,9,0,32
"789","victim",8,19,5,0,32
"790","wretched",7,17,8,0,32
"791","afforded",14,12,5,0,31
"792","argument",18,10,3,0,31
"793","belonged",16,11,4,0,31
"794","completely",15,14,1,1,31
"795","earnings",16,14,1,0,31
"796","expression",17,11,3,0,31
"797","hardships",18,9,4,0,31
"798","harris",14,13,4,0,31
"799","knowing",14,13,4,0,31
"800","makes",12,12,4,3,31
"801","march",15,4,3,9,31
"802","pain",14,11,5,1,31
"803","parties",14,14,3,0,31
"804","pen",15,14,2,0,31
"805","pleasant",10,11,0,10,31
"806","popular",22,7,1,1,31
"807","practice",10,17,4,0,31
"808","pretty",9,17,3,2,31
"809","see",0,0,0,31,31
"810","souls",9,14,8,0,31
"811","superior",13,16,2,0,31
"812","testimony",13,11,6,1,31
"813","walked",12,11,4,4,31
"814","addressed",15,10,3,2,30
"815","break",12,14,4,0,30
"816","brute",9,15,6,0,30
"817","de",18,12,0,0,30
"818","devoted",15,11,4,0,30
"819","divided",16,10,4,0,30
"820","failure",15,10,5,0,30
"821","generous",17,13,0,0,30
"822","glorious",14,14,2,0,30
"823","green",19,9,0,2,30
"824","hair",14,12,3,1,30
"825","harper’s",30,0,0,0,30
"826","highly",13,10,6,1,30
"827","holy",7,20,3,0,30
"828","huge",12,18,0,0,30
"829","methodist",10,15,4,1,30
"830","ministers",16,11,3,0,30
"831","occupied",16,13,0,1,30
"832","philadelphia",23,6,1,0,30
"833","properly",20,6,4,0,30
"834","remarkable",15,6,3,6,30
"835","removed",16,13,1,0,30
"836","rendered",13,14,1,2,30
"837","senate",25,4,0,1,30
"838","sic",0,30,0,0,30
"839","slave’s",11,17,2,0,30
"840","speeches",17,12,1,0,30
"841","successful",9,15,5,1,30
"842","trees",15,11,3,1,30
"843","tuckahoe",7,22,1,0,30
"844","voyage",12,8,0,10,30
"845","added",14,10,5,0,29
"846","arrival",9,10,8,2,29
"847","awakened",12,15,2,0,29
"848","calling",13,10,5,1,29
"849","consequence",8,13,8,0,29
"850","dozen",12,14,3,0,29
"851","ease",9,10,9,1,29
"852","follow",13,11,5,0,29
"853","gospel",10,18,1,0,29
"854","grant",22,6,0,1,29
"855","humane",14,11,4,0,29
"856","measures",17,10,2,0,29
"857","mighty",14,11,4,0,29
"858","now",0,0,0,29,29
"859","numerous",15,12,1,1,29
"860","objects",12,15,0,2,29
"861","opposition",15,12,2,0,29
"862","plans",12,13,4,0,29
"863","questions",13,15,1,0,29
"864","republican",21,8,0,0,29
"865","reputation",7,12,10,0,29
"866","saw",0,0,0,29,29
"867","shame",13,14,2,0,29
"868","spend",11,10,6,2,29
"869","start",10,13,6,0,29
"870","stern",13,14,2,0,29
"871","stone",13,9,6,1,29
"872","treat",9,15,5,0,29
"873","troops",27,1,0,1,29
"874","upon",0,0,0,29,29
"875","apparently",14,11,1,2,28
"876","brethren",8,12,7,1,28
"877","chain",10,18,0,0,28
"878","clothes",10,10,5,3,28
"879","conscience",9,15,4,0,28
"880","constantly",12,14,1,1,28
"881","conviction",11,12,3,2,28
"882","defense",16,12,0,0,28
"883","doctor",15,13,0,0,28
"884","driven",11,16,1,0,28
"885","expect",13,15,0,0,28
"886","firmly",15,12,1,0,28
"887","forgotten",5,15,3,5,28
"888","governor",23,5,0,0,28
"889","grave",10,11,3,4,28
"890","hated",13,12,2,1,28
"891","hearts",15,8,5,0,28
"892","heat",14,12,1,1,28
"893","horrible",6,13,8,1,28
"894","incident",14,14,0,0,28
"895","induced",15,12,1,0,28
"896","injustice",14,11,3,0,28
"897","lord",14,10,4,0,28
"898","minister",14,9,3,2,28
"899","mrs",0,0,0,28,28
"900","naked",10,7,11,0,28
"901","nigger",11,9,8,0,28
"902","remove",10,15,3,0,28
"903","satisfaction",15,9,4,0,28
"904","savage",6,13,9,0,28
"905","search",11,13,2,2,28
"906","share",15,10,2,1,28
"907","sorrow",10,14,4,0,28
"908","space",16,10,2,0,28
"909","sun",11,14,3,0,28
"910","surprise",13,9,4,2,28
"911","talbot",10,10,8,0,28
"912","twelve",12,10,5,1,28
"913","wicked",4,21,3,0,28
"914","worst",10,13,4,1,28
"915","affected",14,11,2,0,27
"916","aid",11,10,6,0,27
"917","bible",11,12,2,2,27
"918","bringing",12,14,1,0,27
"919","consequences",9,12,6,0,27
"920","difficult",13,10,1,3,27
"921","drawn",13,9,4,1,27
"922","dreaded",11,10,5,1,27
"923","driver",12,10,5,0,27
"924","ears",9,14,2,2,27
"925","election",22,3,2,0,27
"926","enemies",16,9,2,0,27
"927","english",11,10,1,5,27
"928","extent",11,15,1,0,27
"929","fifty",16,6,3,2,27
"930","flogging",8,18,1,0,27
"931","formed",12,14,0,1,27
"932","gain",15,10,1,1,27
"933","happily",18,9,0,0,27
"934","honorable",15,11,1,0,27
"935","institution",15,10,2,0,27
"936","intelligence",14,12,1,0,27
"937","judgment",12,11,4,0,27
"938","lead",15,7,4,1,27
"939","manly",16,11,0,0,27
"940","mention",16,8,3,0,27
"941","monday",5,8,4,10,27
"942","niggers",11,13,3,0,27
"943","occasions",18,6,1,2,27
"944","oppressed",9,12,6,0,27
"945","oppression",15,12,0,0,27
"946","post",16,4,7,0,27
"947","principle",12,14,1,0,27
"948","qualities",18,7,2,0,27
"949","repeated",14,12,1,0,27
"950","seek",12,10,5,0,27
"951","seized",9,9,9,0,27
"952","servants",10,12,4,1,27
"953","shape",12,11,2,2,27
"954","silence",14,12,1,0,27
"955","territory",26,1,0,0,27
"956","unable",13,9,4,1,27
"957","visited",9,7,2,9,27
"958","andthe",26,0,0,0,26
"959","anxiety",10,11,4,1,26
"960","apprehension",12,11,3,0,26
"961","art",7,11,1,7,26
"962","assistance",11,12,3,0,26
"963","assured",16,8,2,0,26
"964","attached",9,15,2,0,26
"965","belonging",7,11,8,0,26
"966","carpenters",6,11,9,0,26
"967","charge",11,11,4,0,26
"968","connection",19,3,4,0,26
"969","court",16,6,3,1,26
"970","credit",17,6,2,1,26
"971","drink",8,9,8,1,26
"972","eloquent",15,7,3,1,26
"973","event",16,7,3,0,26
"974","evils",13,11,2,0,26
"975","excitement",9,12,5,0,26
"976","fish",12,9,3,2,26
"977","ideas",12,13,0,1,26
"978","industry",15,9,2,0,26
"979","market",11,13,1,1,26
"980","matters",11,12,3,0,26
"981","midst",11,5,10,0,26
"982","mother’s",8,16,2,0,26
"983","motive",16,9,1,0,26
"984","offered",17,9,0,0,26
"985","onthe",26,0,0,0,26
"986","opinions",14,12,0,0,26
"987","pair",8,11,7,0,26
"988","phillips",18,5,3,0,26
"989","platform",16,9,1,0,26
"990","previous",9,13,3,1,26
"991","published",13,11,2,0,26
"992","remains",7,8,5,6,26
"993","removal",13,13,0,0,26
"994","scotland",12,14,0,0,26
"995","skin",8,16,2,0,26
"996","sons",12,9,4,1,26
"997","stock",11,14,1,0,26
"998","store",15,8,3,0,26
"999","straight",12,12,2,0,26
"1000","transaction",8,13,5,0,26
"1001","weak",17,9,0,0,26
"1002","weather",13,8,0,5,26
"1003","wrath",15,10,1,0,26
"1004","action",15,8,1,1,25
"1005","alive",14,9,1,1,25
"1006","capital",20,4,1,0,25
"1007","conditions",20,4,0,1,25
"1008","congress",16,7,2,0,25
"1009","cousin",11,12,2,0,25
"1010","cowskin",2,13,10,0,25
"1011","departure",10,8,7,0,25
"1012","dollar",15,7,3,0,25
"1013","equality",15,9,0,1,25
"1014","explanation",8,14,3,0,25
"1015","extraordinary",5,14,6,0,25
"1016","fathers",10,11,4,0,25
"1017","features",12,9,1,3,25
"1018","fortune",14,9,1,1,25
"1019","grateful",17,6,1,1,25
"1020","homes",12,10,3,0,25
"1021","horrid",1,11,13,0,25
"1022","illustration",21,4,0,0,25
"1023","importance",8,9,8,0,25
"1024","increasing",16,8,1,0,25
"1025","intelligent",15,8,2,0,25
"1026","lips",14,10,1,0,25
"1027","listen",16,7,2,0,25
"1028","mark",10,14,0,1,25
"1029","meaning",13,8,4,0,25
"1030","obtained",13,10,1,1,25
"1031","owner",12,12,1,0,25
"1032","partly",12,11,2,0,25
"1033","permitted",13,8,2,2,25
"1034","regret",14,8,3,0,25
"1035","results",8,10,6,1,25
"1036","satisfied",8,8,8,1,25
"1037","serve",10,9,4,2,25
"1038","similar",10,8,7,0,25
"1039","slightest",5,11,9,0,25
"1040","stable",7,13,5,0,25
"1041","streets",11,6,2,6,25
"1042","sum",12,11,2,0,25
"1043","sweet",9,15,1,0,25
"1044","vast",12,6,0,7,25
"1045","whites",10,14,1,0,25
"1046","wind",10,8,1,6,25
"1047","wrote",12,4,4,5,25
"1048","admitted",11,12,1,0,24
"1049","advance",18,5,1,0,24
"1050","afford",7,13,3,1,24
"1051","americans",10,11,0,3,24
"1052","army",23,1,0,0,24
"1053","beaten",15,8,1,0,24
"1054","burden",12,9,1,2,24
"1055","carry",8,11,5,0,24
"1056","carrying",7,9,7,1,24
"1057","caught",9,11,4,0,24
"1058","churches",10,8,4,2,24
"1059","circle",10,10,2,2,24
"1060","comfortable",13,7,2,2,24
"1061","confess",13,11,0,0,24
"1062","constant",6,10,7,1,24
"1063","conversation",17,4,2,1,24
"1064","copy",10,9,5,0,24
"1065","crimes",4,16,4,0,24
"1066","cross",8,7,6,3,24
"1067","cry",10,14,0,0,24
"1068","emancipated",20,3,1,0,24
"1069","exception",11,11,1,1,24
"1070","experienced",4,10,10,0,24
"1071","fault",9,10,5,0,24
"1072","feature",9,10,1,4,24
"1073","heads",10,7,4,3,24
"1074","hopkins",4,11,9,0,24
"1075","immense",12,8,2,2,24
"1076","information",12,9,3,0,24
"1077","institutions",12,12,0,0,24
"1078","lines",17,4,2,1,24
"1079","london",8,10,0,6,24
"1080","low",15,7,1,1,24
"1081","marriage",7,11,6,0,24
"1082","married",6,10,7,1,24
"1083","meanness",10,10,4,0,24
"1084","occasionally",6,15,2,1,24
"1085","occurred",10,12,2,0,24
"1086","red",12,7,3,2,24
"1087","remembered",12,8,2,2,24
"1088","scenes",9,12,3,0,24
"1089","seated",15,7,1,1,24
"1090","separated",5,16,3,0,24
"1091","steamer",13,4,0,7,24
"1092","stranger",10,10,4,0,24
"1093","strangers",9,11,4,0,24
"1094","struggle",14,8,1,1,24
"1095","suspected",8,13,3,0,24
"1096","suspicion",10,13,1,0,24
"1097","terms",14,6,4,0,24
"1098","thoughtful",15,7,0,2,24
"1099","valuable",14,8,2,0,24
"1100","weeks",13,7,4,0,24
"1101","wishes",10,12,2,0,24
"1102","witness",6,11,6,1,24
"1103","worn",11,9,3,1,24
"1104","worship",8,8,0,8,24
"1105","advocate",10,10,3,0,23
"1106","anxious",10,7,6,0,23
"1107","appointed",16,5,2,0,23
"1108","arguments",15,7,1,0,23
"1109","bank",22,1,0,0,23
"1110","behalf",10,9,4,0,23
"1111","belong",12,9,2,0,23
"1112","canada",19,2,2,0,23
"1113","careful",8,12,3,0,23
"1114","contest",16,7,0,0,23
"1115","contrast",14,8,0,1,23
"1116","deal",10,9,3,1,23
"1117","denounced",11,11,1,0,23
"1118","describe",9,9,4,1,23
"1119","devil",8,8,7,0,23
"1120","distant",11,10,0,2,23
"1121","established",10,10,2,1,23
"1122","fan",8,9,6,0,23
"1123","helpless",7,10,6,0,23
"1124","insurrection",17,4,2,0,23
"1125","loud",10,7,4,2,23
"1126","mistake",14,5,3,1,23
"1127","mountains",16,1,0,6,23
"1128","native",13,9,1,0,23
"1129","neck",8,12,3,0,23
"1130","note",17,2,1,3,23
"1131","ofmy",23,0,0,0,23
"1132","passage",13,5,5,0,23
"1133","pieces",9,9,5,0,23
"1134","possession",12,7,3,1,23
"1135","proceeded",10,7,4,2,23
"1136","profession",6,14,3,0,23
"1137","purposes",13,9,1,0,23
"1138","pursuit",13,6,4,0,23
"1139","ran",7,8,8,0,23
"1140","reception",16,6,0,1,23
"1141","remarkably",12,10,0,1,23
"1142","rome",3,1,0,19,23
"1143","rope",8,10,5,0,23
"1144","rose",9,9,5,0,23
"1145","samuel",17,4,2,0,23
"1146","sharp",12,9,1,1,23
"1147","sheep",6,12,4,1,23
"1148","sing",5,10,8,0,23
"1149","star",12,8,3,0,23
"1150","striking",10,7,2,4,23
"1151","suffer",7,9,7,0,23
"1152","tears",8,10,5,0,23
"1153","watch",9,13,1,0,23
"1154","waters",6,10,3,4,23
"1155","went",0,0,0,23,23
"1156","woe",5,9,9,0,23
"1157","wrongs",10,12,1,0,23
"1158","youth",13,7,2,1,23
"1159","abolished",16,4,2,0,22
"1160","absent",9,10,3,0,22
"1161","accustomed",6,11,5,0,22
"1162","africa",5,14,3,0,22
"1163","approach",8,8,5,1,22
"1164","arm",15,4,2,1,22
"1165","aware",8,12,2,0,22
"1166","bailey",11,3,8,0,22
"1167","barney",7,10,5,0,22
"1168","belief",13,6,3,0,22
"1169","bleeding",9,12,1,0,22
"1170","bore",16,5,0,1,22
"1171","bought",7,12,2,1,22
"1172","breakfast",8,8,4,2,22
"1173","capable",15,6,1,0,22
"1174","charged",13,9,0,0,22
"1175","claims",8,13,1,0,22
"1176","consisted",5,9,6,2,22
"1177","contempt",10,10,2,0,22
"1178","cost",10,9,3,0,22
"1179","cunning",9,10,3,0,22
"1180","degradation",12,10,0,0,22
"1181","delightful",5,7,1,9,22
"1182","depths",9,9,1,3,22
"1183","doctrine",14,8,0,0,22
"1184","drive",12,6,3,1,22
"1185","editor",14,8,0,0,22
"1186","enslaved",8,12,2,0,22
"1187","enslavement",6,12,4,0,22
"1188","esther",7,15,0,0,22
"1189","eternal",7,12,2,1,22
"1190","fast",7,7,5,3,22
"1191","flight",9,10,3,0,22
"1192","fortunate",8,4,10,0,22
"1193","fought",16,6,0,0,22
"1194","fresh",6,12,3,1,22
"1195","great",0,0,0,22,22
"1196","grown",10,10,0,2,22
"1197","instantly",13,8,0,1,22
"1198","intense",7,14,1,0,22
"1199","ireland",12,8,2,0,22
"1200","lashes",4,14,4,0,22
"1201","leaders",15,5,2,0,22
"1202","limbs",8,11,2,1,22
"1203","marshal",22,0,0,0,22
"1204","mass",7,9,2,4,22
"1205","narrative",8,4,10,0,22
"1206","narrow",11,6,2,3,22
"1207","notice",14,6,2,0,22
"1208","picture",7,9,3,3,22
"1209","praise",12,8,2,0,22
"1210","press",8,14,0,0,22
"1211","proceed",8,11,1,2,22
"1212","quarters",13,7,2,0,22
"1213","quick",9,9,3,1,22
"1214","rank",10,10,2,0,22
"1215","readily",14,7,1,0,22
"1216","reward",6,10,5,1,22
"1217","ride",5,4,0,13,22
"1218","ruggles",6,7,9,0,22
"1219","safely",15,4,2,1,22
"1220","seeking",9,10,3,0,22
"1221","ships",9,9,3,1,22
"1222","stopping",10,7,0,5,22
"1223","teaching",4,13,4,1,22
"1224","terror",10,10,2,0,22
"1225","thompson",13,9,0,0,22
"1226","torn",10,10,1,1,22
"1227","troubled",9,12,1,0,22
"1228","urged",14,5,3,0,22
"1229","utterly",13,7,2,0,22
"1230","vessels",9,8,3,2,22
"1231","victims",8,11,3,0,22
"1232","vote",18,3,0,1,22
"1233","addition",9,10,2,0,21
"1234","afraid",9,10,2,0,21
"1235","agent",10,8,3,0,21
"1236","apparent",12,9,0,0,21
"1237","arrived",6,5,2,8,21
"1238","barn",9,7,5,0,21
"1239","bearing",8,10,1,2,21
"1240","beauty",9,9,1,2,21
"1241","borne",11,8,2,0,21
"1242","commanded",8,8,5,0,21
"1243","confusion",10,7,3,1,21
"1244","considerable",8,4,9,0,21
"1245","cowardly",7,12,2,0,21
"1246","crowd",14,4,0,3,21
"1247","custom",11,8,2,0,21
"1248","daily",8,12,1,0,21
"1249","dealt",11,9,1,0,21
"1250","deeper",14,7,0,0,21
"1251","desired",9,6,5,1,21
"1252","directions",11,10,0,0,21
"1253","driving",10,9,1,1,21
"1254","enter",11,8,1,1,21
"1255","famous",9,4,0,8,21
"1256","fears",10,9,2,0,21
"1257","forthe",21,0,0,0,21
"1258","friendly",14,3,3,1,21
"1259","glance",7,14,0,0,21
"1260","grew",9,9,3,0,21
"1261","handed",13,5,1,2,21
"1262","health",10,8,1,2,21
"1263","hughes",7,6,8,0,21
"1264","ihad",21,0,0,0,21
"1265","impressed",10,5,5,1,21
"1266","indignation",10,9,2,0,21
"1267","linen",7,10,4,0,21
"1268","meat",8,9,4,0,21
"1269","mission",13,7,0,1,21
"1270","negroes",10,7,2,2,21
"1271","neighbors",4,13,4,0,21
"1272","newspaper",9,10,2,0,21
"1273","officers",17,2,0,2,21
"1274","opposed",13,8,0,0,21
"1275","owe",9,9,3,0,21
"1276","possibly",10,10,1,0,21
"1277","returning",8,9,3,1,21
"1278","sacred",8,8,3,2,21
"1279","sale",12,7,1,1,21
"1280","secretary",18,2,1,0,21
"1281","seen",0,0,0,21,21
"1282","shoot",6,10,5,0,21
"1283","shot",10,7,4,0,21
"1284","spring",6,10,5,0,21
"1285","stage",14,5,2,0,21
"1286","tongue",9,10,2,0,21
"1287","traders",8,10,3,0,21
"1288","trial",8,11,2,0,21
"1289","two",0,0,0,21,21
"1290","wait",11,5,4,1,21
"1291","weight",9,8,4,0,21
"1292","witnessed",10,7,3,1,21
"1293","absence",8,8,4,0,20
"1294","abuse",8,11,1,0,20
"1295","admit",11,9,0,0,20
"1296","advantages",12,8,0,0,20
"1297","buy",4,10,4,2,20
"1298","chase",14,5,1,0,20
"1299","chesapeake",5,10,5,0,20
"1300","civil",13,6,1,0,20
"1301","columbia",16,2,2,0,20
"1302","contrary",9,8,3,0,20
"1303","deck",11,4,0,5,20
"1304","deed",7,7,6,0,20
"1305","deeds",9,6,5,0,20
"1306","dinner",9,8,1,2,20
"1307","direct",10,8,1,1,20
"1308","dr",10,10,0,0,20
"1309","dropped",11,9,0,0,20
"1310","ear",7,12,1,0,20
"1311","employed",10,8,2,0,20
"1312","encouraged",10,5,4,1,20
"1313","enemy",10,8,2,0,20
"1314","esteemed",6,10,4,0,20
"1315","excluded",14,6,0,0,20
"1316","favored",10,8,0,2,20
"1317","firm",10,5,4,1,20
"1318","friendship",10,9,0,1,20
"1319","gates",7,7,1,5,20
"1320","gentle",8,11,1,0,20
"1321","georgia",11,6,3,0,20
"1322","helen",0,0,0,20,20
"1323","hell",6,9,5,0,20
"1324","horror",7,9,4,0,20
"1325","incidents",12,7,1,0,20
"1326","isaac",12,6,2,0,20
"1327","itwas",20,0,0,0,20
"1328","judge",5,11,1,3,20
"1329","ladies",11,5,1,3,20
"1330","largest",10,4,1,5,20
"1331","material",13,7,0,0,20
"1332","merciless",6,11,3,0,20
"1333","misery",8,10,2,0,20
"1334","mob",12,8,0,0,20
"1335","mode",6,6,8,0,20
"1336","notwithstanding",10,6,2,2,20
"1337","old",0,0,0,20,20
"1338","perform",11,7,2,0,20
"1339","performance",7,7,4,2,20
"1340","pigs",7,8,5,0,20
"1341","proclamation",20,0,0,0,20
"1342","provided",9,8,3,0,20
"1343","pursued",8,10,2,0,20
"1344","quality",9,9,1,1,20
"1345","raise",11,6,3,0,20
"1346","rapidly",12,8,0,0,20
"1347","replied",15,4,1,0,20
"1348","respects",11,6,2,1,20
"1349","riding",6,11,3,0,20
"1350","rising",14,5,1,0,20
"1351","roused",8,9,3,0,20
"1352","senator",15,2,0,3,20
"1353","servant",6,9,4,1,20
"1354","shut",7,10,3,0,20
"1355","silent",17,3,0,0,20
"1356","sleeping",9,9,2,0,20
"1357","stealing",6,9,5,0,20
"1358","superstition",8,8,1,3,20
"1359","takes",7,10,3,0,20
"1360","threat",9,11,0,0,20
"1361","tobe",20,0,0,0,20
"1362","tom",6,11,3,0,20
"1363","trust",10,9,1,0,20
"1364","volume",8,11,0,1,20
"1365","well",0,0,0,20,20
"1366","wharf",10,6,3,1,20
"1367","wharves",7,10,3,0,20
"1368","ye",2,3,15,0,20
"1369","abused",8,10,1,0,19
"1370","afternoon",4,5,4,6,19
"1371","attack",12,6,1,0,19
"1372","beat",7,11,1,0,19
"1373","behold",7,9,2,1,19
"1374","beneath",8,10,1,0,19
"1375","blacks",11,8,0,0,19
"1376","blue",9,3,0,7,19
"1377","broke",7,5,7,0,19
"1378","car",13,6,0,0,19
"1379","career",8,5,6,0,19
"1380","christ",5,9,4,1,19
"1381","christianity",0,9,10,0,19
"1382","closed",9,6,3,1,19
"1383","commenced",2,4,13,0,19
"1384","committee",17,2,0,0,19
"1385","conducted",9,6,2,2,19
"1386","countenance",7,12,0,0,19
"1387","curiosity",7,9,2,1,19
"1388","demand",11,7,1,0,19
"1389","derived",10,9,0,0,19
"1390","difficulties",9,7,3,0,19
"1391","dignity",10,8,1,0,19
"1392","directly",8,8,3,0,19
"1393","effective",14,4,1,0,19
"1394","element",11,6,2,0,19
"1395","establishment",10,7,2,0,19
"1396","esteem",9,10,0,0,19
"1397","fairly",7,7,4,1,19
"1398","faithful",9,7,2,1,19
"1399","falling",10,6,3,0,19
"1400","false",6,8,5,0,19
"1401","fare",7,7,2,3,19
"1402","fence",5,8,6,0,19
"1403","forms",7,7,1,4,19
"1404","freeland’s",6,12,1,0,19
"1405","freely",11,7,1,0,19
"1406","gaining",6,10,3,0,19
"1407","genuine",8,11,0,0,19
"1408","heavenly",1,3,15,0,19
"1409","hot",8,5,4,2,19
"1410","humble",10,6,3,0,19
"1411","hurried",8,9,1,1,19
"1412","independence",8,10,1,0,19
"1413","informed",12,6,1,0,19
"1414","inquired",6,5,7,1,19
"1415","instruction",7,6,4,2,19
"1416","insult",9,10,0,0,19
"1417","jesus",5,6,3,5,19
"1418","leisure",7,8,4,0,19
"1419","level",7,8,2,2,19
"1420","mankind",8,10,1,0,19
"1421","manners",7,10,1,1,19
"1422","many",0,0,0,19,19
"1423","minutes",10,6,2,1,19
"1424","motion",7,8,3,1,19
"1425","much",0,0,0,19,19
"1426","nights",9,5,4,1,19
"1427","obtain",12,6,1,0,19
"1428","offer",10,7,2,0,19
"1429","perfectly",9,8,2,0,19
"1430","poverty",10,5,3,1,19
"1431","preacher",6,10,3,0,19
"1432","precisely",11,7,0,1,19
"1433","pulpit",6,8,4,1,19
"1434","quiet",10,7,0,2,19
"1435","rebels",18,1,0,0,19
"1436","recently",14,2,2,1,19
"1437","relief",7,10,2,0,19
"1438","relieved",7,5,7,0,19
"1439","represented",11,3,4,1,19
"1440","reproach",8,11,0,0,19
"1441","schools",16,3,0,0,19
"1442","separate",5,13,1,0,19
"1443","sick",9,8,2,0,19
"1444","speedily",11,8,0,0,19
"1445","spot",6,6,7,0,19
"1446","stands",7,8,2,2,19
"1447","stripes",6,11,2,0,19
"1448","study",8,9,0,2,19
"1449","suffrage",18,1,0,0,19
"1450","sumner",18,1,0,0,19
"1451","supported",12,6,0,1,19
"1452","sustain",7,9,3,0,19
"1453","sustained",9,6,4,0,19
"1454","tear",7,10,2,0,19
"1455","troubles",7,12,0,0,19
"1456","undertaking",8,8,3,0,19
"1457","unreasonable",12,7,0,0,19
"1458","wheat",6,8,5,0,19
"1459","wholly",9,9,1,0,19
"1460","wilson",16,2,1,0,19
"1461","years",0,0,0,19,19
"1462","_i",7,10,1,0,18
"1463","_liberator_",9,9,0,0,18
"1464","absolute",7,9,1,1,18
"1465","acknowledge",5,10,3,0,18
"1466","active",8,6,4,0,18
"1467","add",8,8,2,0,18
"1468","agitation",13,4,1,0,18
"1469","almighty",7,8,2,1,18
"1470","amount",8,4,5,1,18
"1471","answered",8,8,1,1,18
"1472","ashes",6,9,0,3,18
"1473","aspect",6,11,1,0,18
"1474","assumed",7,9,2,0,18
"1475","attending",6,6,6,0,18
"1476","august",10,3,5,0,18
"1477","auld’s",12,6,0,0,18
"1478","beasts",5,7,6,0,18
"1479","behavior",6,9,1,2,18
"1480","boast",7,6,5,0,18
"1481","breast",7,9,2,0,18
"1482","cake",8,10,0,0,18
"1483","calking",4,7,7,0,18
"1484","cared",10,7,1,0,18
"1485","cease",10,6,2,0,18
"1486","cent",6,8,4,0,18
"1487","choice",12,4,2,0,18
"1488","college",15,1,0,2,18
"1489","complaint",10,5,3,0,18
"1490","complaints",9,6,3,0,18
"1491","conclusion",11,6,1,0,18
"1492","conversion",6,8,4,0,18
"1493","daughters",7,8,2,1,18
"1494","despised",11,7,0,0,18
"1495","disturbed",9,6,2,1,18
"1496","divine",5,10,2,1,18
"1497","doomed",9,8,1,0,18
"1498","drew",6,8,4,0,18
"1499","educated",10,7,1,0,18
"1500","entering",7,6,4,1,18
"1501","exodus",18,0,0,0,18
"1502","express",7,7,4,0,18
"1503","fail",12,5,1,0,18
"1504","families",8,7,2,1,18
"1505","feared",5,9,4,0,18
"1506","fifteen",6,9,3,0,18
"1507","fill",12,5,1,0,18
"1508","final",9,7,2,0,18
"1509","fitted",10,6,1,1,18
"1510","gardiner’s",9,9,0,0,18
"1511","gathered",10,8,0,0,18
"1512","glory",7,6,4,1,18
"1513","grace",11,4,2,1,18
"1514","gratitude",10,6,2,0,18
"1515","growing",13,4,1,0,18
"1516","headed",6,9,1,2,18
"1517","hewas",18,0,0,0,18
"1518","hill",9,4,2,3,18
"1519","hire",5,7,6,0,18
"1520","honored",14,4,0,0,18
"1521","idle",8,9,1,0,18
"1522","impudence",5,11,2,0,18
"1523","individual",7,9,2,0,18
"1524","invitation",15,2,0,1,18
"1525","island",12,4,1,1,18
"1526","jan",0,0,0,18,18
"1527","legs",7,9,2,0,18
"1528","listening",14,4,0,0,18
"1529","loving",7,9,2,0,18
"1530","luxury",8,7,3,0,18
"1531","lying",6,9,3,0,18
"1532","main",11,7,0,0,18
"1533","management",9,8,1,0,18
"1534","mechanics",12,6,0,0,18
"1535","mentioned",8,9,1,0,18
"1536","mystery",7,11,0,0,18
"1537","newly",11,6,1,0,18
"1538","obedience",8,9,0,1,18
"1539","ocean",9,6,2,1,18
"1540","pains",8,7,3,0,18
"1541","passion",9,9,0,0,18
"1542","permission",5,10,3,0,18
"1543","philosophy",7,10,1,0,18
"1544","piety",6,10,2,0,18
"1545","preachers",6,10,2,0,18
"1546","price",10,6,2,0,18
"1547","promote",10,8,0,0,18
"1548","providence",7,7,4,0,18
"1549","pure",7,6,3,2,18
"1550","races",15,2,1,0,18
"1551","ranks",7,9,2,0,18
"1552","referred",7,11,0,0,18
"1553","revolting",5,12,0,1,18
"1554","rid",6,7,4,1,18
"1555","round",9,6,2,1,18
"1556","sable",7,10,1,0,18
"1557","said",0,0,0,18,18
"1558","sat",11,6,1,0,18
"1559","sears",18,0,0,0,18
"1560","selfish",10,8,0,0,18
"1561","shade",6,11,0,1,18
"1562","shelter",11,5,2,0,18
"1563","sin",4,13,1,0,18
"1564","sister",4,7,4,3,18
"1565","spread",9,5,0,4,18
"1566","station",10,5,2,1,18
"1567","storm",11,3,1,3,18
"1568","strongest",5,6,6,1,18
"1569","suggested",10,4,4,0,18
"1570","talked",8,7,3,0,18
"1571","teeth",8,10,0,0,18
"1572","temper",6,11,1,0,18
"1573","timber",4,6,8,0,18
"1574","torture",6,11,1,0,18
"1575","touched",10,6,2,0,18
"1576","trembling",5,5,6,2,18
"1577","unknown",12,3,2,1,18
"1578","welfare",9,8,1,0,18
"1579","wide",6,10,1,1,18
"1580","agents",13,3,1,0,17
"1581","agony",9,7,1,0,17
"1582","amid",9,7,1,0,17
"1583","angry",7,7,3,0,17
"1584","author",8,9,0,0,17
"1585","benefit",8,7,2,0,17
"1586","bent",7,8,2,0,17
"1587","brains",6,5,6,0,17
"1588","brilliant",9,6,1,1,17
"1589","calm",8,6,1,2,17
"1590","capture",14,2,1,0,17
"1591","ceremony",8,7,1,1,17
"1592","chair",11,4,2,0,17
"1593","chattel",6,9,2,0,17
"1594","citizen",14,3,0,0,17
"1595","claim",8,8,1,0,17
"1596","compared",2,8,7,0,17
"1597","concerned",6,9,2,0,17
"1598","confined",8,7,2,0,17
"1599","consented",10,6,1,0,17
"1600","contented",6,7,3,1,17
"1601","cries",6,9,2,0,17
"1602","defend",10,6,1,0,17
"1603","deliver",8,5,3,1,17
"1604","discussion",10,7,0,0,17
"1605","dragged",7,9,1,0,17
"1606","dream",7,9,1,0,17
"1607","east",10,4,1,2,17
"1608","energy",7,7,1,2,17
"1609","enthusiasm",8,7,1,1,17
"1610","favorite",6,11,0,0,17
"1611","febry",0,0,0,17,17
"1612","feeding",7,8,2,0,17
"1613","freedmen",17,0,0,0,17
"1614","friday",4,4,1,8,17
"1615","gladly",9,7,1,0,17
"1616","grandchildren",7,5,5,0,17
"1617","harsh",6,10,1,0,17
"1618","hatred",8,7,2,0,17
"1619","henny",7,8,2,0,17
"1620","hospitality",9,7,1,0,17
"1621","hut",4,9,4,0,17
"1622","impressive",7,1,2,7,17
"1623","indebted",9,7,1,0,17
"1624","indian",9,8,0,0,17
"1625","intellect",5,7,4,1,17
"1626","knees",6,7,4,0,17
"1627","laborer",8,8,1,0,17
"1628","lawson",8,9,0,0,17
"1629","leader",10,4,3,0,17
"1630","like",0,0,0,17,17
"1631","may",0,0,0,17,17
"1632","men",0,0,0,17,17
"1633","narrate",7,8,2,0,17
"1634","o’clock",10,5,2,0,17
"1635","occur",10,6,1,0,17
"1636","operation",10,6,1,0,17
"1637","orleans",10,7,0,0,17
"1638","prayers",5,8,4,0,17
"1639","precious",7,7,1,2,17
"1640","prefer",5,9,3,0,17
"1641","private",9,8,0,0,17
"1642","proposed",11,3,3,0,17
"1643","prospect",5,9,1,2,17
"1644","purchase",9,6,2,0,17
"1645","reality",7,7,3,0,17
"1646","recognized",9,5,1,2,17
"1647","render",8,7,2,0,17
"1648","responsibility",6,10,1,0,17
"1649","runaway",12,5,0,0,17
"1650","secured",10,4,2,1,17
"1651","security",9,7,1,0,17
"1652","sensation",6,8,2,1,17
"1653","services",9,7,0,1,17
"1654","shake",10,6,0,1,17
"1655","solid",11,4,0,2,17
"1656","spectacle",6,7,1,3,17
"1657","speed",7,6,4,0,17
"1658","succeed",6,7,4,0,17
"1659","supplied",10,7,0,0,17
"1660","surprised",10,6,0,1,17
"1661","temperance",15,2,0,0,17
"1662","tenderness",7,8,2,0,17
"1663","term",6,9,2,0,17
"1664","usefulness",8,8,1,0,17
"1665","utmost",5,6,5,1,17
"1666","violent",8,7,2,0,17
"1667","waiting",10,4,3,0,17
"1668","walls",11,3,1,2,17
"1669","way",0,0,0,17,17
"1670","western",8,7,1,1,17
"1671","withthe",17,0,0,0,17
"1672","abolitionist",8,8,0,0,16
"1673","acquaintance",8,5,2,1,16
"1674","admiration",6,6,2,2,16
"1675","admission",9,6,1,0,16
"1676","aim",7,8,1,0,16
"1677","applied",7,6,3,0,16
"1678","assist",11,5,0,0,16
"1679","assisted",9,5,2,0,16
"1680","atthe",16,0,0,0,16
"1681","austin",7,7,2,0,16
"1682","avoid",8,5,3,0,16
"1683","begin",9,6,1,0,16
"1684","bodies",6,7,3,0,16
"1685","bold",7,6,2,1,16
"1686","buildings",8,6,1,1,16
"1687","burned",9,6,1,0,16
"1688","calculated",6,8,1,1,16
"1689","cambria",6,10,0,0,16
"1690","carefully",7,7,1,1,16
"1691","cattle",5,10,1,0,16
"1692","cheerful",7,2,3,4,16
"1693","comfort",4,10,2,0,16
"1694","contentment",4,8,4,0,16
"1695","control",6,8,1,1,16
"1696","curious",8,7,1,0,16
"1697","dashing",6,7,1,2,16
"1698","degraded",7,6,2,1,16
"1699","degrading",6,7,3,0,16
"1700","demands",12,4,0,0,16
"1701","departed",7,3,4,2,16
"1702","discovered",6,8,2,0,16
"1703","division",9,4,3,0,16
"1704","doubtless",5,10,1,0,16
"1705","enjoy",5,10,1,0,16
"1706","essential",8,7,1,0,16
"1707","evident",7,8,1,0,16
"1708","execution",14,2,0,0,16
"1709","exposed",6,10,0,0,16
"1710","extreme",6,7,3,0,16
"1711","fed",6,6,4,0,16
"1712","fetters",7,6,3,0,16
"1713","fighting",11,5,0,0,16
"1714","fit",8,6,2,0,16
"1715","forced",10,5,1,0,16
"1716","foster",11,5,0,0,16
"1717","fruits",7,8,1,0,16
"1718","furnished",4,11,0,1,16
"1719","grounds",9,6,0,1,16
"1720","harm",9,4,3,0,16
"1721","hoped",10,2,2,2,16
"1722","hugh’s",5,8,3,0,16
"1723","industrious",9,6,1,0,16
"1724","inspiration",11,5,0,0,16
"1725","intellectual",4,9,3,0,16
"1726","intention",8,4,4,0,16
"1727","january",6,4,5,1,16
"1728","justified",7,9,0,0,16
"1729","liability",4,9,3,0,16
"1730","logic",8,8,0,0,16
"1731","mary",3,7,5,1,16
"1732","mill",5,9,2,0,16
"1733","monument",13,0,0,3,16
"1734","motives",8,8,0,0,16
"1735","movements",8,8,0,0,16
"1736","nations",10,4,0,2,16
"1737","newspapers",6,9,1,0,16
"1738","offering",5,9,1,1,16
"1739","original",5,10,1,0,16
"1740","path",5,7,3,1,16
"1741","period",7,4,4,1,16
"1742","pictures",3,5,1,7,16
"1743","prey",5,8,3,0,16
"1744","privileges",5,9,2,0,16
"1745","procession",11,3,0,2,16
"1746","produce",6,7,3,0,16
"1747","produced",8,7,1,0,16
"1748","proud",8,5,3,0,16
"1749","putting",9,6,0,1,16
"1750","rebel",16,0,0,0,16
"1751","rebuke",5,10,1,0,16
"1752","reserve",6,6,0,4,16
"1753","responsible",5,9,2,0,16
"1754","robert",15,0,0,1,16
"1755","ruin",12,4,0,0,16
"1756","rushed",6,7,3,0,16
"1757","secret",7,8,1,0,16
"1758","selected",6,7,2,1,16
"1759","series",8,6,2,0,16
"1760","severely",4,10,2,0,16
"1761","shock",10,5,1,0,16
"1762","sober",8,6,2,0,16
"1763","spirits",7,7,1,1,16
"1764","splendid",9,4,3,0,16
"1765","standard",11,4,1,0,16
"1766","stately",8,5,0,3,16
"1767","steam",6,6,1,3,16
"1768","stick",5,6,5,0,16
"1769","supply",9,7,0,0,16
"1770","threats",7,7,2,0,16
"1771","threw",8,5,3,0,16
"1772","tie",4,6,6,0,16
"1773","trained",6,9,1,0,16
"1774","utter",4,6,4,2,16
"1775","vain",10,4,2,0,16
"1776","warrant",6,8,2,0,16
"1777","wit",5,7,3,1,16
"1778","wore",8,5,2,1,16
"1779","wound",7,5,4,0,16
"1780","african",7,7,1,0,15
"1781","ages",6,6,3,0,15
"1782","ashamed",10,5,0,0,15
"1783","assembled",10,4,0,1,15
"1784","band",6,7,2,0,15
"1785","barbarity",2,6,7,0,15
"1786","barbarous",7,8,0,0,15
"1787","base",6,6,2,1,15
"1788","beast",5,7,3,0,15
"1789","beating",6,4,4,1,15
"1790","believing",7,8,0,0,15
"1791","belongs",9,6,0,0,15
"1792","benefits",6,8,1,0,15
"1793","betrayed",8,6,1,0,15
"1794","bind",6,5,4,0,15
"1795","bones",6,7,1,1,15
"1796","buchanan",15,0,0,0,15
"1797","canoe",5,7,3,0,15
"1798","caroline",5,6,2,2,15
"1799","carriage",9,3,2,1,15
"1800","catch",5,6,3,1,15
"1801","collins",9,5,1,0,15
"1802","colors",11,2,0,2,15
"1803","columns",8,5,0,2,15
"1804","commission",9,3,3,0,15
"1805","comparatively",7,7,1,0,15
"1806","compromise",9,5,1,0,15
"1807","concern",6,8,1,0,15
"1808","contemplated",7,6,2,0,15
"1809","converted",4,8,2,1,15
"1810","cook",10,5,0,0,15
"1811","countrymen",11,4,0,0,15
"1812","cover",6,8,0,1,15
"1813","cruelties",2,11,2,0,15
"1814","crushed",5,8,2,0,15
"1815","dare",3,8,3,1,15
"1816","daring",7,6,2,0,15
"1817","dashed",5,6,3,1,15
"1818","day’s",5,8,2,0,15
"1819","defeat",13,1,1,0,15
"1820","desolate",4,5,4,2,15
"1821","destroy",6,8,1,0,15
"1822","devotion",10,2,2,1,15
"1823","distinct",5,10,0,0,15
"1824","drawing",8,5,1,1,15
"1825","dreams",8,7,0,0,15
"1826","eager",5,6,1,3,15
"1827","exceedingly",4,7,4,0,15
"1828","excuse",6,6,3,0,15
"1829","extended",9,6,0,0,15
"1830","extract",1,14,0,0,15
"1831","feed",5,8,2,0,15
"1832","fixed",6,6,2,1,15
"1833","fortunately",10,5,0,0,15
"1834","freemen",6,6,3,0,15
"1835","frightful",3,5,7,0,15
"1836","garden",8,1,6,0,15
"1837","gold",6,6,1,2,15
"1838","grandeur",8,5,1,1,15
"1839","grief",5,8,2,0,15
"1840","here_",4,11,0,0,15
"1841","hunted",5,8,2,0,15
"1842","i’ll",6,5,4,0,15
"1843","illustrate",7,7,1,0,15
"1844","improvement",7,8,0,0,15
"1845","indifference",8,6,0,1,15
"1846","inspired",9,4,2,0,15
"1847","instances",2,9,4,0,15
"1848","joyous",4,11,0,0,15
"1849","justify",3,9,3,0,15
"1850","leaves",5,9,1,0,15
"1851","lie",4,3,4,4,15
"1852","literary",9,6,0,0,15
"1853","load",4,7,3,1,15
"1854","loneliness",2,8,4,1,15
"1855","maintain",8,7,0,0,15
"1856","malice",7,7,1,0,15
"1857","marks",7,6,1,1,15
"1858","messrs",9,5,1,0,15
"1859","must",0,0,0,15,15
"1860","noise",7,6,1,1,15
"1861","notions",3,11,1,0,15
"1862","offenses",2,13,0,0,15
"1863","ordinary",4,8,3,0,15
"1864","origin",8,7,0,0,15
"1865","pennsylvania",10,4,1,0,15
"1866","plainly",11,4,0,0,15
"1867","positive",4,10,1,0,15
"1868","prosperity",6,7,1,1,15
"1869","raising",10,2,3,0,15
"1870","recapture",7,8,0,0,15
"1871","refinement",5,8,2,0,15
"1872","refusal",7,6,2,0,15
"1873","repeal",14,0,1,0,15
"1874","residence",7,5,1,2,15
"1875","resisted",8,5,1,1,15
"1876","respectable",8,7,0,0,15
"1877","resting",7,6,0,2,15
"1878","rude",6,7,2,0,15
"1879","sentiments",7,5,3,0,15
"1880","signs",6,8,0,1,15
"1881","silver",5,7,1,2,15
"1882","source",4,7,3,1,15
"1883","startling",10,2,1,2,15
"1884","starve",8,6,1,0,15
"1885","strongly",5,7,3,0,15
"1886","sugar",7,7,1,0,15
"1887","taste",6,7,2,0,15
"1888","teacher",6,6,3,0,15
"1889","thecountry",15,0,0,0,15
"1890","tools",6,5,4,0,15
"1891","trials",9,6,0,0,15
"1892","tyrant",8,6,1,0,15
"1893","utterance",7,5,3,0,15
"1894","virtue",3,9,3,0,15
"1895","virtuous",3,8,4,0,15
"1896","wall",4,9,1,1,15
"1897","warning",6,6,3,0,15
"1898","wasa",15,0,0,0,15
"1899","whilst",2,5,8,0,15
"1900","wickedness",5,10,0,0,15
"1901","won’t",5,6,4,0,15
"1902","worthy",9,3,3,0,15
"1903","_the",2,11,1,0,14
"1904","abhorrence",7,5,2,0,14
"1905","activity",9,3,1,1,14
"1906","advanced",6,7,1,0,14
"1907","afterward",3,7,2,2,14
"1908","alleged",6,6,2,0,14
"1909","appeal",6,8,0,0,14
"1910","approaching",4,9,1,0,14
"1911","arrangement",3,9,2,0,14
"1912","ascertain",4,5,5,0,14
"1913","avail",9,5,0,0,14
"1914","basis",8,6,0,0,14
"1915","beds",5,7,2,0,14
"1916","birds",6,6,1,1,14
"1917","block",4,8,1,1,14
"1918","boat",10,3,0,1,14
"1919","bondman",2,9,3,0,14
"1920","bonds",6,4,4,0,14
"1921","branches",10,2,0,2,14
"1922","britain",3,11,0,0,14
"1923","built",7,3,1,3,14
"1924","bythe",14,0,0,0,14
"1925","calamity",9,3,2,0,14
"1926","chances",5,7,2,0,14
"1927","characteristics",5,9,0,0,14
"1928","characters",8,5,1,0,14
"1929","classes",11,3,0,0,14
"1930","clean",5,4,4,1,14
"1931","coal",7,2,1,4,14
"1932","cool",8,4,1,1,14
"1933","cried",5,7,2,0,14
"1934","denby",4,10,0,0,14
"1935","desirable",8,6,0,0,14
"1936","desperate",8,5,1,0,14
"1937","dialogue",4,6,4,0,14
"1938","directed",7,6,1,0,14
"1939","disappointed",7,5,2,0,14
"1940","drove",4,7,1,2,14
"1941","effects",6,5,3,0,14
"1942","emancipate",5,6,3,0,14
"1943","endured",4,5,4,1,14
"1944","erected",10,3,0,1,14
"1945","escaping",4,8,2,0,14
"1946","establish",6,7,1,0,14
"1947","existed",7,4,3,0,14
"1948","expense",6,5,3,0,14
"1949","extra",7,7,0,0,14
"1950","faithfully",6,6,2,0,14
"1951","fever",8,4,2,0,14
"1952","fiendish",3,8,3,0,14
"1953","fingers",5,5,3,1,14
"1954","florence",0,0,0,14,14
"1955","forces",9,4,0,1,14
"1956","foregoing",8,5,1,0,14
"1957","fugitives",9,5,0,0,14
"1958","gardiner",6,8,0,0,14
"1959","gen",14,0,0,0,14
"1960","gloom",5,5,4,0,14
"1961","goodness",3,8,3,0,14
"1962","gradually",8,6,0,0,14
"1963","gray",9,5,0,0,14
"1964","hadbeen",14,0,0,0,14
"1965","horrors",4,9,1,0,14
"1966","hostility",11,3,0,0,14
"1967","imposing",5,4,1,4,14
"1968","impressions",7,6,1,0,14
"1969","induce",5,8,1,0,14
"1970","infernal",2,6,6,0,14
"1971","inflicted",4,5,5,0,14
"1972","insensible",4,6,4,0,14
"1973","instrument",8,4,1,1,14
"1974","introduction",5,9,0,0,14
"1975","joseph",8,2,2,2,14
"1976","july",3,10,1,0,14
"1977","keen",2,11,1,0,14
"1978","killing",4,6,4,0,14
"1979","lane",6,6,2,0,14
"1980","lightning",7,5,2,0,14
"1981","listened",7,4,2,1,14
"1982","little",0,0,0,14,14
"1983","lose",5,5,4,0,14
"1984","mansion",11,3,0,0,14
"1985","miserable",7,4,3,0,14
"1986","missouri",13,1,0,0,14
"1987","mountain",7,1,1,5,14
"1988","mouth",6,8,0,0,14
"1989","moving",4,7,2,1,14
"1990","obey",6,6,2,0,14
"1991","obeyed",5,6,2,1,14
"1992","objection",9,5,0,0,14
"1993","observation",8,5,1,0,14
"1994","offended",7,7,0,0,14
"1995","opportunities",7,5,2,0,14
"1996","orator",7,5,2,0,14
"1997","owners",6,7,1,0,14
"1998","performed",5,5,4,0,14
"1999","pity",4,8,2,0,14
"2000","plenty",5,7,2,0,14
"2001","pocket",6,7,1,0,14
"2002","portion",3,8,3,0,14
"2003","pro",8,6,0,0,14
"2004","probable",6,6,2,0,14
"2005","proposition",8,5,1,0,14
"2006","punish",6,8,0,0,14
"2007","quickly",9,4,1,0,14
"2008","rain",4,5,2,3,14
"2009","reduced",4,7,3,0,14
"2010","regular",6,5,3,0,14
"2011","rice",5,6,3,0,14
"2012","roll",4,6,2,2,14
"2013","roof",9,5,0,0,14
"2014","season",10,4,0,0,14
"2015","settled",8,5,1,0,14
"2016","seventy",5,6,2,1,14
"2017","shirt",7,5,2,0,14
"2018","sixty",12,1,1,0,14
"2019","sounds",4,7,1,2,14
"2020","steal",6,5,3,0,14
"2021","stopped",7,3,4,0,14
"2022","stowe",13,1,0,0,14
"2023","style",3,9,2,0,14
"2024","submit",10,4,0,0,14
"2025","sudden",6,5,3,0,14
"2026","suddenly",6,7,1,0,14
"2027","supper",7,5,1,1,14
"2028","supreme",13,1,0,0,14
"2029","swore",6,6,2,0,14
"2030","thatthe",14,0,0,0,14
"2031","throw",7,6,1,0,14
"2032","title",7,5,2,0,14
"2033","tow",6,7,1,0,14
"2034","understanding",6,7,1,0,14
"2035","unhappy",6,5,3,0,14
"2036","unitedstates",14,0,0,0,14
"2037","unlike",6,5,3,0,14
"2038","unnatural",4,10,0,0,14
"2039","unusual",7,7,0,0,14
"2040","valued",7,6,1,0,14
"2041","vice",9,3,1,1,14
"2042","victory",12,2,0,0,14
"2043","visible",7,5,1,1,14
"2044","waited",10,4,0,0,14
"2045","wasnot",14,0,0,0,14
"2046","wendell",9,2,3,0,14
"2047","wouldhave",14,0,0,0,14
"2048","wounds",9,5,0,0,14
"2049","yea",5,7,2,0,14
"2050","_not_",3,10,0,0,13
"2051","1838",4,3,6,0,13
"2052","acted",3,8,2,0,13
"2053","administration",12,1,0,0,13
"2054","affectionate",4,7,2,0,13
"2055","alarm",6,6,1,0,13
"2056","amanda",6,5,2,0,13
"2057","ambition",6,4,1,2,13
"2058","ambitious",6,5,2,0,13
"2059","author’s",12,1,0,0,13
"2060","bolts",8,5,0,0,13
"2061","bond",5,5,3,0,13
"2062","border",12,0,1,0,13
"2063","box",9,3,1,0,13
"2064","bravely",8,4,0,1,13
"2065","brotherhood",6,7,0,0,13
"2066","burning",4,9,0,0,13
"2067","ceased",7,5,1,0,13
"2068","cents",5,4,4,0,13
"2069","civilized",6,7,0,0,13
"2070","clouds",5,5,0,3,13
"2071","combined",5,6,2,0,13
"2072","compel",5,6,2,0,13
"2073","complexion",5,5,3,0,13
"2074","concluded",4,4,5,0,13
"2075","consent",7,4,1,1,13
"2076","content",4,6,3,0,13
"2077","continue",7,3,3,0,13
"2078","copper",7,6,0,0,13
"2079","cunningham",5,8,0,0,13
"2080","deadly",5,5,3,0,13
"2081","deem",3,5,5,0,13
"2082","defeated",8,5,0,0,13
"2083","defended",6,5,0,2,13
"2084","definite",6,7,0,0,13
"2085","demanded",5,8,0,0,13
"2086","deprived",4,8,1,0,13
"2087","design",6,5,2,0,13
"2088","designed",8,5,0,0,13
"2089","discovery",8,5,0,0,13
"2090","distressing",6,7,0,0,13
"2091","drop",6,6,1,0,13
"2092","edge",4,7,1,1,13
"2093","endurance",5,5,2,1,13
"2094","enlightened",9,3,1,0,13
"2095","entertained",6,7,0,0,13
"2096","examined",4,7,2,0,13
"2097","exist",3,10,0,0,13
"2098","exposure",4,8,1,0,13
"2099","extend",7,2,2,2,13
"2100","fastened",7,6,0,0,13
"2101","fierce",9,3,0,1,13
"2102","fly",4,5,4,0,13
"2103","foul",5,6,2,0,13
"2104","foundation",10,2,1,0,13
"2105","good",0,0,0,13,13
"2106","hesitation",6,7,0,0,13
"2107","hicks",6,4,3,0,13
"2108","hiring",5,5,3,0,13
"2109","hit",8,5,0,0,13
"2110","hitherto",9,4,0,0,13
"2111","inch",4,8,1,0,13
"2112","influences",4,9,0,0,13
"2113","innocent",5,6,2,0,13
"2114","instruct",4,4,5,0,13
"2115","job",6,4,3,0,13
"2116","join",9,3,0,1,13
"2117","lacked",3,5,5,0,13
"2118","landed",8,5,0,0,13
"2119","larger",5,4,2,2,13
"2120","lessons",6,4,2,1,13
"2121","lloyds",5,8,0,0,13
"2122","long",0,0,0,13,13
"2123","man",0,0,0,13,13
"2124","mothers",3,7,3,0,13
"2125","nelly",2,11,0,0,13
"2126","news",11,0,0,2,13
"2127","objections",7,6,0,0,13
"2128","ofslavery",13,0,0,0,13
"2129","oil",6,5,2,0,13
"2130","owing",2,7,3,1,13
"2131","pathway",4,6,3,0,13
"2132","patience",9,2,0,2,13
"2133","patriotism",7,6,0,0,13
"2134","peril",8,4,1,0,13
"2135","prayed",5,4,4,0,13
"2136","preferred",7,4,2,0,13
"2137","presidential",12,1,0,0,13
"2138","pressed",8,4,1,0,13
"2139","prominent",9,4,0,0,13
"2140","promised",10,2,1,0,13
"2141","proscription",7,6,0,0,13
"2142","quietly",6,6,0,1,13
"2143","reasoning",7,4,2,0,13
"2144","remark",4,8,1,0,13
"2145","remarks",8,3,2,0,13
"2146","requires",4,9,0,0,13
"2147","resist",3,9,1,0,13
"2148","resort",4,6,2,1,13
"2149","respected",9,3,1,0,13
"2150","risk",7,4,1,1,13
"2151","rode",4,2,4,3,13
"2152","ruffians",7,6,0,0,13
"2153","rules",6,6,1,0,13
"2154","scale",4,5,4,0,13
"2155","seats",4,7,2,0,13
"2156","selfishness",6,6,1,0,13
"2157","sending",5,6,1,1,13
"2158","shadow",6,4,2,1,13
"2159","singular",7,5,1,0,13
"2160","sit",7,4,2,0,13
"2161","slight",5,8,0,0,13
"2162","soft",5,7,0,1,13
"2163","solely",4,7,2,0,13
"2164","spiritual",4,9,0,0,13
"2165","stained",6,3,4,0,13
"2166","stamped",8,4,1,0,13
"2167","starting",6,4,2,1,13
"2168","starved",6,3,4,0,13
"2169","stated",5,8,0,0,13
"2170","statements",3,8,2,0,13
"2171","steamboats",8,3,2,0,13
"2172","strictly",4,7,2,0,13
"2173","sufficiently",4,7,2,0,13
"2174","task",5,5,3,0,13
"2175","travel",6,6,1,0,13
"2176","traveling",8,5,0,0,13
"2177","vengeance",7,5,1,0,13
"2178","walking",4,5,1,3,13
"2179","washed",6,6,1,0,13
"2180","whisky",3,6,4,0,13
"2181","wm",11,1,1,0,13
"2182","wonderful",8,1,2,2,13
"2183","wretchedness",4,6,2,1,13
"2184","yet",0,0,0,13,13
"2185","absolutely",5,6,1,0,12
"2186","acquired",5,5,2,0,12
"2187","additional",7,3,2,0,12
"2188","anguish",3,7,2,0,12
"2189","announced",10,2,0,0,12
"2190","apology",5,7,0,0,12
"2191","appealed",5,6,1,0,12
"2192","appointment",12,0,0,0,12
"2193","approached",6,3,1,2,12
"2194","asa",12,0,0,0,12
"2195","ash",5,7,0,0,12
"2196","assembly",5,7,0,0,12
"2197","assume",7,5,0,0,12
"2198","assuming",7,4,1,0,12
"2199","awkward",3,5,4,0,12
"2200","begun",6,6,0,0,12
"2201","beloved",7,4,1,0,12
"2202","bitterest",6,4,2,0,12
"2203","breath",5,6,1,0,12
"2204","breeze",4,6,2,0,12
"2205","brick",5,5,2,0,12
"2206","brow",5,4,2,1,12
"2207","buffum",7,5,0,0,12
"2208","buried",4,4,1,3,12
"2209","changing",4,6,0,2,12
"2210","characteristic",6,6,0,0,12
"2211","cherished",6,6,0,0,12
"2212","christians",3,7,2,0,12
"2213","clay",7,4,1,0,12
"2214","coast",2,7,0,3,12
"2215","collected",6,4,2,0,12
"2216","comforts",3,5,4,0,12
"2217","commit",4,6,2,0,12
"2218","condemned",5,7,0,0,12
"2219","conductor",11,1,0,0,12
"2220","congenial",7,5,0,0,12
"2221","convictions",9,3,0,0,12
"2222","convince",5,6,1,0,12
"2223","created",6,4,2,0,12
"2224","creature",4,8,0,0,12
"2225","curses",3,6,3,0,12
"2226","debate",8,4,0,0,12
"2227","decision",8,1,3,0,12
"2228","declared",8,3,1,0,12
"2229","delegates",12,0,0,0,12
"2230","destiny",6,5,1,0,12
"2231","destitute",6,4,2,0,12
"2232","details",5,6,1,0,12
"2233","dey",6,6,0,0,12
"2234","didnot",12,0,0,0,12
"2235","dim",5,4,3,0,12
"2236","discontent",5,6,1,0,12
"2237","distinction",7,5,0,0,12
"2238","distinctly",6,6,0,0,12
"2239","doctors",3,9,0,0,12
"2240","doubted",7,4,1,0,12
"2241","doubts",5,7,0,0,12
"2242","dreamed",5,7,0,0,12
"2243","drunken",6,6,0,0,12
"2244","earnestness",6,3,2,1,12
"2245","earthly",6,6,0,0,12
"2246","employ",8,2,2,0,12
"2247","energies",3,8,1,0,12
"2248","estate",8,2,2,0,12
"2249","facilities",5,6,1,0,12
"2250","farther",7,2,3,0,12
"2251","fashion",8,4,0,0,12
"2252","fearful",3,7,2,0,12
"2253","fell’s",3,8,1,0,12
"2254","finest",2,3,3,4,12
"2255","fishing",7,4,1,0,12
"2256","footing",8,4,0,0,12
"2257","fromthe",12,0,0,0,12
"2258","furious",8,4,0,0,12
"2259","gash",4,8,0,0,12
"2260","gratification",5,3,4,0,12
"2261","habits",8,4,0,0,12
"2262","halloo",4,4,4,0,12
"2263","hateful",3,7,2,0,12
"2264","height",5,4,1,2,12
"2265","helped",8,3,1,0,12
"2266","hickory",5,5,2,0,12
"2267","hymns",5,7,0,0,12
"2268","imagine",2,5,3,2,12
"2269","included",6,5,1,0,12
"2270","inferior",6,5,1,0,12
"2271","ingratitude",6,4,2,0,12
"2272","inquiry",6,6,0,0,12
"2273","interest",0,0,0,12,12
"2274","interview",11,1,0,0,12
"2275","inthis",12,0,0,0,12
"2276","intimated",6,5,1,0,12
"2277","jake",5,6,1,0,12
"2278","kick",3,3,6,0,12
"2279","kidnappers",4,6,2,0,12
"2280","kinds",5,5,1,1,12
"2281","knife",4,8,0,0,12
"2282","laboring",7,4,1,0,12
"2283","legal",6,4,2,0,12
"2284","lesson",7,3,1,1,12
"2285","limits",6,3,2,1,12
"2286","lynn",4,7,1,0,12
"2287","made",0,0,0,12,12
"2288","marshall",10,1,1,0,12
"2289","memorable",11,0,1,0,12
"2290","method",6,6,0,0,12
"2291","middle",2,6,3,1,12
"2292","multitude",4,5,1,2,12
"2293","necessarily",4,4,4,0,12
"2294","notion",4,6,1,1,12
"2295","oath",9,2,1,0,12
"2296","obtaining",6,6,0,0,12
"2297","occasional",3,7,1,1,12
"2298","ohio",11,1,0,0,12
"2299","pages",5,7,0,0,12
"2300","permit",7,5,0,0,12
"2301","possess",3,8,1,0,12
"2302","pour",4,5,2,1,12
"2303","practiced",4,8,0,0,12
"2304","preaching",3,7,2,0,12
"2305","prepare",3,6,3,0,12
"2306","probability",6,5,1,0,12
"2307","protecting",6,3,3,0,12
"2308","ray",6,4,2,0,12
"2309","recognition",9,3,0,0,12
"2310","reflections",9,2,1,0,12
"2311","regretted",10,1,0,1,12
"2312","regularly",3,7,2,0,12
"2313","remainder",5,4,1,2,12
"2314","remaining",4,5,2,1,12
"2315","remond",5,1,0,6,12
"2316","require",8,3,1,0,12
"2317","respecting",1,7,4,0,12
"2318","revealed",5,5,2,0,12
"2319","richmond",10,1,1,0,12
"2320","rigid",6,4,1,1,12
"2321","rivers",5,5,1,1,12
"2322","robbed",5,7,0,0,12
"2323","sailor",8,2,1,1,12
"2324","sake",4,7,1,0,12
"2325","satisfy",5,6,1,0,12
"2326","scandalous",6,6,0,0,12
"2327","scheme",7,5,0,0,12
"2328","scorn",6,6,0,0,12
"2329","section",10,2,0,0,12
"2330","shores",3,6,0,3,12
"2331","signal",9,2,1,0,12
"2332","singularly",5,6,1,0,12
"2333","smile",7,5,0,0,12
"2334","speakers",11,1,0,0,12
"2335","spelling",4,6,2,0,12
"2336","spirited",4,7,1,0,12
"2337","sports",3,7,2,0,12
"2338","stephen",10,2,0,0,12
"2339","straw",7,5,0,0,12
"2340","stronger",6,3,3,0,12
"2341","sublime",7,4,1,0,12
"2342","successfully",11,1,0,0,12
"2343","sufferings",2,7,3,0,12
"2344","suitable",4,7,1,0,12
"2345","suited",8,4,0,0,12
"2346","suppression",6,6,0,0,12
"2347","theslave",12,0,0,0,12
"2348","theywere",12,0,0,0,12
"2349","thrown",5,5,2,0,12
"2350","ties",5,5,2,0,12
"2351","took",0,0,0,12,12
"2352","training",5,5,2,0,12
"2353","traveled",8,4,0,0,12
"2354","unfavorable",5,6,1,0,12
"2355","unjust",7,4,1,0,12
"2356","viewed",4,7,1,0,12
"2357","vision",4,6,1,1,12
"2358","wear",5,6,1,0,12
"2359","will",0,0,0,12,12
"2360","witnesses",5,5,2,0,12
"2361","won",6,6,0,0,12
"2362","wright",6,5,1,0,12
"2363","wrought",6,5,0,1,12
"2364","wye",3,7,2,0,12
"2365","yoke",5,5,2,0,12
"2366","_a",1,8,2,0,11
"2367","_as",3,8,0,0,11
"2368","_we",4,7,0,0,11
"2369","1835",3,4,4,0,11
"2370","1836",5,6,0,0,11
"2371","accept",10,1,0,0,11
"2372","accomplished",8,3,0,0,11
"2373","acting",5,6,0,0,11
"2374","adapted",8,3,0,0,11
"2375","administrators",5,6,0,0,11
"2376","agitated",4,6,1,0,11
"2377","alas",4,2,3,2,11
"2378","alliance",4,7,0,0,11
"2379","amidst",4,7,0,0,11
"2380","angels",3,3,4,1,11
"2381","animals",4,6,0,1,11
"2382","application",4,6,1,0,11
"2383","apt",4,6,1,0,11
"2384","argue",2,9,0,0,11
"2385","armies",10,0,0,1,11
"2386","aspirations",5,5,1,0,11
"2387","assailed",9,2,0,0,11
"2388","assurance",4,3,4,0,11
"2389","assuring",6,4,1,0,11
"2390","astonished",4,5,2,0,11
"2391","attachment",4,6,1,0,11
"2392","bade",7,2,2,0,11
"2393","bag",6,2,2,1,11
"2394","bar",7,4,0,0,11
"2395","behave",3,5,3,0,11
"2396","bitterness",7,4,0,0,11
"2397","blessings",6,5,0,0,11
"2398","borders",6,5,0,0,11
"2399","bridge",3,7,1,0,11
"2400","bruises",5,5,1,0,11
"2401","buffalo",11,0,0,0,11
"2402","calls",5,2,3,1,11
"2403","canaan",6,5,0,0,11
"2404","capacity",6,3,2,0,11
"2405","certainty",5,4,2,0,11
"2406","charms",5,5,0,1,11
"2407","closely",4,6,1,0,11
"2408","cloud",4,5,1,1,11
"2409","commended",7,3,0,1,11
"2410","companions",6,5,0,0,11
"2411","compensation",3,5,3,0,11
"2412","conceal",4,5,2,0,11
"2413","confident",5,3,3,0,11
"2414","considerations",7,4,0,0,11
"2415","contact",6,5,0,0,11
"2416","contending",2,5,4,0,11
"2417","cookman",3,5,3,0,11
"2418","crowded",5,3,1,2,11
"2419","curse",4,5,2,0,11
"2420","dangers",7,4,0,0,11
"2421","dared",4,3,3,1,11
"2422","dealing",6,5,0,0,11
"2423","delay",10,1,0,0,11
"2424","delight",3,6,1,1,11
"2425","deserving",3,4,4,0,11
"2426","designs",6,5,0,0,11
"2427","despair",7,3,1,0,11
"2428","destruction",8,3,0,0,11
"2429","domestic",3,7,1,0,11
"2430","doors",7,3,1,0,11
"2431","drag",4,6,1,0,11
"2432","draw",5,6,0,0,11
"2433","dressed",5,2,2,2,11
"2434","dull",6,4,0,1,11
"2435","dying",5,4,2,0,11
"2436","earned",3,4,4,0,11
"2437","earnestly",6,4,1,0,11
"2438","egypt",1,1,0,9,11
"2439","eminent",8,2,1,0,11
"2440","enabled",6,3,2,0,11
"2441","endeavoring",6,4,0,1,11
"2442","endure",5,5,1,0,11
"2443","enfranchisement",11,0,0,0,11
"2444","evangelical",6,5,0,0,11
"2445","exceptions",3,6,2,0,11
"2446","executors",5,6,0,0,11
"2447","exhibition",4,4,1,2,11
"2448","expectations",4,5,2,0,11
"2449","explain",5,6,0,0,11
"2450","fame",5,4,2,0,11
"2451","fatal",7,3,1,0,11
"2452","fellows",5,5,1,0,11
"2453","fiery",5,6,0,0,11
"2454","finger",4,5,2,0,11
"2455","firmness",4,2,5,0,11
"2456","garfield",11,0,0,0,11
"2457","globe",2,5,2,2,11
"2458","gloomy",5,6,0,0,11
"2459","granite",4,3,1,3,11
"2460","grasp",3,7,1,0,11
"2461","hanged",5,5,1,0,11
"2462","hardened",0,8,2,1,11
"2463","heroic",9,2,0,0,11
"2464","hesitate",5,5,1,0,11
"2465","hide",4,5,2,0,11
"2466","hills",3,6,1,1,11
"2467","holds",1,7,1,2,11
"2468","hunters",4,5,2,0,11
"2469","hurry",6,4,1,0,11
"2470","image",3,6,2,0,11
"2471","imagined",6,3,2,0,11
"2472","imposed",6,5,0,0,11
"2473","improved",3,7,1,0,11
"2474","inauguration",11,0,0,0,11
"2475","inclined",5,5,1,0,11
"2476","india",8,2,1,0,11
"2477","indifferent",8,3,0,0,11
"2478","inhuman",5,6,0,0,11
"2479","inspire",4,6,1,0,11
"2480","introduced",9,2,0,0,11
"2481","irish",6,5,0,0,11
"2482","knock",3,6,2,0,11
"2483","landing",8,2,1,0,11
"2484","lecturer",4,7,0,0,11
"2485","letting",2,7,2,0,11
"2486","lewis",9,0,0,2,11
"2487","liverpool",4,3,0,4,11
"2488","losing",4,5,2,0,11
"2489","lower",4,5,2,0,11
"2490","majority",4,7,0,0,11
"2491","managed",6,3,2,0,11
"2492","mas",1,10,0,0,11
"2493","meals",3,5,2,1,11
"2494","morality",2,9,0,0,11
"2495","murderous",4,6,1,0,11
"2496","murray",3,4,3,1,11
"2497","music",4,5,1,1,11
"2498","nathan",5,4,2,0,11
"2499","nearer",6,3,1,1,11
"2500","ned",3,4,4,0,11
"2501","neighboring",2,3,5,1,11
"2502","notorious",4,7,0,0,11
"2503","obliged",6,4,0,1,11
"2504","observe",5,5,0,1,11
"2505","page",4,7,0,0,11
"2506","palace",1,0,0,10,11
"2507","passes",5,6,0,0,11
"2508","patriotic",10,1,0,0,11
"2509","perilous",8,3,0,0,11
"2510","pierce",6,5,0,0,11
"2511","place",0,0,0,11,11
"2512","playing",5,4,1,1,11
"2513","plead",7,4,0,0,11
"2514","pleasing",4,2,0,5,11
"2515","preach",2,4,3,2,11
"2516","prompt",5,6,0,0,11
"2517","prospects",6,5,0,0,11
"2518","pursue",7,3,1,0,11
"2519","receiving",2,4,4,1,11
"2520","reckless",4,6,1,0,11
"2521","remedy",5,5,1,0,11
"2522","representatives",10,1,0,0,11
"2523","resentment",9,1,0,1,11
"2524","resolution",2,6,3,0,11
"2525","resorted",5,5,1,0,11
"2526","respectfully",8,2,0,1,11
"2527","rhode",11,0,0,0,11
"2528","ridiculous",6,5,0,0,11
"2529","rob",3,5,3,0,11
"2530","roberts",4,5,2,0,11
"2531","rush",5,4,1,1,11
"2532","sadness",4,3,4,0,11
"2533","saved",9,1,1,0,11
"2534","select",6,5,0,0,11
"2535","senators",8,3,0,0,11
"2536","shop",5,5,1,0,11
"2537","shrouded",3,6,2,0,11
"2538","side",0,0,0,11,11
"2539","sinners",2,6,3,0,11
"2540","smoothly",5,2,3,1,11
"2541","soon",0,0,0,11,11
"2542","speaker",7,3,1,0,11
"2543","spending",4,4,3,0,11
"2544","statesmen",8,3,0,0,11
"2545","steps",5,6,0,0,11
"2546","sticks",4,4,3,0,11
"2547","stricken",7,2,2,0,11
"2548","sword",10,0,0,1,11
"2549","tall",4,7,0,0,11
"2550","tempest",8,3,0,0,11
"2551","tendency",7,2,2,0,11
"2552","testify",4,3,4,0,11
"2553","theodore",8,0,0,3,11
"2554","thick",5,5,1,0,11
"2555","threatened",6,5,0,0,11
"2556","tide",7,4,0,0,11
"2557","timid",8,2,1,0,11
"2558","tombs",5,2,0,4,11
"2559","touching",6,3,1,1,11
"2560","tour",6,1,0,4,11
"2561","towns",6,2,0,3,11
"2562","track",5,6,0,0,11
"2563","tremendous",9,2,0,0,11
"2564","trip",4,2,0,5,11
"2565","triumph",4,5,1,1,11
"2566","trowsers",5,6,0,0,11
"2567","tuesday",1,0,0,10,11
"2568","uponthe",11,0,0,0,11
"2569","vigilance",4,5,2,0,11
"2570","village",6,4,1,0,11
"2571","visits",4,7,0,0,11
"2572","watching",6,4,1,0,11
"2573","wilks",6,5,0,0,11
"2574","winds",6,5,0,0,11
"2575","wishing",5,4,2,0,11
"2576","without",0,0,0,11,11
"2577","wounded",7,2,1,1,11
"2578","1",4,3,3,0,10
"2579","1834",4,4,2,0,10
"2580","1845",0,3,7,0,10
"2581","1st",8,1,1,0,10
"2582","absurd",3,7,0,0,10
"2583","abundance",4,3,3,0,10
"2584","abundant",5,4,1,0,10
"2585","aged",6,4,0,0,10
"2586","agency",5,3,2,0,10
"2587","agreed",6,3,1,0,10
"2588","alabama",2,5,3,0,10
"2589","amazed",7,3,0,0,10
"2590","ample",5,5,0,0,10
"2591","angel",3,7,0,0,10
"2592","announcement",8,2,0,0,10
"2593","apprentices",4,4,2,0,10
"2594","approval",10,0,0,0,10
"2595","april",4,0,0,6,10
"2596","arose",5,4,1,0,10
"2597","ascertained",4,5,1,0,10
"2598","attempts",4,5,0,1,10
"2599","attendance",7,2,1,0,10
"2600","attractions",6,1,0,3,10
"2601","awaken",5,5,0,0,10
"2602","baggage",4,3,2,1,10
"2603","baily",2,8,0,0,10
"2604","banks",5,3,2,0,10
"2605","bearer",6,2,2,0,10
"2606","benevolent",6,3,1,0,10
"2607","beset",4,5,1,0,10
"2608","branded",2,8,0,0,10
"2609","breaker",4,3,3,0,10
"2610","briefly",6,2,2,0,10
"2611","brutality",3,7,0,0,10
"2612","busy",9,1,0,0,10
"2613","cairo",0,0,0,10,10
"2614","calkers",3,5,2,0,10
"2615","carolina",9,1,0,0,10
"2616","cars",5,5,0,0,10
"2617","caste",4,6,0,0,10
"2618","catholic",5,1,1,3,10
"2619","causing",3,2,5,0,10
"2620","century",9,1,0,0,10
"2621","christmas",2,4,4,0,10
"2622","competition",5,5,0,0,10
"2623","comrades",4,6,0,0,10
"2624","conceived",6,4,0,0,10
"2625","consciousness",4,6,0,0,10
"2626","constables",2,5,3,0,10
"2627","cotton",7,3,0,0,10
"2628","couldnot",10,0,0,0,10
"2629","creek",3,5,2,0,10
"2630","crushing",4,5,1,0,10
"2631","damage",5,5,0,0,10
"2632","damp",2,3,5,0,10
"2633","date",5,2,1,2,10
"2634","david",6,2,2,0,10
"2635","defence",7,0,3,0,10
"2636","delicate",4,5,1,0,10
"2637","deliverance",3,3,4,0,10
"2638","demon",3,4,3,0,10
"2639","denounce",3,7,0,0,10
"2640","deprive",5,2,3,0,10
"2641","destitution",9,1,0,0,10
"2642","destroyed",8,2,0,0,10
"2643","disagreeable",5,4,1,0,10
"2644","discharged",6,4,0,0,10
"2645","display",6,1,1,2,10
"2646","disregard",3,7,0,0,10
"2647","divinity",5,5,0,0,10
"2648","dogs",4,6,0,0,10
"2649","douglas",9,1,0,0,10
"2650","douglass_",0,1,9,0,10
"2651","drinking",4,4,2,0,10
"2652","dumb",3,7,0,0,10
"2653","earlier",6,3,1,0,10
"2654","economy",8,2,0,0,10
"2655","elements",5,5,0,0,10
"2656","embraced",5,5,0,0,10
"2657","errands",3,3,4,0,10
"2658","europe",5,2,0,3,10
"2659","evinced",3,6,1,0,10
"2660","exact",3,3,3,1,10
"2661","examination",4,2,4,0,10
"2662","fancy",4,6,0,0,10
"2663","figure",4,6,0,0,10
"2664","first",0,0,0,10,10
"2665","fled",4,4,2,0,10
"2666","flourish",5,5,0,0,10
"2667","foot",4,4,2,0,10
"2668","frankly",0,8,1,1,10
"2669","fraud",2,4,4,0,10
"2670","french",8,2,0,0,10
"2671","frequent",5,5,0,0,10
"2672","fretful",2,6,2,0,10
"2673","fruit",3,3,3,1,10
"2674","fury",4,3,3,0,10
"2675","gallant",5,4,1,0,10
"2676","gather",3,6,1,0,10
"2677","gerrit",8,2,0,0,10
"2678","girls",3,5,1,1,10
"2679","governments",8,2,0,0,10
"2680","grain",3,3,4,0,10
"2681","grandfather",3,6,1,0,10
"2682","granted",4,5,1,0,10
"2683","greatness",1,4,2,3,10
"2684","gross",3,5,2,0,10
"2685","grow",2,6,1,1,10
"2686","hamilton’s",3,6,1,0,10
"2687","hastily",7,2,1,0,10
"2688","hounds",4,4,1,1,10
"2689","humility",6,4,0,0,10
"2690","impress",3,3,3,1,10
"2691","independent",5,4,1,0,10
"2692","inevitable",4,2,4,0,10
"2693","inferred",7,2,1,0,10
"2694","inhabitants",3,5,1,1,10
"2695","inside",8,2,0,0,10
"2696","instant",4,3,3,0,10
"2697","intensely",5,4,1,0,10
"2698","interfere",3,7,0,0,10
"2699","issue",4,4,2,0,10
"2700","journal",5,5,0,0,10
"2701","kentucky",8,2,0,0,10
"2702","laborers",3,6,0,1,10
"2703","legislation",8,2,0,0,10
"2704","liberal",7,2,0,1,10
"2705","loose",4,5,1,0,10
"2706","maintained",4,6,0,0,10
"2707","man_",5,5,0,0,10
"2708","manifest",5,5,0,0,10
"2709","methods",4,6,0,0,10
"2710","midnight",4,4,2,0,10
"2711","mingled",4,6,0,0,10
"2712","multitudes",3,2,4,1,10
"2713","murdered",4,4,2,0,10
"2714","mutual",4,4,2,0,10
"2715","nantucket",2,5,3,0,10
"2716","naples",0,0,0,10,10
"2717","nose",4,3,3,0,10
"2718","offence",4,0,6,0,10
"2719","oftheir",10,0,0,0,10
"2720","oneof",10,0,0,0,10
"2721","oyster",4,5,1,0,10
"2722","pardon",5,5,0,0,10
"2723","parker",8,0,0,2,10
"2724","passions",4,6,0,0,10
"2725","pathos",5,2,3,0,10
"2726","paying",6,3,1,0,10
"2727","perception",4,5,1,0,10
"2728","phase",5,5,0,0,10
"2729","pinched",4,6,0,0,10
"2730","pine",5,3,1,1,10
"2731","pistols",3,5,2,0,10
"2732","placing",6,3,1,0,10
"2733","plight",5,5,0,0,10
"2734","politics",4,5,0,1,10
"2735","port",4,3,0,3,10
"2736","positions",8,2,0,0,10
"2737","pounds",4,5,1,0,10
"2738","poured",5,5,0,0,10
"2739","practical",4,6,0,0,10
"2740","preservation",6,3,1,0,10
"2741","protected",7,3,0,0,10
"2742","punished",4,5,1,0,10
"2743","raid",10,0,0,0,10
"2744","rapid",5,5,0,0,10
"2745","raw",4,4,2,0,10
"2746","refuse",5,3,1,1,10
"2747","relate",5,5,0,0,10
"2748","related",5,5,0,0,10
"2749","relationship",4,4,2,0,10
"2750","release",4,5,1,0,10
"2751","repeat",6,4,0,0,10
"2752","repose",3,6,0,1,10
"2753","represent",5,3,1,1,10
"2754","representation",6,4,0,0,10
"2755","resided",5,3,1,1,10
"2756","revelation",6,3,1,0,10
"2757","revolution",6,4,0,0,10
"2758","robbing",5,5,0,0,10
"2759","sadly",4,5,1,0,10
"2760","sails",2,3,3,2,10
"2761","santo",9,0,1,0,10
"2762","satisfactory",5,3,1,1,10
"2763","scattered",7,3,0,0,10
"2764","scholars",2,7,1,0,10
"2765","screams",4,5,1,0,10
"2766","sections",8,2,0,0,10
"2767","shall",0,0,0,10,10
"2768","shared",5,5,0,0,10
"2769","shield",2,4,4,0,10
"2770","shields",9,1,0,0,10
"2771","shoulder",5,5,0,0,10
"2772","sickness",3,3,1,3,10
"2773","sincerely",3,3,2,2,10
"2774","sizes",5,5,0,0,10
"2775","slaveholder’s",4,5,1,0,10
"2776","snatched",4,5,1,0,10
"2777","snow",2,2,2,4,10
"2778","societies",9,1,0,0,10
"2779","sooner",7,3,0,0,10
"2780","sorrows",2,7,1,0,10
"2781","spare",5,4,1,0,10
"2782","spite",4,3,3,0,10
"2783","sport",4,6,0,0,10
"2784","steadily",4,5,1,0,10
"2785","stirred",5,4,1,0,10
"2786","stream",2,3,2,3,10
"2787","strict",5,4,1,0,10
"2788","stringent",4,6,0,0,10
"2789","suggestion",7,3,0,0,10
"2790","sundry",5,5,0,0,10
"2791","supporting",4,5,1,0,10
"2792","suppress",5,3,2,0,10
"2793","survey",4,5,1,0,10
"2794","suspense",6,4,0,0,10
"2795","teachers",5,4,1,0,10
"2796","temple",5,1,0,4,10
"2797","thenorth",10,0,0,0,10
"2798","theory",3,5,2,0,10
"2799","think",0,0,0,10,10
"2800","throat",3,5,2,0,10
"2801","tired",5,4,0,1,10
"2802","tobacco",3,5,2,0,10
"2803","touch",6,2,0,2,10
"2804","transient",6,4,0,0,10
"2805","travelers",5,5,0,0,10
"2806","treason",9,1,0,0,10
"2807","uncommon",5,3,2,0,10
"2808","underground",7,2,0,1,10
"2809","unfriendly",6,3,1,0,10
"2810","valuation",3,3,4,0,10
"2811","vanished",4,5,1,0,10
"2812","venture",1,5,4,0,10
"2813","ventured",6,4,0,0,10
"2814","victorious",5,5,0,0,10
"2815","vindication",5,4,1,0,10
"2816","virtually",5,4,1,0,10
"2817","voices",2,4,3,1,10
"2818","votes",9,1,0,0,10
"2819","vow",4,5,1,0,10
"2820","ward",8,1,0,1,10
"2821","washing",3,3,3,1,10
"2822","waves",4,4,1,1,10
"2823","webster",8,2,0,0,10
"2824","whisper",4,5,1,0,10
"2825","wisely",8,2,0,0,10
"2826","wretch",3,5,2,0,10
"2827","yellow",7,2,1,0,10
"2828","_no",3,6,0,0,9
"2829","1833",3,3,3,0,9
"2830","1850",4,5,0,0,9
"2831","abby",9,0,0,0,9
"2832","aching",4,3,2,0,9
"2833","adopt",5,2,2,0,9
"2834","adrift",2,4,3,0,9
"2835","advocates",6,2,1,0,9
"2836","affairs",7,2,0,0,9
"2837","afflicted",2,4,3,0,9
"2838","aft",3,3,3,0,9
"2839","agreeable",5,1,1,2,9
"2840","aimed",3,5,1,0,9
"2841","albany",6,3,0,0,9
"2842","along",0,0,0,9,9
"2843","andi",9,0,0,0,9
"2844","answering",4,4,1,0,9
"2845","appalled",3,4,2,0,9
"2846","apprehended",4,5,0,0,9
"2847","approved",5,3,1,0,9
"2848","ardent",4,5,0,0,9
"2849","aristocracy",6,3,0,0,9
"2850","assassination",8,0,0,1,9
"2851","assault",4,4,1,0,9
"2852","assert",6,1,2,0,9
"2853","atrocious",3,5,1,0,9
"2854","attained",7,2,0,0,9
"2855","attainments",5,3,1,0,9
"2856","attitude",6,3,0,0,9
"2857","awful",0,6,3,0,9
"2858","ballot",9,0,0,0,9
"2859","based",6,3,0,0,9
"2860","battles",6,3,0,0,9
"2861","beam",5,3,1,0,9
"2862","beneficent",5,4,0,0,9
"2863","benevolence",4,4,1,0,9
"2864","betray",4,4,1,0,9
"2865","blast",3,5,1,0,9
"2866","bless",3,4,2,0,9
"2867","blessing",1,5,3,0,9
"2868","build",4,2,1,2,9
"2869","bushel",2,4,3,0,9
"2870","butler",5,3,1,0,9
"2871","candlish",4,5,0,0,9
"2872","carriages",1,3,0,5,9
"2873","center",7,2,0,0,9
"2874","chained",4,4,1,0,9
"2875","child’s",3,5,1,0,9
"2876","chosen",5,1,2,1,9
"2877","compelling",4,4,1,0,9
"2878","composed",6,2,0,1,9
"2879","comprehend",3,5,0,1,9
"2880","condemnation",2,7,0,0,9
"2881","confessed",5,4,0,0,9
"2882","conscious",3,5,1,0,9
"2883","constituted",5,4,0,0,9
"2884","contents",3,4,2,0,9
"2885","controlling",4,5,0,0,9
"2886","conventions",8,1,0,0,9
"2887","convicted",2,1,6,0,9
"2888","convinced",6,3,0,0,9
"2889","cooking",4,4,1,0,9
"2890","courts",5,2,1,1,9
"2891","cowardice",5,3,1,0,9
"2892","creatures",1,6,2,0,9
"2893","current",6,3,0,0,9
"2894","davis",7,0,0,2,9
"2895","decide",5,2,2,0,9
"2896","deepen",3,4,2,0,9
"2897","delaware",4,4,1,0,9
"2898","delighted",6,3,0,0,9
"2899","den",3,4,2,0,9
"2900","denunciation",5,3,1,0,9
"2901","deny",4,4,1,0,9
"2902","depend",4,4,1,0,9
"2903","depended",5,3,1,0,9
"2904","depth",3,5,1,0,9
"2905","destroying",5,4,0,0,9
"2906","development",2,5,2,0,9
"2907","disadvantages",5,4,0,0,9
"2908","discourse",4,5,0,0,9
"2909","displayed",6,3,0,0,9
"2910","distinguish",3,5,1,0,9
"2911","dixon’s",2,5,2,0,9
"2912","domingo",8,0,1,0,9
"2913","dorr",9,0,0,0,9
"2914","double",3,5,1,0,9
"2915","doubtful",5,2,2,0,9
"2916","drunk",3,3,3,0,9
"2917","dry",4,4,1,0,9
"2918","earliest",2,5,2,0,9
"2919","eighty",4,4,1,0,9
"2920","elevation",3,6,0,0,9
"2921","employments",6,3,0,0,9
"2922","enable",7,2,0,0,9
"2923","encountered",8,0,1,0,9
"2924","enmity",5,4,0,0,9
"2925","entertain",3,5,1,0,9
"2926","entitled",5,2,2,0,9
"2927","especial",6,3,0,0,9
"2928","estimate",5,2,2,0,9
"2929","exalted",5,4,0,0,9
"2930","execute",6,3,0,0,9
"2931","executed",4,5,0,0,9
"2932","executive",9,0,0,0,9
"2933","exists",1,7,1,0,9
"2934","experiences",6,3,0,0,9
"2935","explained",5,4,0,0,9
"2936","expose",4,5,0,0,9
"2937","extremity",6,3,0,0,9
"2938","faults",3,4,2,0,9
"2939","favorably",5,3,0,1,9
"2940","feeble",3,3,3,0,9
"2941","fences",4,5,0,0,9
"2942","ferocious",4,4,1,0,9
"2943","fertile",4,5,0,0,9
"2944","fewer",3,5,1,0,9
"2945","finished",4,4,1,0,9
"2946","flashed",1,3,4,1,9
"2947","footed",3,4,1,1,9
"2948","foreign",1,7,0,1,9
"2949","foremost",4,5,0,0,9
"2950","forts",9,0,0,0,9
"2951","frame",5,3,1,0,9
"2952","full",0,0,0,9,9
"2953","genius",5,4,0,0,9
"2954","gib",4,5,0,0,9
"2955","gifts",3,5,1,0,9
"2956","graceful",4,4,1,0,9
"2957","grandmother’s",5,4,0,0,9
"2958","graves",8,1,0,0,9
"2959","grievous",3,5,1,0,9
"2960","habit",5,3,1,0,9
"2961","hang",5,4,0,0,9
"2962","havebeen",9,0,0,0,9
"2963","healing",4,5,0,0,9
"2964","heathen",0,4,3,2,9
"2965","hound",1,8,0,0,9
"2966","hunter",5,4,0,0,9
"2967","hunting",2,5,2,0,9
"2968","icould",9,0,0,0,9
"2969","ihave",9,0,0,0,9
"2970","improve",6,2,1,0,9
"2971","impunity",3,4,2,0,9
"2972","inhis",9,0,0,0,9
"2973","interesting",0,0,0,9,9
"2974","internal",2,6,0,1,9
"2975","invisible",3,4,2,0,9
"2976","irons",3,5,1,0,9
"2977","labored",5,4,0,0,9
"2978","lack",6,3,0,0,9
"2979","lake",5,2,1,1,9
"2980","lame",3,5,1,0,9
"2981","larboard",3,3,3,0,9
"2982","life_",2,6,1,0,9
"2983","limb",4,3,1,1,9
"2984","lone",3,4,2,0,9
"2985","looking",0,0,0,9,9
"2986","louisiana",6,2,1,0,9
"2987","luck",2,5,0,2,9
"2988","madness",5,3,1,0,9
"2989","malign",5,4,0,0,9
"2990","manage",2,4,2,1,9
"2991","mangled",2,4,3,0,9
"2992","mason",2,5,2,0,9
"2993","measured",5,3,1,0,9
"2994","mile",4,5,0,0,9
"2995","mistaken",5,3,1,0,9
"2996","modern",3,3,0,3,9
"2997","monroe",7,0,0,2,9
"2998","monster",1,7,1,0,9
"2999","monthly",3,3,3,0,9
"3000","murderer",5,4,0,0,9
"3001","muttering",5,4,0,0,9
"3002","mysterious",3,5,1,0,9
"3003","narration",4,4,1,0,9
"3004","narrowly",4,4,1,0,9
"3005","nation’s",5,4,0,0,9
"3006","neglected",4,4,1,0,9
"3007","nerve",6,3,0,0,9
"3008","nice",2,4,0,3,9
"3009","notes",3,5,1,0,9
"3010","occupation",4,5,0,0,9
"3011","occurrence",4,3,2,0,9
"3012","openly",3,4,2,0,9
"3013","orators",5,4,0,0,9
"3014","outrages",3,3,3,0,9
"3015","outward",2,5,2,0,9
"3016","overseer’s",5,3,1,0,9
"3017","overtaken",3,4,2,0,9
"3018","oysters",3,5,1,0,9
"3019","pack",5,4,0,0,9
"3020","parents",3,5,1,0,9
"3021","part",0,0,0,9,9
"3022","perish",7,1,0,1,9
"3023","perpetrated",3,3,3,0,9
"3024","perpetuate",6,3,0,0,9
"3025","persecuted",5,4,0,0,9
"3026","persuaded",3,4,2,0,9
"3027","pillars",4,2,0,3,9
"3028","plummer",2,5,2,0,9
"3029","poison",3,4,2,0,9
"3030","pork",4,4,1,0,9
"3031","possibility",6,2,1,0,9
"3032","potatoes",4,5,0,0,9
"3033","prejudices",5,3,1,0,9
"3034","presentiment",3,6,0,0,9
"3035","pressing",4,3,1,1,9
"3036","pressure",3,4,0,2,9
"3037","prisoners",8,1,0,0,9
"3038","proceeding",5,4,0,0,9
"3039","propriety",4,4,1,0,9
"3040","proves",3,5,1,0,9
"3041","rage",4,4,1,0,9
"3042","rare",1,4,3,1,9
"3043","rascal",4,5,0,0,9
"3044","recognize",3,5,1,0,9
"3045","refusing",4,4,1,0,9
"3046","regiments",8,0,1,0,9
"3047","rejected",4,3,2,0,9
"3048","rejoice",3,5,0,1,9
"3049","relied",5,3,1,0,9
"3050","reluctant",4,4,1,0,9
"3051","rent",7,2,0,0,9
"3052","report",6,3,0,0,9
"3053","representative",2,6,1,0,9
"3054","reproaches",6,3,0,0,9
"3055","request",5,3,1,0,9
"3056","resemblance",4,5,0,0,9
"3057","resembled",4,5,0,0,9
"3058","resolutions",4,5,0,0,9
"3059","richard",3,3,2,1,9
"3060","righteous",3,2,4,0,9
"3061","robber",3,4,2,0,9
"3062","route",4,3,2,0,9
"3063","salt",5,4,0,0,9
"3064","sandy’s",4,5,0,0,9
"3065","scarce",2,1,6,0,9
"3066","scuffle",3,3,3,0,9
"3067","seemed",0,0,0,9,9
"3068","sept",0,0,0,9,9
"3069","september",4,3,2,0,9
"3070","several",0,0,0,9,9
"3071","sevier",1,8,0,0,9
"3072","seward",8,1,0,0,9
"3073","shadows",5,4,0,0,9
"3074","shoes",2,3,3,1,9
"3075","shunned",2,5,2,0,9
"3076","sign",3,2,0,4,9
"3077","sixteen",3,3,2,1,9
"3078","slept",4,5,0,0,9
"3079","slow",5,3,1,0,9
"3080","smiles",3,5,1,0,9
"3081","snatch",2,4,3,0,9
"3082","square",6,1,0,2,9
"3083","stagger",2,4,3,0,9
"3084","stanton",8,0,0,1,9
"3085","starboard",2,3,3,1,9
"3086","stead",4,5,0,0,9
"3087","steamers",4,5,0,0,9
"3088","stewart",3,5,1,0,9
"3089","stillness",2,4,1,2,9
"3090","stumps",4,4,1,0,9
"3091","substantial",7,2,0,0,9
"3092","summoned",2,6,1,0,9
"3093","sunshine",3,1,0,5,9
"3094","swine",2,6,1,0,9
"3095","temporary",5,4,0,0,9
"3096","territories",9,0,0,0,9
"3097","thereof",4,4,1,0,9
"3098","theunited",9,0,0,0,9
"3099","theworld",9,0,0,0,9
"3100","thin",3,5,0,1,9
"3101","thither",5,2,2,0,9
"3102","tones",2,4,3,0,9
"3103","torment",2,3,4,0,9
"3104","trickery",3,4,2,0,9
"3105","trodden",3,4,2,0,9
"3106","trusted",7,2,0,0,9
"3107","tying",3,4,2,0,9
"3108","undertake",4,3,1,1,9
"3109","unsafe",2,3,4,0,9
"3110","urge",7,1,1,0,9
"3111","uttered",7,2,0,0,9
"3112","vessel",6,1,1,1,9
"3113","vigorous",6,3,0,0,9
"3114","wasthe",9,0,0,0,9
"3115","weary",5,4,0,0,9
"3116","weeden",0,6,3,0,9
"3117","whichi",9,0,0,0,9
"3118","widely",5,3,1,0,9
"3119","win",5,4,0,0,9
"3120","windows",5,3,1,0,9
"3121","witnessing",2,6,1,0,9
"3122","woman’s",5,3,1,0,9
"3123","wonders",4,2,0,3,9
"3124","wooden",4,4,1,0,9
"3125","workers",7,2,0,0,9
"3126","workmen",4,3,1,1,9
"3127","yards",5,3,1,0,9
"3128","_mr",2,0,6,0,8
"3129","_my",3,4,1,0,8
"3130","_slavery_",2,6,0,0,8
"3131","_they_",3,4,1,0,8
"3132","_to",3,5,0,0,8
"3133","_who_",2,6,0,0,8
"3134","1841",2,3,3,0,8
"3135","abandon",3,4,1,0,8
"3136","abode",4,4,0,0,8
"3137","abounding",6,1,0,1,8
"3138","accompany",6,1,0,1,8
"3139","accord",5,1,2,0,8
"3140","accordance",3,5,0,0,8
"3141","accused",3,2,3,0,8
"3142","achievements",5,3,0,0,8
"3143","actual",3,4,1,0,8
"3144","adams",6,1,0,1,8
"3145","adding",4,4,0,0,8
"3146","addresses",5,2,0,1,8
"3147","affair",4,1,3,0,8
"3148","affect",2,2,4,0,8
"3149","affections",2,6,0,0,8
"3150","almost",0,0,0,8,8
"3151","also",0,0,0,8,8
"3152","animated",2,4,2,0,8
"3153","appealing",3,5,0,0,8
"3154","arranged",5,3,0,0,8
"3155","assemblage",4,2,0,2,8
"3156","assented",5,3,0,0,8
"3157","asserted",4,4,0,0,8
"3158","associations",4,3,0,1,8
"3159","authorities",3,5,0,0,8
"3160","aversion",5,3,0,0,8
"3161","badly",3,4,1,0,8
"3162","balance",4,4,0,0,8
"3163","balsam",3,5,0,0,8
"3164","beheld",2,3,2,1,8
"3165","betrayer",3,3,2,0,8
"3166","better",0,0,0,8,8
"3167","bewildered",5,3,0,0,8
"3168","blame",6,2,0,0,8
"3169","blanket",3,4,1,0,8
"3170","blind",4,3,1,0,8
"3171","bolt",4,3,1,0,8
"3172","bondley",4,4,0,0,8
"3173","bone",4,4,0,0,8
"3174","bosom",0,6,1,1,8
"3175","breadth",5,3,0,0,8
"3176","brings",4,3,1,0,8
"3177","burst",0,6,2,0,8
"3178","butthe",8,0,0,0,8
"3179","came",0,0,0,8,8
"3180","canvass",7,0,0,1,8
"3181","caucasian",4,4,0,0,8
"3182","caution",4,4,0,0,8
"3183","celebrate",8,0,0,0,8
"3184","chimney",3,3,2,0,8
"3185","cities",2,3,0,3,8
"3186","clark",7,0,0,1,8
"3187","closing",4,3,1,0,8
"3188","cloth",4,3,1,0,8
"3189","clothe",2,6,0,0,8
"3190","clothed",3,4,1,0,8
"3191","cobden",8,0,0,0,8
"3192","coldest",3,2,3,0,8
"3193","committees",6,2,0,0,8
"3194","comparative",3,4,0,1,8
"3195","comprehensive",7,1,0,0,8
"3196","conception",1,3,3,1,8
"3197","conciliation",5,2,1,0,8
"3198","conductors",1,5,2,0,8
"3199","confirmed",5,3,0,0,8
"3200","consultation",3,3,2,0,8
"3201","contemplate",4,2,1,1,8
"3202","copying",1,3,4,0,8
"3203","cordially",5,1,0,2,8
"3204","costly",3,1,0,4,8
"3205","counsel",4,3,1,0,8
"3206","covering",2,3,3,0,8
"3207","crawl",2,3,3,0,8
"3208","creed",3,4,0,1,8
"3209","cure",3,5,0,0,8
"3210","cursed",4,3,1,0,8
"3211","customs",3,4,0,1,8
"3212","cutting",1,2,5,0,8
"3213","dancing",3,3,1,1,8
"3214","deceived",4,2,2,0,8
"3215","decidedly",4,2,2,0,8
"3216","declare",4,4,0,0,8
"3217","demby",0,1,7,0,8
"3218","department",7,1,0,0,8
"3219","dependent",5,2,1,0,8
"3220","deplorable",1,6,1,0,8
"3221","describing",2,5,1,0,8
"3222","desert",3,3,0,2,8
"3223","desirous",6,1,1,0,8
"3224","devouring",3,5,0,0,8
"3225","disappointment",5,3,0,0,8
"3226","disgraceful",3,5,0,0,8
"3227","disgust",2,4,2,0,8
"3228","disregarded",3,4,1,0,8
"3229","dissipation",2,3,3,0,8
"3230","distress",5,3,0,0,8
"3231","doctrines",6,1,0,1,8
"3232","dominion",4,4,0,0,8
"3233","driver’s",3,3,2,0,8
"3234","dwelling",3,4,0,1,8
"3235","easter",2,3,2,1,8
"3236","ell",3,4,1,0,8
"3237","embarrassment",4,3,1,0,8
"3238","encouragement",4,3,1,0,8
"3239","endeavor",6,2,0,0,8
"3240","endeavored",4,2,1,1,8
"3241","enforced",3,5,0,0,8
"3242","engage",2,5,1,0,8
"3243","enslave",4,3,1,0,8
"3244","entrance",4,3,1,0,8
"3245","exercises",2,5,1,0,8
"3246","exhausted",6,2,0,0,8
"3247","exhibited",2,5,0,1,8
"3248","exposing",3,5,0,0,8
"3249","extension",7,1,0,0,8
"3250","extravagant",5,3,0,0,8
"3251","fairbanks",4,2,2,0,8
"3252","fancied",5,3,0,0,8
"3253","flag",7,1,0,0,8
"3254","flowers",6,2,0,0,8
"3255","folly",6,2,0,0,8
"3256","forbidding",4,4,0,0,8
"3257","forehead",4,4,0,0,8
"3258","fourteen",3,4,1,0,8
"3259","fourth",2,6,0,0,8
"3260","framed",7,1,0,0,8
"3261","france",5,2,0,1,8
"3262","freed",6,2,0,0,8
"3263","freedman",8,0,0,0,8
"3264","galling",3,3,2,0,8
"3265","gaze",1,6,1,0,8
"3266","generation",7,1,0,0,8
"3267","generously",4,4,0,0,8
"3268","glaring",1,5,2,0,8
"3269","grandmamma",2,6,0,0,8
"3270","grim",2,4,2,0,8
"3271","happiest",3,4,1,0,8
"3272","harmony",4,4,0,0,8
"3273","haste",6,1,1,0,8
"3274","hayes",8,0,0,0,8
"3275","hays",4,4,0,0,8
"3276","hearth",2,4,2,0,8
"3277","heavens",4,3,0,1,8
"3278","heavily",2,3,3,0,8
"3279","helping",3,2,3,0,8
"3280","hero",5,3,0,0,8
"3281","hesaid",8,0,0,0,8
"3282","hillsborough",2,3,3,0,8
"3283","hinder",2,2,4,0,8
"3284","hoe",1,4,1,2,8
"3285","hopeless",2,4,2,0,8
"3286","horn",2,3,3,0,8
"3287","humiliating",4,4,0,0,8
"3288","hunt",5,3,0,0,8
"3289","hypocrisy",2,5,1,0,8
"3290","impart",4,4,0,0,8
"3291","implied",4,4,0,0,8
"3292","inches",4,3,1,0,8
"3293","indiana",6,2,0,0,8
"3294","indolent",4,4,0,0,8
"3295","infliction",3,4,0,1,8
"3296","innocence",3,4,1,0,8
"3297","insecurity",4,3,1,0,8
"3298","insight",4,3,1,0,8
"3299","insisted",5,2,1,0,8
"3300","inthat",8,0,0,0,8
"3301","isolation",5,3,0,0,8
"3302","jacket",2,4,2,0,8
"3303","journals",5,3,0,0,8
"3304","judging",3,5,0,0,8
"3305","jury",6,2,0,0,8
"3306","king",1,4,1,2,8
"3307","kingdom",4,3,1,0,8
"3308","kneel",3,3,2,0,8
"3309","lad",4,4,0,0,8
"3310","laugh",4,3,1,0,8
"3311","liable",2,2,4,0,8
"3312","lift",6,2,0,0,8
"3313","lions",2,3,3,0,8
"3314","loaded",3,3,1,1,8
"3315","logical",5,3,0,0,8
"3316","lord’s",3,5,0,0,8
"3317","manifestation",2,3,3,0,8
"3318","marvelous",3,5,0,0,8
"3319","mastered",4,3,1,0,8
"3320","mastery",4,4,0,0,8
"3321","match",3,4,1,0,8
"3322","maxim",1,4,3,0,8
"3323","mending",2,4,2,0,8
"3324","merry",1,6,0,1,8
"3325","military",8,0,0,0,8
"3326","missiles",4,3,1,0,8
"3327","mississippi",5,2,1,0,8
"3328","morals",2,4,2,0,8
"3329","mush",3,4,1,0,8
"3330","newport",3,1,4,0,8
"3331","noblest",6,1,1,0,8
"3332","noisy",2,4,0,2,8
"3333","norris",8,0,0,0,8
"3334","noticed",4,3,0,1,8
"3335","ofhis",8,0,0,0,8
"3336","ofthese",8,0,0,0,8
"3337","onward",3,5,0,0,8
"3338","oppressor",2,4,2,0,8
"3339","organization",6,2,0,0,8
"3340","outraged",2,6,0,0,8
"3341","park",5,1,0,2,8
"3342","peaceful",6,2,0,0,8
"3343","permanent",7,1,0,0,8
"3344","perry",5,3,0,0,8
"3345","persecution",4,3,1,0,8
"3346","persisted",5,3,0,0,8
"3347","planted",5,3,0,0,8
"3348","played",2,6,0,0,8
"3349","pomp",3,1,2,2,8
"3350","powerfully",3,3,1,1,8
"3351","preference",3,5,0,0,8
"3352","preserved",6,0,1,1,8
"3353","previously",2,4,2,0,8
"3354","printing",3,5,0,0,8
"3355","procure",5,3,0,0,8
"3356","professedly",2,4,2,0,8
"3357","prudence",2,4,2,0,8
"3358","publicly",5,3,0,0,8
"3359","publishing",2,6,0,0,8
"3360","purchased",5,3,0,0,8
"3361","rail",3,4,1,0,8
"3362","reasonable",6,2,0,0,8
"3363","redress",2,5,1,0,8
"3364","reflection",2,4,2,0,8
"3365","regiment",8,0,0,0,8
"3366","reluctantly",3,3,2,0,8
"3367","remind",2,4,1,1,8
"3368","republicans",6,2,0,0,8
"3369","repulsive",4,4,0,0,8
"3370","restless",3,3,2,0,8
"3371","restore",5,3,0,0,8
"3372","retained",5,3,0,0,8
"3373","reverence",1,4,3,0,8
"3374","rigors",3,5,0,0,8
"3375","roots",2,4,2,0,8
"3376","saddened",2,3,3,0,8
"3377","salvation",4,3,1,0,8
"3378","sang",4,3,1,0,8
"3379","sank",3,2,3,0,8
"3380","sarah",5,2,0,1,8
"3381","scoundrel",3,5,0,0,8
"3382","sensitive",3,4,1,0,8
"3383","sermon",4,2,0,2,8
"3384","shades",4,3,1,0,8
"3385","shocked",4,3,1,0,8
"3386","shook",4,2,2,0,8
"3387","shooting",4,3,1,0,8
"3388","sins",2,6,0,0,8
"3389","situated",2,2,1,3,8
"3390","size",2,4,2,0,8
"3391","smooth",4,1,1,2,8
"3392","solemnity",2,5,1,0,8
"3393","solitary",4,3,0,1,8
"3394","sorts",4,3,0,1,8
"3395","speaks",1,5,0,2,8
"3396","species",5,3,0,0,8
"3397","specimen",2,4,2,0,8
"3398","speedy",4,2,1,1,8
"3399","staggered",3,3,2,0,8
"3400","stars",7,1,0,0,8
"3401","starving",4,4,0,0,8
"3402","statesman",7,0,1,0,8
"3403","sterling",3,5,0,0,8
"3404","sternly",4,4,0,0,8
"3405","sting",3,3,2,0,8
"3406","stockings",2,3,3,0,8
"3407","strangely",4,2,2,0,8
"3408","strengthen",6,2,0,0,8
"3409","struggled",2,4,2,0,8
"3410","stupendous",5,1,0,2,8
"3411","submission",5,3,0,0,8
"3412","submitted",4,2,2,0,8
"3413","suit",4,2,2,0,8
"3414","sundays",3,2,3,0,8
"3415","supporters",4,4,0,0,8
"3416","surname",3,5,0,0,8
"3417","surprising",6,1,1,0,8
"3418","swallow",0,3,4,1,8
"3419","swamps",4,3,1,0,8
"3420","tedious",4,3,1,0,8
"3421","tells",1,6,0,1,8
"3422","test",4,4,0,0,8
"3423","themost",8,0,0,0,8
"3424","theology",6,2,0,0,8
"3425","thetime",8,0,0,0,8
"3426","though",0,0,0,8,8
"3427","thread",2,5,0,1,8
"3428","three",0,0,0,8,8
"3429","thursday",0,0,0,8,8
"3430","togive",8,0,0,0,8
"3431","tormentor",2,6,0,0,8
"3432","traits",3,1,3,1,8
"3433","transformed",4,3,1,0,8
"3434","treading",4,3,1,0,8
"3435","treating",4,3,1,0,8
"3436","tribute",6,2,0,0,8
"3437","undertook",3,3,2,0,8
"3438","unfrequently",5,3,0,0,8
"3439","universal",4,2,2,0,8
"3440","unmanageable",2,2,4,0,8
"3441","unwilling",4,4,0,0,8
"3442","usage",5,3,0,0,8
"3443","valley",3,1,1,3,8
"3444","volumes",4,2,1,1,8
"3445","waste",4,1,0,3,8
"3446","watson",4,3,1,0,8
"3447","weakness",3,5,0,0,8
"3448","wealthy",4,4,0,0,8
"3449","wednesday",0,0,0,8,8
"3450","weighed",3,3,2,0,8
"3451","wept",3,5,0,0,8
"3452","wheel",4,3,1,0,8
"3453","willingly",3,4,1,0,8
"3454","window",5,2,1,0,8
"3455","winged",4,3,1,0,8
"3456","winthrop",8,0,0,0,8
"3457","withal",5,3,0,0,8
"3458","world’s",3,5,0,0,8
"3459","yesterday",3,2,0,3,8
"3460","_columbian",0,7,0,0,7
"3461","_man_",2,4,1,0,7
"3462","1860",7,0,0,0,7
"3463","1863",7,0,0,0,7
"3464","2",2,3,2,0,7
"3465","54th",6,0,1,0,7
"3466","abilities",3,4,0,0,7
"3467","abuses",3,4,0,0,7
"3468","accepted",7,0,0,0,7
"3469","accommodation",3,4,0,0,7
"3470","accompanied",4,2,1,0,7
"3471","accomplish",2,5,0,0,7
"3472","accomplishment",3,2,1,1,7
"3473","accursed",1,5,1,0,7
"3474","acres",3,3,0,1,7
"3475","addressing",4,2,1,0,7
"3476","adoption",5,2,0,0,7
"3477","adorned",4,2,0,1,7
"3478","adverse",5,2,0,0,7
"3479","advised",5,0,2,0,7
"3480","aggressive",7,0,0,0,7
"3481","allies",3,3,1,0,7
"3482","allthe",7,0,0,0,7
"3483","alluded",2,4,1,0,7
"3484","amendment",7,0,0,0,7
"3485","among",0,0,0,7,7
"3486","amongthe",7,0,0,0,7
"3487","ancient",0,1,1,5,7
"3488","anda",7,0,0,0,7
"3489","anderson",6,0,0,1,7
"3490","andto",7,0,0,0,7
"3491","animal",3,3,0,1,7
"3492","anna",2,1,4,0,7
"3493","answers",3,4,0,0,7
"3494","appalling",1,3,3,0,7
"3495","applaud",3,3,1,0,7
"3496","applause",3,2,2,0,7
"3497","applying",2,5,0,0,7
"3498","arrested",5,1,1,0,7
"3499","aslave",7,0,0,0,7
"3500","assaults",3,3,1,0,7
"3501","assigned",4,3,0,0,7
"3502","astonishment",3,3,1,0,7
"3503","asunder",4,3,0,0,7
"3504","atlantic",4,2,1,0,7
"3505","attacks",3,3,1,0,7
"3506","attentions",5,2,0,0,7
"3507","attracted",4,2,0,1,7
"3508","avenue",2,3,1,1,7
"3509","awake",3,2,0,2,7
"3510","banner",5,1,1,0,7
"3511","bargain",1,4,2,0,7
"3512","bassett",7,0,0,0,7
"3513","bears",2,5,0,0,7
"3514","behaved",4,2,1,0,7
"3515","beneficial",2,5,0,0,7
"3516","blasted",2,5,0,0,7
"3517","boiling",3,3,1,0,7
"3518","bondmen",1,6,0,0,7
"3519","boots",6,1,0,0,7
"3520","boundless",5,2,0,0,7
"3521","bow",2,2,0,3,7
"3522","brand",1,5,1,0,7
"3523","brass",1,6,0,0,7
"3524","breathed",3,2,2,0,7
"3525","bruised",2,5,0,0,7
"3526","burial",4,2,1,0,7
"3527","cabinet",7,0,0,0,7
"3528","can",0,0,0,7,7
"3529","can’t",3,3,1,0,7
"3530","cannon",4,3,0,0,7
"3531","caprice",2,5,0,0,7
"3532","captured",7,0,0,0,7
"3533","catching",3,3,1,0,7
"3534","centuries",5,1,1,0,7
"3535","ceremonies",5,1,0,1,7
"3536","charity",5,2,0,0,7
"3537","charmed",4,3,0,0,7
"3538","cheek",2,4,1,0,7
"3539","circles",3,4,0,0,7
"3540","circulation",5,2,0,0,7
"3541","citizenship",7,0,0,0,7
"3542","colleges",7,0,0,0,7
"3543","colonization",5,2,0,0,7
"3544","commanding",2,2,2,1,7
"3545","communication",4,2,1,0,7
"3546","comprehension",3,2,1,1,7
"3547","concealed",3,3,0,1,7
"3548","conceive",1,3,2,1,7
"3549","confided",4,2,1,0,7
"3550","conquered",4,2,1,0,7
"3551","constitutional",5,2,0,0,7
"3552","consumed",1,4,2,0,7
"3553","contemptible",3,4,0,0,7
"3554","contradiction",4,1,1,1,7
"3555","coöperation",7,0,0,0,7
"3556","cordial",4,2,0,1,7
"3557","counter",5,2,0,0,7
"3558","counting",3,3,1,0,7
"3559","countries",4,3,0,0,7
"3560","cow",4,3,0,0,7
"3561","cox",3,4,0,0,7
"3562","craft",2,3,2,0,7
"3563","cripple",4,2,1,0,7
"3564","crowned",3,2,1,1,7
"3565","cultivation",4,2,1,0,7
"3566","cup",2,3,2,0,7
"3567","damning",1,6,0,0,7
"3568","dawn",4,2,1,0,7
"3569","debt",5,1,1,0,7
"3570","declaration",2,3,2,0,7
"3571","deepest",4,2,1,0,7
"3572","deliberately",1,5,1,0,7
"3573","demonstration",4,2,1,0,7
"3574","denial",5,2,0,0,7
"3575","deportment",3,4,0,0,7
"3576","deserved",3,3,1,0,7
"3577","desk",5,2,0,0,7
"3578","despise",2,3,2,0,7
"3579","destined",5,2,0,0,7
"3580","dirt",4,2,1,0,7
"3581","dirty",2,2,3,0,7
"3582","discharge",3,3,1,0,7
"3583","disgusting",2,5,0,0,7
"3584","dispose",5,2,0,0,7
"3585","distinctions",4,3,0,0,7
"3586","documents",4,1,2,0,7
"3587","dog",2,5,0,0,7
"3588","domain",2,4,1,0,7
"3589","dragging",3,4,0,0,7
"3590","dreadful",4,2,1,0,7
"3591","duly",6,1,0,0,7
"3592","eagerly",3,4,0,0,7
"3593","earn",5,2,0,0,7
"3594","edinburgh",4,3,0,0,7
"3595","edited",4,3,0,0,7
"3596","educational",6,1,0,0,7
"3597","efficient",4,2,1,0,7
"3598","egyptian",0,1,0,6,7
"3599","embarrass",2,3,2,0,7
"3600","emergency",6,1,0,0,7
"3601","emotions",2,3,2,0,7
"3602","emphatic",6,1,0,0,7
"3603","employer",5,1,1,0,7
"3604","enacted",2,4,1,0,7
"3605","encourage",2,3,2,0,7
"3606","encouraging",4,3,0,0,7
"3607","enduring",5,1,0,1,7
"3608","enjoyment",3,3,1,0,7
"3609","establishing",5,2,0,0,7
"3610","estimation",4,3,0,0,7
"3611","exclusively",4,3,0,0,7
"3612","expenses",3,2,2,0,7
"3613","faculties",1,6,0,0,7
"3614","faculty",3,2,2,0,7
"3615","faint",3,2,2,0,7
"3616","familiar",4,2,1,0,7
"3617","federal",7,0,0,0,7
"3618","filling",4,3,0,0,7
"3619","finely",2,3,2,0,7
"3620","fires",2,5,0,0,7
"3621","fitness",5,2,0,0,7
"3622","five",0,0,0,7,7
"3623","flash",3,3,1,0,7
"3624","flat",4,3,0,0,7
"3625","flock",2,4,1,0,7
"3626","flog",3,4,0,0,7
"3627","forbade",3,2,2,0,7
"3628","foreman",3,3,1,0,7
"3629","forest",2,4,1,0,7
"3630","forgot",3,3,1,0,7
"3631","fowls",2,4,1,0,7
"3632","frauds",1,2,4,0,7
"3633","freddy",3,3,1,0,7
"3634","freedmen’s",7,0,0,0,7
"3635","frost",2,4,1,0,7
"3636","fulfilled",5,1,1,0,7
"3637","game",4,3,0,0,7
"3638","gardner’s",0,0,7,0,7
"3639","garrisonians",2,5,0,0,7
"3640","generations",5,2,0,0,7
"3641","geography",3,4,0,0,7
"3642","gleam",3,4,0,0,7
"3643","god’s",2,4,1,0,7
"3644","golden",5,2,0,0,7
"3645","graham",3,2,2,0,7
"3646","grapple",4,3,0,0,7
"3647","greeley",6,1,0,0,7
"3648","growth",1,5,0,1,7
"3649","guests",5,1,0,1,7
"3650","guilt",3,4,0,0,7
"3651","hanson",3,4,0,0,7
"3652","harder",3,1,3,0,7
"3653","hat",3,3,1,0,7
"3654","healthy",4,3,0,0,7
"3655","heights",3,0,0,4,7
"3656","heirs",3,4,0,0,7
"3657","heroes",6,1,0,0,7
"3658","hidden",3,3,0,1,7
"3659","hilles",7,0,0,0,7
"3660","honestly",3,4,0,0,7
"3661","honey",3,3,0,1,7
"3662","hook",2,2,2,1,7
"3663","horseback",2,4,1,0,7
"3664","hostile",5,2,0,0,7
"3665","hottest",1,3,3,0,7
"3666","hymn",2,2,3,0,7
"3667","ike",3,4,0,0,7
"3668","ills",3,2,2,0,7
"3669","illustrated",1,5,1,0,7
"3670","incendiary",3,4,0,0,7
"3671","indignant",5,1,1,0,7
"3672","indispensable",1,1,5,0,7
"3673","individuality",3,4,0,0,7
"3674","inevitably",6,1,0,0,7
"3675","infancy",2,3,2,0,7
"3676","infant",2,4,1,0,7
"3677","inferiority",4,2,1,0,7
"3678","infinite",5,2,0,0,7
"3679","inform",3,4,0,0,7
"3680","inhumanity",0,4,3,0,7
"3681","inmy",7,0,0,0,7
"3682","instigator",3,4,0,0,7
"3683","intending",3,4,0,0,7
"3684","interposed",4,2,1,0,7
"3685","intimation",4,2,1,0,7
"3686","intolerable",3,4,0,0,7
"3687","investigation",3,2,2,0,7
"3688","inviting",3,3,0,1,7
"3689","involved",3,3,1,0,7
"3690","irresponsible",2,3,2,0,7
"3691","issued",4,2,1,0,7
"3692","jaws",1,3,3,0,7
"3693","jenkins",2,3,2,0,7
"3694","joined",4,2,1,0,7
"3695","kelley",7,0,0,0,7
"3696","knocked",1,4,2,0,7
"3697","large",0,0,0,7,7
"3698","lasting",4,3,0,0,7
"3699","laughed",3,3,1,0,7
"3700","laying",4,3,0,0,7
"3701","legitimate",2,4,1,0,7
"3702","lifted",3,4,0,0,7
"3703","likelihoods",4,3,0,0,7
"3704","limited",5,2,0,0,7
"3705","list",4,3,0,0,7
"3706","loudly",2,1,3,1,7
"3707","malicious",4,3,0,0,7
"3708","manifested",3,3,1,0,7
"3709","marble",5,0,0,2,7
"3710","martin",5,0,1,1,7
"3711","marvelously",4,3,0,0,7
"3712","meanest",1,2,4,0,7
"3713","merciful",2,3,2,0,7
"3714","model",3,3,1,0,7
"3715","moderate",6,1,0,0,7
"3716","moses",3,1,0,3,7
"3717","mysteries",2,5,0,0,7
"3718","narrated",2,5,0,0,7
"3719","nathaniel",5,2,0,0,7
"3720","neglect",3,2,2,0,7
"3721","new",0,0,0,7,7
"3722","noon",2,1,2,2,7
"3723","nothing",0,0,0,7,7
"3724","nurse",3,4,0,0,7
"3725","o’connell",7,0,0,0,7
"3726","oaths",2,2,3,0,7
"3727","obedient",4,2,1,0,7
"3728","occupy",4,3,0,0,7
"3729","odds",5,1,1,0,7
"3730","ofthis",7,0,0,0,7
"3731","one’s",3,4,0,0,7
"3732","oppose",2,4,0,1,7
"3733","organized",5,1,1,0,7
"3734","overcome",2,2,3,0,7
"3735","overthrow",2,3,2,0,7
"3736","painfully",4,3,0,0,7
"3737","pamphlet",2,5,0,0,7
"3738","partial",3,3,1,0,7
"3739","partof",7,0,0,0,7
"3740","peaceable",5,1,1,0,7
"3741","peculiarly",2,3,2,0,7
"3742","penalty",2,3,2,0,7
"3743","perils",4,2,1,0,7
"3744","personally",5,2,0,0,7
"3745","piled",4,3,0,0,7
"3746","pitt",3,4,0,0,7
"3747","planting",1,5,1,0,7
"3748","poet",4,2,1,0,7
"3749","possessing",2,4,1,0,7
"3750","practically",4,3,0,0,7
"3751","praying",1,5,1,0,7
"3752","predicted",4,1,2,0,7
"3753","preparing",2,2,2,1,7
"3754","prevailed",4,2,1,0,7
"3755","professing",4,1,2,0,7
"3756","protestant",2,3,0,2,7
"3757","proverb",2,4,1,0,7
"3758","publication",4,3,0,0,7
"3759","punishing",3,3,1,0,7
"3760","pursuing",3,2,2,0,7
"3761","quit",5,2,0,0,7
"3762","radical",5,2,0,0,7
"3763","range",3,3,0,1,7
"3764","readers",4,3,0,0,7
"3765","reference",4,2,1,0,7
"3766","reflecting",3,3,1,0,7
"3767","refuge",3,2,2,0,7
"3768","region",3,2,1,1,7
"3769","regrets",3,3,0,1,7
"3770","reminding",2,3,1,1,7
"3771","removing",4,2,1,0,7
"3772","repeatedly",5,2,0,0,7
"3773","repentance",2,5,0,0,7
"3774","residing",4,2,1,0,7
"3775","resolute",4,3,0,0,7
"3776","resolve",3,4,0,0,7
"3777","restraint",2,5,0,0,7
"3778","resulting",2,4,1,0,7
"3779","revenge",4,3,0,0,7
"3780","reverse",2,3,1,1,7
"3781","revived",4,1,2,0,7
"3782","richly",2,2,1,2,7
"3783","risen",4,2,0,1,7
"3784","rivalry",3,4,0,0,7
"3785","rolled",3,3,0,1,7
"3786","room",0,0,0,7,7
"3787","rudely",4,3,0,0,7
"3788","ruined",2,4,1,0,7
"3789","ruins",0,0,0,7,7
"3790","rulers",5,1,1,0,7
"3791","runs",2,3,1,1,7
"3792","saints",1,2,2,2,7
"3793","salary",5,1,0,1,7
"3794","sally",4,2,1,0,7
"3795","saxon",2,5,0,0,7
"3796","scarred",3,3,1,0,7
"3797","scream",2,3,2,0,7
"3798","scriptures",2,5,0,0,7
"3799","sealed",4,3,0,0,7
"3800","searching",2,4,0,1,7
"3801","securing",2,4,1,0,7
"3802","seem",0,0,0,7,7
"3803","selling",3,3,0,1,7
"3804","semi",2,5,0,0,7
"3805","servility",4,2,1,0,7
"3806","settlement",5,2,0,0,7
"3807","shirts",1,3,3,0,7
"3808","show",0,0,0,7,7
"3809","sights",2,4,0,1,7
"3810","simplicity",2,3,2,0,7
"3811","slave_",0,7,0,0,7
"3812","slender",3,4,0,0,7
"3813","small",0,0,0,7,7
"3814","smoke",0,0,1,6,7
"3815","snake",3,3,1,0,7
"3816","sole",4,2,1,0,7
"3817","song",3,3,1,0,7
"3818","stables",4,3,0,0,7
"3819","stake",2,4,1,0,7
"3820","starvation",3,3,1,0,7
"3821","stearns",7,0,0,0,7
"3822","steel",3,4,0,0,7
"3823","stones",3,1,2,1,7
"3824","stunned",3,3,1,0,7
"3825","subjects",3,3,0,1,7
"3826","subsided",3,3,1,0,7
"3827","succor",2,4,1,0,7
"3828","suggest",1,3,2,1,7
"3829","sunbeams",2,3,1,1,7
"3830","sung",2,4,1,0,7
"3831","sunk",3,3,1,0,7
"3832","supposing",3,3,0,1,7
"3833","suppressed",4,2,1,0,7
"3834","surpassed",3,2,1,1,7
"3835","surrounding",4,2,0,1,7
"3836","swamp",2,3,2,0,7
"3837","syracuse",7,0,0,0,7
"3838","tents",3,4,0,0,7
"3839","testimonial",3,3,1,0,7
"3840","thathe",7,0,0,0,7
"3841","therewas",7,0,0,0,7
"3842","therewere",7,0,0,0,7
"3843","thirteen",3,4,0,0,7
"3844","thiswas",7,0,0,0,7
"3845","thought",0,0,0,7,7
"3846","throng",3,2,1,1,7
"3847","thumb",1,5,1,0,7
"3848","thunder",3,3,1,0,7
"3849","tidings",2,3,1,1,7
"3850","tilled",1,2,2,2,7
"3851","todo",7,0,0,0,7
"3852","tolerably",5,2,0,0,7
"3853","tomy",7,0,0,0,7
"3854","top",2,1,0,4,7
"3855","tore",3,3,1,0,7
"3856","tormentors",1,5,1,0,7
"3857","tracy",7,0,0,0,7
"3858","treasured",3,4,0,0,7
"3859","treasures",2,2,1,2,7
"3860","tricks",3,4,0,0,7
"3861","triumphant",5,2,0,0,7
"3862","tumult",6,1,0,0,7
"3863","tyranny",1,6,0,0,7
"3864","unconscious",4,2,1,0,7
"3865","uncultivated",3,3,1,0,7
"3866","undersigned",5,1,1,0,7
"3867","underthe",7,0,0,0,7
"3868","unfortunate",5,1,1,0,7
"3869","unhappily",4,3,0,0,7
"3870","universe",3,2,1,1,7
"3871","university",7,0,0,0,7
"3872","unloading",2,3,2,0,7
"3873","unnecessary",4,2,1,0,7
"3874","unusually",3,4,0,0,7
"3875","unutterable",1,2,4,0,7
"3876","vanity",3,4,0,0,7
"3877","venice",0,0,0,7,7
"3878","viewing",1,3,1,2,7
"3879","vividly",3,3,1,0,7
"3880","waiters",5,2,0,0,7
"3881","warmly",4,2,1,0,7
"3882","wasted",3,3,1,0,7
"3883","wayland",2,0,0,5,7
"3884","wheni",7,0,0,0,7
"3885","whig",4,3,0,0,7
"3886","whirlwind",6,1,0,0,7
"3887","wing",1,3,2,1,7
"3888","wings",3,3,1,0,7
"3889","witha",7,0,0,0,7
"3890","withhold",5,2,0,0,7
"3891","wives",1,5,1,0,7
"3892","youthful",2,4,1,0,7
"3893","_free_",1,5,0,0,6
"3894","_in",1,5,0,0,6
"3895","_life",0,5,1,0,6
"3896","_me_",2,4,0,0,6
"3897","_possible_",1,5,0,0,6
"3898","_white_",2,4,0,0,6
"3899","1846",4,2,0,0,6
"3900","3",2,2,2,0,6
"3901","abhorred",2,3,1,0,6
"3902","abject",4,2,0,0,6
"3903","abolishing",3,2,1,0,6
"3904","accosted",3,3,0,0,6
"3905","accumulating",2,3,1,0,6
"3906","acts",3,3,0,0,6
"3907","adjudged",4,1,1,0,6
"3908","adversity",3,3,0,0,6
"3909","advertisements",1,5,0,0,6
"3910","advocacy",5,1,0,0,6
"3911","advocated",5,1,0,0,6
"3912","affecting",3,2,1,0,6
"3913","ague",2,3,1,0,6
"3914","alarmed",5,1,0,0,6
"3915","allowing",2,3,1,0,6
"3916","altar",1,4,1,0,6
"3917","alternative",3,2,1,0,6
"3918","amusement",1,3,0,2,6
"3919","andhaving",6,0,0,0,6
"3920","andthat",6,0,0,0,6
"3921","anger",3,2,1,0,6
"3922","annapolis",3,1,2,0,6
"3923","annexation",6,0,0,0,6
"3924","appeals",3,2,1,0,6
"3925","appears",3,2,1,0,6
"3926","argued",1,3,2,0,6
"3927","arise",3,3,0,0,6
"3928","arising",3,3,0,0,6
"3929","aristocratic",4,2,0,0,6
"3930","arraigned",3,2,1,0,6
"3931","arrangements",2,3,0,1,6
"3932","asi",6,0,0,0,6
"3933","asleep",2,3,1,0,6
"3934","asserting",3,3,0,0,6
"3935","assets",6,0,0,0,6
"3936","assigns",2,4,0,0,6
"3937","assisting",5,1,0,0,6
"3938","associates",3,3,0,0,6
"3939","association",3,1,1,1,6
"3940","assurances",5,1,0,0,6
"3941","assure",5,1,0,0,6
"3942","atmosphere",4,2,0,0,6
"3943","attempting",3,3,0,0,6
"3944","attraction",1,4,1,0,6
"3945","attributed",2,2,2,0,6
"3946","authorized",3,3,0,0,6
"3947","availed",3,1,2,0,6
"3948","averse",2,4,0,0,6
"3949","awaited",2,4,0,0,6
"3950","awakening",2,4,0,0,6
"3951","away",0,0,0,6,6
"3952","baby",2,2,2,0,6
"3953","barbarism",5,1,0,0,6
"3954","beecher",5,1,0,0,6
"3955","beef",2,2,2,0,6
"3956","beforethe",6,0,0,0,6
"3957","begging",3,0,1,2,6
"3958","betsey",3,2,1,0,6
"3959","birthright",3,3,0,0,6
"3960","blacksmith’s",3,2,1,0,6
"3961","blank",3,3,0,0,6
"3962","blasphemy",1,4,1,0,6
"3963","blaze",2,4,0,0,6
"3964","blowing",1,2,1,2,6
"3965","boasting",2,4,0,0,6
"3966","boot",2,2,2,0,6
"3967","boyish",1,5,0,0,6
"3968","brighter",4,2,0,0,6
"3969","broader",3,3,0,0,6
"3970","bull",2,3,1,0,6
"3971","burdens",2,2,2,0,6
"3972","burnt",2,2,1,1,6
"3973","butter",3,3,0,0,6
"3974","buyers",2,4,0,0,6
"3975","calk",2,2,2,0,6
"3976","calmly",3,2,0,1,6
"3977","campaign",6,0,0,0,6
"3978","capitol",5,1,0,0,6
"3979","carpenter",5,1,0,0,6
"3980","casks",3,2,1,0,6
"3981","cat",1,4,1,0,6
"3982","cathedral",0,0,0,6,6
"3983","cautiously",3,3,0,0,6
"3984","celebrated",1,3,1,1,6
"3985","charleston",6,0,0,0,6
"3986","charming",3,1,0,2,6
"3987","cheering",2,3,1,0,6
"3988","cherish",4,1,1,0,6
"3989","chill",3,2,1,0,6
"3990","chilling",2,4,0,0,6
"3991","cholera",3,3,0,0,6
"3992","clad",3,2,0,1,6
"3993","cleveland",6,0,0,0,6
"3994","clever",1,3,1,1,6
"3995","clifford",1,5,0,0,6
"3996","closet",3,2,1,0,6
"3997","coloredpeople",6,0,0,0,6
"3998","columbian",5,0,1,0,6
"3999","commend",4,1,0,1,6
"4000","concealment",3,3,0,0,6
"4001","condemn",3,3,0,0,6
"4002","confession",3,3,0,0,6
"4003","confiding",4,2,0,0,6
"4004","conform",3,2,1,0,6
"4005","constitute",2,4,0,0,6
"4006","contained",4,1,1,0,6
"4007","contemplating",2,3,0,1,6
"4008","continuance",1,4,1,0,6
"4009","coolness",1,3,2,0,6
"4010","correct",2,3,1,0,6
"4011","correspondence",3,3,0,0,6
"4012","count",3,2,1,0,6
"4013","cradle",3,1,2,0,6
"4014","creditable",3,2,1,0,6
"4015","crippled",4,2,0,0,6
"4016","crossing",2,1,1,2,6
"4017","crow",2,4,0,0,6
"4018","crying",2,1,3,0,6
"4019","culture",0,6,0,0,6
"4020","dank",2,2,2,0,6
"4021","darken",2,1,2,1,6
"4022","darker",2,1,2,1,6
"4023","darkest",1,3,2,0,6
"4024","dawning",3,3,0,0,6
"4025","daybreak",3,3,0,0,6
"4026","daylight",3,2,1,0,6
"4027","december",2,4,0,0,6
"4028","defenders",3,3,0,0,6
"4029","degrees",3,2,1,0,6
"4030","delivery",5,1,0,0,6
"4031","denouncing",3,3,0,0,6
"4032","denying",2,4,0,0,6
"4033","descent",5,0,1,0,6
"4034","desperation",2,3,1,0,6
"4035","devices",4,2,0,0,6
"4036","dictionary",2,3,1,0,6
"4037","differences",4,1,1,0,6
"4038","dignified",5,1,0,0,6
"4039","dimensions",3,2,1,0,6
"4040","dine",3,2,0,1,6
"4041","dining",2,2,0,2,6
"4042","disappeared",5,1,0,0,6
"4043","discipline",1,4,1,0,6
"4044","dismemberment",6,0,0,0,6
"4045","dispel",3,3,0,0,6
"4046","disturbing",3,3,0,0,6
"4047","dose",2,2,2,0,6
"4048","draft",6,0,0,0,6
"4049","dress",2,2,1,1,6
"4050","drivers",3,2,1,0,6
"4051","drunkenness",2,4,0,0,6
"4052","eagle",4,1,0,1,6
"4053","eating",2,4,0,0,6
"4054","eighteen",3,2,0,1,6
"4055","elder",4,1,0,1,6
"4056","elect",6,0,0,0,6
"4057","elected",5,1,0,0,6
"4058","elevate",3,3,0,0,6
"4059","eleven",3,2,1,0,6
"4060","eliza",1,4,1,0,6
"4061","embers",1,3,2,0,6
"4062","embrace",2,2,2,0,6
"4063","eminence",3,3,0,0,6
"4064","emotion",2,2,2,0,6
"4065","empty",5,1,0,0,6
"4066","enactment",0,6,0,0,6
"4067","endless",3,3,0,0,6
"4068","endowments",3,3,0,0,6
"4069","enforce",4,2,0,0,6
"4070","enforcement",2,3,1,0,6
"4071","engagement",3,0,3,0,6
"4072","englishman",3,2,0,1,6
"4073","enlightenment",5,0,1,0,6
"4074","esq",3,1,2,0,6
"4075","even",0,0,0,6,6
"4076","exchanged",4,2,0,0,6
"4077","exciting",5,1,0,0,6
"4078","exerted",3,3,0,0,6
"4079","exhibit",2,3,0,1,6
"4080","expectation",2,3,0,1,6
"4081","experiment",5,0,1,0,6
"4082","expired",4,1,1,0,6
"4083","expressive",4,2,0,0,6
"4084","extending",3,3,0,0,6
"4085","extensive",2,2,1,1,6
"4086","far",0,0,0,6,6
"4087","fat",3,3,0,0,6
"4088","fellowmen",4,1,1,0,6
"4089","fierceness",2,1,3,0,6
"4090","fishermen",2,3,1,0,6
"4091","fitting",4,1,1,0,6
"4092","flee",5,1,0,0,6
"4093","fletcher",0,0,0,6,6
"4094","flew",3,2,1,0,6
"4095","flood",5,1,0,0,6
"4096","flying",1,3,2,0,6
"4097","foes",4,1,1,0,6
"4098","formal",5,1,0,0,6
"4099","fort",5,0,0,1,6
"4100","fourteenth",6,0,0,0,6
"4101","freedom’s",2,3,1,0,6
"4102","fullest",2,4,0,0,6
"4103","fullness",6,0,0,0,6
"4104","fund",3,3,0,0,6
"4105","gale",2,3,1,0,6
"4106","gardens",0,0,1,5,6
"4107","gentlemanly",4,2,0,0,6
"4108","german",5,1,0,0,6
"4109","gift",5,0,1,0,6
"4110","gladness",3,3,0,0,6
"4111","going",0,0,0,6,6
"4112","gorgeous",2,3,0,1,6
"4113","grains",2,4,0,0,6
"4114","gratified",4,1,1,0,6
"4115","gratify",3,2,1,0,6
"4116","grip",3,2,0,1,6
"4117","grossest",0,1,5,0,6
"4118","guard",4,1,1,0,6
"4119","guide",2,3,0,1,6
"4120","hail",2,3,1,0,6
"4121","halls",3,1,0,2,6
"4122","hardy",4,1,1,0,6
"4123","harshly",3,3,0,0,6
"4124","hearers",4,2,0,0,6
"4125","heel",3,2,1,0,6
"4126","herb",3,3,0,0,6
"4127","hideous",1,2,3,0,6
"4128","hiding",3,2,1,0,6
"4129","highways",2,3,1,0,6
"4130","hopeful",4,2,0,0,6
"4131","host",3,3,0,0,6
"4132","hudson",6,0,0,0,6
"4133","humor",3,3,0,0,6
"4134","hurled",4,2,0,0,6
"4135","hushed",2,3,1,0,6
"4136","hypocrites",1,1,4,0,6
"4137","illinois",4,2,0,0,6
"4138","illness",1,3,1,1,6
"4139","illustrious",5,1,0,0,6
"4140","imagination",2,1,3,0,6
"4141","imparted",3,3,0,0,6
"4142","impartial",4,1,1,0,6
"4143","impudent",3,2,1,0,6
"4144","inattention",2,3,1,0,6
"4145","incapable",2,3,1,0,6
"4146","inconsistent",3,2,1,0,6
"4147","industrial",6,0,0,0,6
"4148","inestimable",3,3,0,0,6
"4149","informing",2,2,2,0,6
"4150","initiated",3,3,0,0,6
"4151","injure",2,3,1,0,6
"4152","injured",3,3,0,0,6
"4153","injuring",2,4,0,0,6
"4154","inmates",1,3,1,1,6
"4155","inquire",1,5,0,0,6
"4156","instructed",4,1,1,0,6
"4157","interference",3,3,0,0,6
"4158","introducing",3,3,0,0,6
"4159","irishman",2,3,1,0,6
"4160","isolated",2,4,0,0,6
"4161","issues",2,4,0,0,6
"4162","jim",2,4,0,0,6
"4163","joys",2,4,0,0,6
"4164","keenly",3,3,0,0,6
"4165","keeper",3,2,1,0,6
"4166","kemp",3,3,0,0,6
"4167","kicked",2,3,1,0,6
"4168","kind",0,0,0,6,6
"4169","lamb",3,2,1,0,6
"4170","last",0,0,0,6,6
"4171","latent",3,3,0,0,6
"4172","latitude",4,1,0,1,6
"4173","latter",0,0,0,6,6
"4174","lawyers",5,1,0,0,6
"4175","leads",2,4,0,0,6
"4176","lean",3,2,1,0,6
"4177","leap",2,3,1,0,6
"4178","legislature",2,4,0,0,6
"4179","liabilities",2,2,2,0,6
"4180","liberties",4,2,0,0,6
"4181","library",1,1,1,3,6
"4182","lightly",3,3,0,0,6
"4183","lincoln’s",6,0,0,0,6
"4184","lingered",3,2,1,0,6
"4185","lingering",2,3,1,0,6
"4186","listener",3,1,1,1,6
"4187","livelihood",4,2,0,0,6
"4188","loaned",4,1,0,1,6
"4189","loathing",2,2,2,0,6
"4190","local",3,3,0,0,6
"4191","locality",4,2,0,0,6
"4192","locks",2,3,0,1,6
"4193","loft",2,2,2,0,6
"4194","look",0,0,0,6,6
"4195","lowest",1,3,2,0,6
"4196","mad",5,1,0,0,6
"4197","magic",2,4,0,0,6
"4198","magnificent",2,3,0,1,6
"4199","maintenance",4,2,0,0,6
"4200","majestic",3,2,0,1,6
"4201","mcclellan",6,0,0,0,6
"4202","mechanical",2,2,1,1,6
"4203","merchant",4,1,0,1,6
"4204","meto",6,0,0,0,6
"4205","mexico",3,3,0,0,6
"4206","mild",3,3,0,0,6
"4207","million",4,2,0,0,6
"4208","mills",2,3,0,1,6
"4209","minded",1,2,3,0,6
"4210","minute",2,1,3,0,6
"4211","mischief",3,2,1,0,6
"4212","misfortune",3,3,0,0,6
"4213","misunderstanding",2,2,2,0,6
"4214","mobbed",5,1,0,0,6
"4215","mobs",6,0,0,0,6
"4216","mockery",3,3,0,0,6
"4217","modes",5,1,0,0,6
"4218","mourners",3,3,0,0,6
"4219","mud",1,4,1,0,6
"4220","mutually",1,3,2,0,6
"4221","mymaster",6,0,0,0,6
"4222","myown",6,0,0,0,6
"4223","nakedness",2,2,2,0,6
"4224","neatly",2,2,1,1,6
"4225","necessities",2,3,1,0,6
"4226","necked",3,3,0,0,6
"4227","net",3,3,0,0,6
"4228","nobly",3,2,0,1,6
"4229","nonsense",4,2,0,0,6
"4230","noted",5,1,0,0,6
"4231","oak",1,3,2,0,6
"4232","obdurate",0,3,3,0,6
"4233","ofa",6,0,0,0,6
"4234","ofall",6,0,0,0,6
"4235","offensive",4,2,0,0,6
"4236","ofwhich",6,0,0,0,6
"4237","onmy",6,0,0,0,6
"4238","opponents",4,2,0,0,6
"4239","orator_",0,6,0,0,6
"4240","outcast",1,1,4,0,6
"4241","pace",2,4,0,0,6
"4242","packed",3,2,0,1,6
"4243","paradise",2,3,1,0,6
"4244","parent",3,2,1,0,6
"4245","parlor",2,4,0,0,6
"4246","particulars",3,3,0,0,6
"4247","passenger",4,2,0,0,6
"4248","patiently",3,3,0,0,6
"4249","pavements",4,2,0,0,6
"4250","peaceably",2,3,1,0,6
"4251","peculiarities",1,5,0,0,6
"4252","pecuniary",5,1,0,0,6
"4253","peel",6,0,0,0,6
"4254","penetrate",2,4,0,0,6
"4255","pennington",2,2,2,0,6
"4256","perished",3,2,1,0,6
"4257","perpetual",4,1,1,0,6
"4258","perseverance",2,2,2,0,6
"4259","persevering",2,2,2,0,6
"4260","picked",3,2,1,0,6
"4261","pitch",2,3,1,0,6
"4262","piteous",2,4,0,0,6
"4263","pitied",3,3,0,0,6
"4264","planning",1,2,2,1,6
"4265","plantations",1,4,1,0,6
"4266","plea",2,3,1,0,6
"4267","popes",0,0,0,6,6
"4268","possibilities",4,1,0,1,6
"4269","precaution",2,3,1,0,6
"4270","preferences",3,3,0,0,6
"4271","premises",3,2,1,0,6
"4272","presume",2,3,1,0,6
"4273","presumption",4,2,0,0,6
"4274","pretended",2,3,1,0,6
"4275","process",2,4,0,0,6
"4276","proclaimed",4,2,0,0,6
"4277","professed",3,2,1,0,6
"4278","proportion",2,1,2,1,6
"4279","protections",1,2,3,0,6
"4280","provide",3,3,0,0,6
"4281","publish",4,1,1,0,6
"4282","pupils",4,2,0,0,6
"4283","quaker",5,1,0,0,6
"4284","qualification",5,1,0,0,6
"4285","quantity",2,3,1,0,6
"4286","queen",2,2,0,2,6
"4287","quote",2,3,1,0,6
"4288","rational",3,2,0,1,6
"4289","realized",5,1,0,0,6
"4290","rear",4,1,0,1,6
"4291","reared",2,4,0,0,6
"4292","reciprocal",3,3,0,0,6
"4293","recognizing",5,1,0,0,6
"4294","recollection",3,2,1,0,6
"4295","recollections",3,2,1,0,6
"4296","recorded",0,4,2,0,6
"4297","reduce",4,1,1,0,6
"4298","refined",3,3,0,0,6
"4299","reform",3,2,1,0,6
"4300","regulations",3,3,0,0,6
"4301","remembering",5,1,0,0,6
"4302","rendering",6,0,0,0,6
"4303","renewed",4,2,0,0,6
"4304","representing",4,2,0,0,6
"4305","requirements",4,2,0,0,6
"4306","requiring",2,3,1,0,6
"4307","requisition",5,1,0,0,6
"4308","rescue",5,1,0,0,6
"4309","resisting",2,4,0,0,6
"4310","respectability",3,3,0,0,6
"4311","response",3,1,2,0,6
"4312","retain",5,1,0,0,6
"4313","revenue",5,1,0,0,6
"4314","revivals",1,1,4,0,6
"4315","richardson",2,2,0,2,6
"4316","rigby",1,3,2,0,6
"4317","robbers",2,3,1,0,6
"4318","robbery",3,2,1,0,6
"4319","rocks",2,1,0,3,6
"4320","rolling",2,2,1,1,6
"4321","row",3,1,0,2,6
"4322","rowena",2,3,1,0,6
"4323","sail",2,1,2,1,6
"4324","sailed",1,1,2,2,6
"4325","sailors",4,2,0,0,6
"4326","saloon",2,3,0,1,6
"4327","say",0,0,0,6,6
"4328","sayings",4,2,0,0,6
"4329","scourge",4,2,0,0,6
"4330","secluded",3,3,0,0,6
"4331","secrets",3,3,0,0,6
"4332","seize",2,2,2,0,6
"4333","separating",3,2,1,0,6
"4334","servile",3,2,1,0,6
"4335","servitude",4,2,0,0,6
"4336","seventeen",1,4,1,0,6
"4337","shapes",2,2,1,1,6
"4338","shattered",2,2,1,1,6
"4339","shining",2,3,1,0,6
"4340","shops",3,3,0,0,6
"4341","shouldbe",6,0,0,0,6
"4342","shouted",5,0,1,0,6
"4343","sided",4,1,1,0,6
"4344","significance",5,1,0,0,6
"4345","silly",3,3,0,0,6
"4346","slaughter",4,2,0,0,6
"4347","slavery_",0,6,0,0,6
"4348","slowly",4,1,0,1,6
"4349","smiled",2,2,2,0,6
"4350","smitten",2,4,0,0,6
"4351","soldier",6,0,0,0,6
"4352","solicited",5,1,0,0,6
"4353","somber",3,3,0,0,6
"4354","sophia",3,2,1,0,6
"4355","soundly",3,3,0,0,6
"4356","sovereignty",6,0,0,0,6
"4357","splended",0,0,0,6,6
"4358","staggering",3,3,0,0,6
"4359","stalwart",5,1,0,0,6
"4360","stations",3,3,0,0,6
"4361","statuary",1,1,0,4,6
"4362","steady",2,3,0,1,6
"4363","steamboat",3,2,1,0,6
"4364","stepped",1,4,1,0,6
"4365","sternness",3,3,0,0,6
"4366","stolen",1,3,2,0,6
"4367","stool",2,2,2,0,6
"4368","stormy",4,2,0,0,6
"4369","strain",3,0,3,0,6
"4370","strengthened",3,3,0,0,6
"4371","stroke",1,1,4,0,6
"4372","subscribers",3,3,0,0,6
"4373","sundown",2,4,0,0,6
"4374","sunlight",2,2,0,2,6
"4375","sunrise",2,2,2,0,6
"4376","supposition",4,1,1,0,6
"4377","suspect",1,4,1,0,6
"4378","swarm",2,2,1,1,6
"4379","sweeping",3,3,0,0,6
"4380","swift",3,2,1,0,6
"4381","swim",2,3,1,0,6
"4382","sympathies",1,4,1,0,6
"4383","sympathizing",2,4,0,0,6
"4384","taken",0,0,0,6,6
"4385","talent",2,3,0,1,6
"4386","talking",2,2,1,1,6
"4387","tame",3,2,1,0,6
"4388","tearing",0,4,2,0,6
"4389","telegraph",5,1,0,0,6
"4390","temporal",2,4,0,0,6
"4391","tempted",2,3,1,0,6
"4392","thatthey",6,0,0,0,6
"4393","thecause",6,0,0,0,6
"4394","thecharacter",6,0,0,0,6
"4395","thecolored",6,0,0,0,6
"4396","theconstitution",6,0,0,0,6
"4397","thee",3,3,0,0,6
"4398","thefirst",6,0,0,0,6
"4399","theother",6,0,0,0,6
"4400","thepeople",6,0,0,0,6
"4401","thesouth",6,0,0,0,6
"4402","theunion",6,0,0,0,6
"4403","they’ll",0,0,6,0,6
"4404","thief",2,1,3,0,6
"4405","thorns",3,2,0,1,6
"4406","threaten",1,2,2,1,6
"4407","threatening",3,1,2,0,6
"4408","thrill",3,1,2,0,6
"4409","thrilled",3,3,0,0,6
"4410","thrilling",4,0,2,0,6
"4411","thy",1,2,3,0,6
"4412","ticket",3,2,0,1,6
"4413","tom’s",5,1,0,0,6
"4414","tomake",6,0,0,0,6
"4415","tomb",2,2,1,1,6
"4416","tome",6,0,0,0,6
"4417","tomorrow",0,1,0,5,6
"4418","totally",2,2,2,0,6
"4419","totell",6,0,0,0,6
"4420","trader",2,2,2,0,6
"4421","traffickers",3,3,0,0,6
"4422","trains",3,3,0,0,6
"4423","tremble",1,4,1,0,6
"4424","triumphed",4,2,0,0,6
"4425","trough",2,2,2,0,6
"4426","trousers",0,0,6,0,6
"4427","trustees",6,0,0,0,6
"4428","tub",3,2,1,0,6
"4429","turner",4,2,0,0,6
"4430","tyrant’s",3,3,0,0,6
"4431","tyrants",2,3,1,0,6
"4432","unbroken",3,2,1,0,6
"4433","uncertainty",3,3,0,0,6
"4434","undertaken",4,2,0,0,6
"4435","unending",2,3,1,0,6
"4436","unexpected",2,2,2,0,6
"4437","unfit",2,3,1,0,6
"4438","uniform",5,1,0,0,6
"4439","uphold",3,3,0,0,6
"4440","utterances",6,0,0,0,6
"4441","uttering",1,2,3,0,6
"4442","vexed",4,2,0,0,6
"4443","vicissitudes",3,3,0,0,6
"4444","vital",3,3,0,0,6
"4445","vivid",1,3,1,1,6
"4446","waked",3,2,1,0,6
"4447","walks",4,2,0,0,6
"4448","walled",1,2,1,2,6
"4449","warn",0,5,1,0,6
"4450","warned",4,1,1,0,6
"4451","wavering",3,3,0,0,6
"4452","wearing",3,2,0,1,6
"4453","webster’s",2,3,1,0,6
"4454","weekly",4,1,1,0,6
"4455","whereof",3,3,0,0,6
"4456","whippings",1,3,2,0,6
"4457","wires",5,1,0,0,6
"4458","withdrew",4,2,0,0,6
"4459","woldfolk",3,3,0,0,6
"4460","wonderfully",3,1,1,1,6
"4461","wondrous",3,2,0,1,6
"4462","work",0,0,0,6,6
"4463","worker",5,0,0,1,6
"4464","year’s",2,2,2,0,6
"4465","yonder",1,3,2,0,6
"4466","zeal",6,0,0,0,6
"4467","_far",1,4,0,0,5
"4468","_frederick",1,1,3,0,5
"4469","_him_",1,4,0,0,5
"4470","_law_",4,1,0,0,5
"4471","_master_",0,5,0,0,5
"4472","_new",2,2,1,0,5
"4473","_what_",1,4,0,0,5
"4474","_would_",3,2,0,0,5
"4475","1855",0,4,1,0,5
"4476","1859",5,0,0,0,5
"4477","1872",5,0,0,0,5
"4478","4",1,2,2,0,5
"4479","5",0,5,0,0,5
"4480","abandoned",4,1,0,0,5
"4481","ablest",4,1,0,0,5
"4482","abolish",4,1,0,0,5
"4483","abolitionism",2,2,1,0,5
"4484","accomplishing",2,2,1,0,5
"4485","accuser",3,2,0,0,5
"4486","achievement",3,1,1,0,5
"4487","acquirements",2,3,0,0,5
"4488","actions",1,1,3,0,5
"4489","actuary",5,0,0,0,5
"4490","administer",3,1,1,0,5
"4491","administered",3,2,0,0,5
"4492","admirably",2,2,1,0,5
"4493","advisedly",2,2,1,0,5
"4494","affirm",2,2,1,0,5
"4495","affords",1,3,0,1,5
"4496","afresh",2,2,1,0,5
"4497","ah",3,1,1,0,5
"4498","ahead",1,1,3,0,5
"4499","aiding",1,2,2,0,5
"4500","airs",1,1,3,0,5
"4501","alittle",5,0,0,0,5
"4502","allotted",2,3,0,0,5
"4503","alphabet",2,2,1,0,5
"4504","already",0,0,0,5,5
"4505","amendments",5,0,0,0,5
"4506","amiable",3,1,0,1,5
"4507","amply",2,3,0,0,5
"4508","amusing",3,2,0,0,5
"4509","andall",5,0,0,0,5
"4510","andby",5,0,0,0,5
"4511","andin",5,0,0,0,5
"4512","andit",5,0,0,0,5
"4513","andthis",5,0,0,0,5
"4514","anglo",2,3,0,0,5
"4515","annihilate",1,3,1,0,5
"4516","anniversary",3,2,0,0,5
"4517","announcing",4,1,0,0,5
"4518","another",0,0,0,5,5
"4519","anthony’s",3,2,0,0,5
"4520","anthonys",4,1,0,0,5
"4521","anticipate",2,3,0,0,5
"4522","appetite",2,3,0,0,5
"4523","apply",3,1,1,0,5
"4524","appreciation",5,0,0,0,5
"4525","aptitude",3,2,0,0,5
"4526","architectural",1,1,0,3,5
"4527","array",2,2,1,0,5
"4528","arresting",2,3,0,0,5
"4529","arriving",1,4,0,0,5
"4530","artful",1,1,3,0,5
"4531","articles",3,2,0,0,5
"4532","artificial",3,2,0,0,5
"4533","assaulted",3,2,0,0,5
"4534","assistant",5,0,0,0,5
"4535","atone",3,2,0,0,5
"4536","attach",2,3,0,0,5
"4537","attain",2,2,1,0,5
"4538","attribute",3,2,0,0,5
"4539","auctioneer’s",0,4,1,0,5
"4540","auspices",3,1,1,0,5
"4541","authors",1,4,0,0,5
"4542","awaiting",2,2,0,1,5
"4543","awhile",1,2,2,0,5
"4544","awkwardness",2,2,1,0,5
"4545","babe",1,3,0,1,5
"4546","balls",3,2,0,0,5
"4547","battered",3,2,0,0,5
"4548","beams",2,3,0,0,5
"4549","beg",3,2,0,0,5
"4550","bell",2,0,2,1,5
"4551","bellows",4,0,0,1,5
"4552","bending",2,2,1,0,5
"4553","benefactor",2,2,1,0,5
"4554","benefactors",4,1,0,0,5
"4555","benignant",2,3,0,0,5
"4556","best",0,0,0,5,5
"4557","binding",3,1,1,0,5
"4558","bird",2,3,0,0,5
"4559","birthday",3,0,2,0,5
"4560","bit",2,2,0,1,5
"4561","blades",2,1,2,0,5
"4562","blessed",2,2,1,0,5
"4563","blindness",2,2,1,0,5
"4564","blotted",1,3,1,0,5
"4565","boarding",2,1,1,1,5
"4566","bonney",0,5,0,0,5
"4567","bosoms",2,2,1,0,5
"4568","bounds",2,3,0,0,5
"4569","bradburn",5,0,0,0,5
"4570","breathe",2,3,0,0,5
"4571","breckenridge",5,0,0,0,5
"4572","briers",2,2,1,0,5
"4573","brown’s",5,0,0,0,5
"4574","brutalizing",1,3,1,0,5
"4575","builder",1,3,1,0,5
"4576","bullet",4,1,0,0,5
"4577","buying",2,2,1,0,5
"4578","calker",1,3,1,0,5
"4579","canal",1,0,0,4,5
"4580","candidate",4,1,0,0,5
"4581","candidates",5,0,0,0,5
"4582","captain’s",4,1,0,0,5
"4583","cares",2,3,0,0,5
"4584","carpet",5,0,0,0,5
"4585","castigation",3,2,0,0,5
"4586","ceaseless",3,1,1,0,5
"4587","censure",1,4,0,0,5
"4588","chairman",4,1,0,0,5
"4589","chalmers",2,3,0,0,5
"4590","characterize",1,4,0,0,5
"4591","characterized",2,2,1,0,5
"4592","charges",2,3,0,0,5
"4593","charm",0,4,0,1,5
"4594","chased",2,2,1,0,5
"4595","chattels",1,4,0,0,5
"4596","check",3,1,1,0,5
"4597","cheer",3,1,1,0,5
"4598","chiefly",4,1,0,0,5
"4599","choose",2,2,1,0,5
"4600","christiana",5,0,0,0,5
"4601","circuit",2,3,0,0,5
"4602","clamor",4,1,0,0,5
"4603","climate",2,1,0,2,5
"4604","clotted",1,1,3,0,5
"4605","collars",2,2,1,0,5
"4606","column",3,1,0,1,5
"4607","combine",2,1,2,0,5
"4608","comer",3,2,0,0,5
"4609","comic",1,4,0,0,5
"4610","commander",5,0,0,0,5
"4611","commencement",2,1,2,0,5
"4612","commerce",2,2,0,1,5
"4613","committing",2,3,0,0,5
"4614","commonest",2,3,0,0,5
"4615","comparison",1,2,1,1,5
"4616","compassion",2,3,0,0,5
"4617","competitors",2,2,1,0,5
"4618","complacency",4,1,0,0,5
"4619","complaining",2,3,0,0,5
"4620","compliance",2,1,2,0,5
"4621","comply",1,2,1,1,5
"4622","comprehended",3,2,0,0,5
"4623","confederate",5,0,0,0,5
"4624","congregation",0,5,0,0,5
"4625","connections",3,1,1,0,5
"4626","conscientious",3,2,0,0,5
"4627","consistent",3,2,0,0,5
"4628","consolation",1,3,1,0,5
"4629","constable",1,1,3,0,5
"4630","consulted",1,2,2,0,5
"4631","contended",2,3,0,0,5
"4632","continually",1,2,2,0,5
"4633","continues",0,3,1,1,5
"4634","contradict",4,1,0,0,5
"4635","contribute",2,3,0,0,5
"4636","controversy",3,2,0,0,5
"4637","convenient",2,3,0,0,5
"4638","conversations",3,2,0,0,5
"4639","convert",2,2,0,1,5
"4640","convey",2,2,1,0,5
"4641","corrupt",0,3,2,0,5
"4642","counted",4,1,0,0,5
"4643","courageous",5,0,0,0,5
"4644","coward",3,2,0,0,5
"4645","cows",2,2,1,0,5
"4646","crawled",2,2,1,0,5
"4647","crisis",5,0,0,0,5
"4648","crowds",2,1,0,2,5
"4649","crush",2,3,0,0,5
"4650","cuff",2,3,0,0,5
"4651","cultivated",1,2,2,0,5
"4652","curb",1,2,1,1,5
"4653","cursing",1,3,1,0,5
"4654","cutter",5,0,0,0,5
"4655","damned",1,1,3,0,5
"4656","darted",2,3,0,0,5
"4657","dash",1,2,2,0,5
"4658","dearest",1,2,2,0,5
"4659","decay",1,2,0,2,5
"4660","decency",1,3,1,0,5
"4661","declarations",0,3,2,0,5
"4662","decline",2,1,0,2,5
"4663","defective",5,0,0,0,5
"4664","defiant",3,2,0,0,5
"4665","deficient",4,1,0,0,5
"4666","deliberate",3,2,0,0,5
"4667","demanding",3,2,0,0,5
"4668","dense",1,2,2,0,5
"4669","departing",2,3,0,0,5
"4670","depravity",2,1,2,0,5
"4671","depressed",2,2,1,0,5
"4672","descend",1,3,1,0,5
"4673","desolation",2,3,0,0,5
"4674","destructive",1,3,1,0,5
"4675","develop",2,3,0,0,5
"4676","devotions",2,2,1,0,5
"4677","dies",0,3,2,0,5
"4678","differing",1,3,0,1,5
"4679","diligently",1,2,2,0,5
"4680","dined",1,1,1,2,5
"4681","disastrously",3,2,0,0,5
"4682","disconsolate",3,2,0,0,5
"4683","discontented",2,2,1,0,5
"4684","discussed",4,1,0,0,5
"4685","displeasure",2,3,0,0,5
"4686","dissatisfied",2,2,1,0,5
"4687","distressed",2,2,1,0,5
"4688","divest",3,1,1,0,5
"4689","dividing",2,3,0,0,5
"4690","dome",3,1,0,1,5
"4691","domicile",2,3,0,0,5
"4692","donkeys",0,0,0,5,5
"4693","doom",2,2,1,0,5
"4694","dorsey",5,0,0,0,5
"4695","dublin",2,2,1,0,5
"4696","dug",3,2,0,0,5
"4697","duration",3,1,1,0,5
"4698","duringthe",5,0,0,0,5
"4699","dwell",1,4,0,0,5
"4700","easiest",3,2,0,0,5
"4701","editorial",2,3,0,0,5
"4702","efficiency",5,0,0,0,5
"4703","elastic",1,4,0,0,5
"4704","elasticity",2,2,1,0,5
"4705","electric",3,2,0,0,5
"4706","emphasis",3,2,0,0,5
"4707","endeavors",2,1,1,1,5
"4708","englishmen",2,3,0,0,5
"4709","enlist",4,1,0,0,5
"4710","enlistments",5,0,0,0,5
"4711","enormity",2,3,0,0,5
"4712","enormous",0,2,2,1,5
"4713","enraged",1,1,3,0,5
"4714","enterprising",4,1,0,0,5
"4715","equals",1,2,1,1,5
"4716","erect",2,2,1,0,5
"4717","errors",2,3,0,0,5
"4718","evenings",1,2,2,0,5
"4719","ever",0,0,0,5,5
"4720","excellence",0,4,1,0,5
"4721","excite",3,2,0,0,5
"4722","exclaiming",2,3,0,0,5
"4723","exclamation",2,3,0,0,5
"4724","exclusion",5,0,0,0,5
"4725","exertion",1,4,0,0,5
"4726","exhort",2,3,0,0,5
"4727","expecting",2,1,1,1,5
"4728","expedient",2,2,1,0,5
"4729","expended",4,1,0,0,5
"4730","expenditure",1,4,0,0,5
"4731","exposition",2,3,0,0,5
"4732","extracts",1,4,0,0,5
"4733","extremely",3,2,0,0,5
"4734","famine",3,2,0,0,5
"4735","fangs",2,2,1,0,5
"4736","fanning",1,2,2,0,5
"4737","father’s",1,1,3,0,5
"4738","february",4,0,0,1,5
"4739","feels",1,4,0,0,5
"4740","fellowship",2,1,1,1,5
"4741","fervent",2,3,0,0,5
"4742","fidelity",5,0,0,0,5
"4743","fifteenth",5,0,0,0,5
"4744","find",0,0,0,5,5
"4745","flattering",3,2,0,0,5
"4746","flocked",2,2,1,0,5
"4747","flower",3,2,0,0,5
"4748","foam",2,2,0,1,5
"4749","foolish",1,4,0,0,5
"4750","forbes",5,0,0,0,5
"4751","forbid",2,3,0,0,5
"4752","forbidden",3,2,0,0,5
"4753","forme",5,0,0,0,5
"4754","founded",2,2,0,1,5
"4755","fowl",2,2,0,1,5
"4756","fox",3,2,0,0,5
"4757","frank",3,1,1,0,5
"4758","fraternity",1,4,0,0,5
"4759","freedom_",2,2,1,0,5
"4760","frown",3,2,0,0,5
"4761","furniture",4,1,0,0,5
"4762","gag",1,4,0,0,5
"4763","gallows",4,1,0,0,5
"4764","gardener",2,1,2,0,5
"4765","gardner",0,0,5,0,5
"4766","gashes",2,2,1,0,5
"4767","gave",0,0,0,5,5
"4768","gay",5,0,0,0,5
"4769","genteel",3,2,0,0,5
"4770","gesture",2,1,1,1,5
"4771","gigantic",3,2,0,0,5
"4772","goaded",2,2,1,0,5
"4773","grandly",3,0,0,2,5
"4774","grandmammy",0,5,0,0,5
"4775","grieved",3,2,0,0,5
"4776","groundless",3,2,0,0,5
"4777","guarded",2,3,0,0,5
"4778","guest",3,1,0,1,5
"4779","guinea",1,4,0,0,5
"4780","gum",2,2,1,0,5
"4781","gun",2,2,1,0,5
"4782","handy",1,2,2,0,5
"4783","happen",1,4,0,0,5
"4784","harassed",2,2,1,0,5
"4785","hardening",1,4,0,0,5
"4786","hardship",2,2,1,0,5
"4787","harry",1,4,0,0,5
"4788","hastened",4,1,0,0,5
"4789","haunted",1,4,0,0,5
"4790","hazard",0,3,2,0,5
"4791","heartless",1,4,0,0,5
"4792","helplessness",1,3,1,0,5
"4793","henceforth",3,1,1,0,5
"4794","henrietta",0,3,2,0,5
"4795","highway",2,2,0,1,5
"4796","honors",5,0,0,0,5
"4797","horace",5,0,0,0,5
"4798","horizon",2,2,0,1,5
"4799","horned",2,2,0,1,5
"4800","horns",2,2,1,0,5
"4801","horribly",1,1,3,0,5
"4802","howard",5,0,0,0,5
"4803","humbled",2,3,0,0,5
"4804","humbly",2,2,1,0,5
"4805","hung",2,3,0,0,5
"4806","husbands",2,2,1,0,5
"4807","hutchinson",3,2,0,0,5
"4808","ican",5,0,0,0,5
"4809","icy",2,2,1,0,5
"4810","ifound",5,0,0,0,5
"4811","ii",1,2,2,0,5
"4812","iii",1,2,2,0,5
"4813","illustrations",1,3,1,0,5
"4814","immeasurable",3,2,0,0,5
"4815","immortal",2,3,0,0,5
"4816","imprisoned",3,2,0,0,5
"4817","imprisonment",3,2,0,0,5
"4818","inaugurated",4,1,0,0,5
"4819","incidental",2,2,1,0,5
"4820","including",4,1,0,0,5
"4821","incomparably",3,1,1,0,5
"4822","inconsistencies",1,2,2,0,5
"4823","incredible",2,3,0,0,5
"4824","incur",0,3,2,0,5
"4825","indies",5,0,0,0,5
"4826","individually",1,4,0,0,5
"4827","individuals",5,0,0,0,5
"4828","ineffable",3,1,1,0,5
"4829","influential",5,0,0,0,5
"4830","inherited",3,2,0,0,5
"4831","injunction",3,2,0,0,5
"4832","innocently",1,4,0,0,5
"4833","inquiries",0,3,2,0,5
"4834","inrochester",5,0,0,0,5
"4835","inseparable",3,2,0,0,5
"4836","instructive",3,2,0,0,5
"4837","instruments",1,4,0,0,5
"4838","insulted",3,2,0,0,5
"4839","insure",3,2,0,0,5
"4840","intemperance",2,3,0,0,5
"4841","intentions",4,1,0,0,5
"4842","intermediate",3,2,0,0,5
"4843","interposition",1,3,1,0,5
"4844","interruptions",3,1,1,0,5
"4845","introduce",3,2,0,0,5
"4846","invariably",1,3,1,0,5
"4847","invincible",1,3,1,0,5
"4848","invoke",1,4,0,0,5
"4849","inwhich",5,0,0,0,5
"4850","irishmen",1,3,1,0,5
"4851","irreligious",2,2,1,0,5
"4852","jackets",2,2,1,0,5
"4853","jacob",0,2,3,0,5
"4854","jefferson",3,1,0,1,5
"4855","joist",1,2,2,0,5
"4856","jones",4,1,0,0,5
"4857","joyful",2,2,1,0,5
"4858","judicial",2,1,2,0,5
"4859","jumped",2,2,1,0,5
"4860","june",3,0,0,2,5
"4861","just",0,0,0,5,5
"4862","justification",2,2,1,0,5
"4863","key",3,2,0,0,5
"4864","knee",1,3,0,1,5
"4865","kneeling",1,2,0,2,5
"4866","know",0,0,0,5,5
"4867","lacerated",1,2,2,0,5
"4868","ladder",1,3,1,0,5
"4869","lands",1,2,1,1,5
"4870","launched",2,1,1,1,5
"4871","lawless",4,1,0,0,5
"4872","laziness",2,3,0,0,5
"4873","leaf",2,2,1,0,5
"4874","leather",4,1,0,0,5
"4875","lectured",2,2,0,1,5
"4876","lectures",4,1,0,0,5
"4877","leg",2,3,0,0,5
"4878","legged",2,2,1,0,5
"4879","liberate",4,1,0,0,5
"4880","liberated",4,1,0,0,5
"4881","liberation",5,0,0,0,5
"4882","lifting",4,1,0,0,5
"4883","lion",2,0,3,0,5
"4884","lively",1,3,1,0,5
"4885","loading",3,1,1,0,5
"4886","loaf",2,3,0,0,5
"4887","locked",4,1,0,0,5
"4888","lofty",3,0,1,1,5
"4889","lucretia’s",2,3,0,0,5
"4890","luxuries",1,2,1,1,5
"4891","machine",1,4,0,0,5
"4892","majesty",2,3,0,0,5
"4893","make",0,0,0,5,5
"4894","male",3,1,1,0,5
"4895","mammy",3,2,0,0,5
"4896","managers",4,0,1,0,5
"4897","managing",3,1,1,0,5
"4898","markets",1,3,0,1,5
"4899","marshals",5,0,0,0,5
"4900","matched",1,3,1,0,5
"4901","me_",2,2,1,0,5
"4902","measuring",3,2,0,0,5
"4903","medicine",3,2,0,0,5
"4904","melted",2,1,2,0,5
"4905","mercifully",2,3,0,0,5
"4906","merits",4,1,0,0,5
"4907","mighthave",5,0,0,0,5
"4908","ministry",4,1,0,0,5
"4909","missionaries",0,2,2,1,5
"4910","mistresses",1,4,0,0,5
"4911","mitchell",3,2,0,0,5
"4912","monopoly",4,1,0,0,5
"4913","mortal",3,2,0,0,5
"4914","mott",5,0,0,0,5
"4915","mount",2,2,1,0,5
"4916","mourn",2,2,1,0,5
"4917","mourning",2,2,1,0,5
"4918","murders",2,2,1,0,5
"4919","musket",2,1,2,0,5
"4920","mygrandmother",5,0,0,0,5
"4921","myold",5,0,0,0,5
"4922","nat",3,2,0,0,5
"4923","natured",3,0,0,2,5
"4924","navy",5,0,0,0,5
"4925","nearest",1,2,2,0,5
"4926","necessaries",2,2,1,0,5
"4927","nerves",2,3,0,0,5
"4928","nets",1,4,0,0,5
"4929","never",0,0,0,5,5
"4930","newyork",5,0,0,0,5
"4931","nile",0,0,0,5,5
"4932","nominal",4,1,0,0,5
"4933","nothave",5,0,0,0,5
"4934","november",4,1,0,0,5
"4935","obstacle",3,2,0,0,5
"4936","occupying",2,2,1,0,5
"4937","ofbeing",5,0,0,0,5
"4938","offences",3,0,2,0,5
"4939","offers",3,1,0,1,5
"4940","omit",3,2,0,0,5
"4941","omitted",3,1,1,0,5
"4942","operations",3,1,1,0,5
"4943","opposing",3,2,0,0,5
"4944","oration",1,4,0,0,5
"4945","oratory",4,1,0,0,5
"4946","ostler",2,3,0,0,5
"4947","other’s",2,3,0,0,5
"4948","overwhelmed",2,2,1,0,5
"4949","paced",3,2,0,0,5
"4950","pale",3,2,0,0,5
"4951","paris",1,1,0,3,5
"4952","parliament",4,1,0,0,5
"4953","participate",3,1,1,0,5
"4954","participation",2,2,1,0,5
"4955","passionate",2,2,1,0,5
"4956","patrick",1,2,2,0,5
"4957","pattern",2,3,0,0,5
"4958","pause",2,3,0,0,5
"4959","pelted",5,0,0,0,5
"4960","peopleof",5,0,0,0,5
"4961","peoria",5,0,0,0,5
"4962","perfection",2,1,0,2,5
"4963","perplexed",1,2,2,0,5
"4964","persistent",4,1,0,0,5
"4965","personality",3,2,0,0,5
"4966","petition",2,3,0,0,5
"4967","pharisees",0,0,5,0,5
"4968","phrase",3,2,0,0,5
"4969","pig",2,2,1,0,5
"4970","pirate",1,2,2,0,5
"4971","planned",2,2,1,0,5
"4972","playmates",2,3,0,0,5
"4973","pleasures",2,3,0,0,5
"4974","plot",3,2,0,0,5
"4975","poets",0,5,0,0,5
"4976","postponed",3,2,0,0,5
"4977","preached",1,4,0,0,5
"4978","precincts",2,3,0,0,5
"4979","preëminently",5,0,0,0,5
"4980","preface",0,3,2,0,5
"4981","preferring",1,4,0,0,5
"4982","preparation",3,2,0,0,5
"4983","preparations",3,2,0,0,5
"4984","preparatory",3,2,0,0,5
"4985","presumed",4,1,0,0,5
"4986","prevented",0,3,2,0,5
"4987","preventing",2,3,0,0,5
"4988","primary",2,3,0,0,5
"4989","prince",2,2,0,1,5
"4990","prior",2,0,3,0,5
"4991","products",1,1,2,1,5
"4992","professor",2,2,1,0,5
"4993","profound",3,2,0,0,5
"4994","pronounced",4,1,0,0,5
"4995","propensities",2,3,0,0,5
"4996","proscribed",2,3,0,0,5
"4997","protracted",4,1,0,0,5
"4998","puffing",2,2,1,0,5
"4999","pull",1,1,2,1,5
"5000","purely",3,2,0,0,5
"5001","purity",1,3,1,0,5
"5002","purposely",3,2,0,0,5
"5003","purse",1,3,1,0,5
"5004","pursuers",2,2,1,0,5
"5005","quarrel",0,3,2,0,5
"5006","quicken",1,3,1,0,5
"5007","quickened",1,3,1,0,5
"5008","quite",0,0,0,5,5
"5009","rally",3,2,0,0,5
"5010","ranked",1,1,3,0,5
"5011","reap",3,2,0,0,5
"5012","recall",3,1,0,1,5
"5013","reconstruction",5,0,0,0,5
"5014","recruiting",4,0,1,0,5
"5015","refer",3,2,0,0,5
"5016","relates",0,2,3,0,5
"5017","released",2,2,1,0,5
"5018","relies",0,5,0,0,5
"5019","remorseless",1,4,0,0,5
"5020","rend",3,2,0,0,5
"5021","repelled",3,1,1,0,5
"5022","reported",3,1,1,0,5
"5023","resemble",3,2,0,0,5
"5024","respectful",4,1,0,0,5
"5025","resulted",2,2,1,0,5
"5026","retaliation",4,0,1,0,5
"5027","reunion",2,3,0,0,5
"5028","reveals",1,4,0,0,5
"5029","revolutionary",1,2,2,0,5
"5030","rightful",2,3,0,0,5
"5031","rigor",2,3,0,0,5
"5032","roar",2,1,2,0,5
"5033","roasting",2,3,0,0,5
"5034","rocked",3,1,1,0,5
"5035","roman",0,0,0,5,5
"5036","ruling",3,2,0,0,5
"5037","ruthless",2,1,2,0,5
"5038","sacrament",0,5,0,0,5
"5039","sacrifice",4,0,1,0,5
"5040","sagacity",2,2,1,0,5
"5041","sailing",2,2,1,0,5
"5042","samaritan",3,2,0,0,5
"5043","sanction",0,3,2,0,5
"5044","sand",0,1,0,4,5
"5045","scantily",1,4,0,0,5
"5046","scars",2,3,0,0,5
"5047","schooling",2,3,0,0,5
"5048","science",2,1,0,2,5
"5049","score",2,3,0,0,5
"5050","scribes",0,0,5,0,5
"5051","seal",2,2,1,0,5
"5052","seasons",2,2,1,0,5
"5053","secession",5,0,0,0,5
"5054","securely",3,2,0,0,5
"5055","seeing",0,0,0,5,5
"5056","seemingly",2,2,1,0,5
"5057","selection",3,1,1,0,5
"5058","senatorial",3,2,0,0,5
"5059","sentence",1,2,1,1,5
"5060","separately",1,1,3,0,5
"5061","setting",0,2,3,0,5
"5062","settle",3,2,0,0,5
"5063","sex",3,1,1,0,5
"5064","shameless",2,3,0,0,5
"5065","shaped",1,2,0,2,5
"5066","sharing",3,2,0,0,5
"5067","sheridan",2,2,1,0,5
"5068","shortest",2,2,1,0,5
"5069","shouts",2,2,1,0,5
"5070","shuddering",3,2,0,0,5
"5071","shutting",1,3,1,0,5
"5072","sickened",1,3,1,0,5
"5073","silenced",3,2,0,0,5
"5074","silently",2,2,0,1,5
"5075","simultaneously",3,2,0,0,5
"5076","sink",2,1,1,1,5
"5077","sinking",2,3,0,0,5
"5078","sinner",1,4,0,0,5
"5079","sitting",2,2,0,1,5
"5080","sketch",2,3,0,0,5
"5081","skirts",2,2,0,1,5
"5082","smart",2,2,1,0,5
"5083","snakish",1,4,0,0,5
"5084","solemnly",2,2,1,0,5
"5085","soliciting",3,2,0,0,5
"5086","someof",5,0,0,0,5
"5087","sore",2,2,1,0,5
"5088","sounded",4,1,0,0,5
"5089","spangled",3,2,0,0,5
"5090","spared",2,3,0,0,5
"5091","spiritless",3,2,0,0,5
"5092","splendor",2,3,0,0,5
"5093","springs",1,4,0,0,5
"5094","spur",3,2,0,0,5
"5095","spy",2,3,0,0,5
"5096","st.michaels",5,0,0,0,5
"5097","standard_",4,1,0,0,5
"5098","stared",3,2,0,0,5
"5099","stationed",3,1,0,1,5
"5100","statute",2,2,1,0,5
"5101","staying",2,1,2,0,5
"5102","still",0,0,0,5,5
"5103","stooping",2,2,1,0,5
"5104","stores",3,1,0,1,5
"5105","stories",2,1,1,1,5
"5106","strained",3,2,0,0,5
"5107","strove",1,1,3,0,5
"5108","structures",0,0,0,5,5
"5109","studied",1,4,0,0,5
"5110","stump",3,1,1,0,5
"5111","stung",2,2,1,0,5
"5112","stunning",2,2,1,0,5
"5113","subjecting",1,3,1,0,5
"5114","subscriber",3,1,1,0,5
"5115","subsequent",3,1,1,0,5
"5116","subsist",2,1,2,0,5
"5117","sunny",3,2,0,0,5
"5118","superiors",2,2,1,0,5
"5119","surface",3,1,0,1,5
"5120","surrender",5,0,0,0,5
"5121","surround",1,3,1,0,5
"5122","surroundings",4,0,0,1,5
"5123","switches",2,1,2,0,5
"5124","sympathized",2,2,1,0,5
"5125","tale",1,3,1,0,5
"5126","talents",1,3,1,0,5
"5127","tempt",2,3,0,0,5
"5128","thatof",5,0,0,0,5
"5129","thegood",5,0,0,0,5
"5130","thegovernment",5,0,0,0,5
"5131","thegreat",5,0,0,0,5
"5132","thehouse",5,0,0,0,5
"5133","theloyal",5,0,0,0,5
"5134","themorning",5,0,0,0,5
"5135","thenight",5,0,0,0,5
"5136","thequestion",5,0,0,0,5
"5137","therefor",2,2,0,1,5
"5138","thesame",5,0,0,0,5
"5139","theslaveholders",5,0,0,0,5
"5140","theycould",5,0,0,0,5
"5141","thieves",3,2,0,0,5
"5142","throne",2,3,0,0,5
"5143","tiger",2,1,2,0,5
"5144","timidity",2,3,0,0,5
"5145","toa",5,0,0,0,5
"5146","tohis",5,0,0,0,5
"5147","tolerated",4,1,0,0,5
"5148","tothis",5,0,0,0,5
"5149","touches",2,3,0,0,5
"5150","traced",1,3,1,0,5
"5151","traces",2,2,1,0,5
"5152","transition",2,3,0,0,5
"5153","tray",1,3,1,0,5
"5154","trifle",3,1,1,0,5
"5155","trimmed",2,3,0,0,5
"5156","trustworthy",3,2,0,0,5
"5157","truthful",1,3,1,0,5
"5158","tumultuous",3,1,0,1,5
"5159","tyrannical",1,4,0,0,5
"5160","ultimate",4,1,0,0,5
"5161","ultimately",5,0,0,0,5
"5162","unceasing",2,3,0,0,5
"5163","uncertain",4,1,0,0,5
"5164","undoubtedly",2,2,1,0,5
"5165","uneasy",2,2,1,0,5
"5166","unlawful",2,2,1,0,5
"5167","unsuccessful",2,3,0,0,5
"5168","untied",2,3,0,0,5
"5169","useless",3,2,0,0,5
"5170","vanquished",3,2,0,0,5
"5171","variety",3,2,0,0,5
"5172","verily",2,2,1,0,5
"5173","vigorously",3,2,0,0,5
"5174","vile",2,3,0,0,5
"5175","villainy",3,2,0,0,5
"5176","volunteer",1,3,1,0,5
"5177","voted",4,1,0,0,5
"5178","voting",3,2,0,0,5
"5179","wake",1,3,1,0,5
"5180","walter",2,2,1,0,5
"5181","wandering",3,2,0,0,5
"5182","wasno",5,0,0,0,5
"5183","wasnow",5,0,0,0,5
"5184","waugh",2,3,0,0,5
"5185","wavered",3,2,0,0,5
"5186","weapons",2,3,0,0,5
"5187","weathers",1,3,1,0,5
"5188","welcomed",3,1,0,1,5
"5189","whaling",2,3,0,0,5
"5190","whatsoever",3,2,0,0,5
"5191","whatwas",5,0,0,0,5
"5192","whereabouts",2,2,1,0,5
"5193","whips",1,2,2,0,5
"5194","whittier",1,3,1,0,5
"5195","whole",0,0,0,5,5
"5196","wholesale",1,1,3,0,5
"5197","wielded",3,1,1,0,5
"5198","winder",1,2,2,0,5
"5199","wishedto",5,0,0,0,5
"5200","withmy",5,0,0,0,5
"5201","withthem",5,0,0,0,5
"5202","wolf",3,2,0,0,5
"5203","worthless",3,2,0,0,5
"5204","wouldbe",5,0,0,0,5
"5205","wrestling",1,2,2,0,5
"5206","yearly",1,2,2,0,5
"5207","yield",3,2,0,0,5
"5208","銔",5,0,0,0,5
"5209","_black_",1,3,0,0,4
"5210","_did_",2,2,0,0,4
"5211","_fact_",2,2,0,0,4
"5212","_form_",2,2,0,0,4
"5213","_friend_",2,2,0,0,4
"5214","_friends",2,1,1,0,4
"5215","_liberty_",3,1,0,0,4
"5216","_men_",2,2,0,0,4
"5217","_not",2,2,0,0,4
"5218","_one_",1,3,0,0,4
"5219","_only_",0,4,0,0,4
"5220","_root_",0,1,3,0,4
"5221","_she_",1,3,0,0,4
"5222","_slave_",1,3,0,0,4
"5223","_thinking_",2,2,0,0,4
"5224","_too",1,3,0,0,4
"5225","_what",1,3,0,0,4
"5226","_why_",2,2,0,0,4
"5227","10",1,3,0,0,4
"5228","1843",2,2,0,0,4
"5229","1847",3,1,0,0,4
"5230","1848",4,0,0,0,4
"5231","1852",1,3,0,0,4
"5232","1854",1,3,0,0,4
"5233","1866",4,0,0,0,4
"5234","2d",3,1,0,0,4
"5235","55th",3,0,1,0,4
"5236","8",1,3,0,0,4
"5237","aaron",4,0,0,0,4
"5238","aback",1,2,1,0,4
"5239","abominable",1,2,1,0,4
"5240","abundantly",2,2,0,0,4
"5241","acceptable",1,2,1,0,4
"5242","accident",1,1,2,0,4
"5243","accounts",2,2,0,0,4
"5244","aches",1,2,1,0,4
"5245","acquaintedwith",4,0,0,0,4
"5246","adhered",3,1,0,0,4
"5247","adjust",3,1,0,0,4
"5248","advancing",3,1,0,0,4
"5249","affectionately",2,2,0,0,4
"5250","afree",4,0,0,0,4
"5251","aims",1,3,0,0,4
"5252","alacrity",3,1,0,0,4
"5253","alexander",3,1,0,0,4
"5254","alliciana",1,2,1,0,4
"5255","allthat",4,0,0,0,4
"5256","aloud",2,2,0,0,4
"5257","altered",2,2,0,0,4
"5258","amalfi",0,0,0,4,4
"5259","amalgamation",2,2,0,0,4
"5260","amazement",1,3,0,0,4
"5261","anchor",2,1,0,1,4
"5262","andhad",4,0,0,0,4
"5263","andone",4,0,0,0,4
"5264","andwas",4,0,0,0,4
"5265","andyet",4,0,0,0,4
"5266","anew",1,1,2,0,4
"5267","annihilated",1,2,1,0,4
"5268","annoyances",3,1,0,0,4
"5269","annually",2,1,1,0,4
"5270","anxieties",2,2,0,0,4
"5271","apostles",3,1,0,0,4
"5272","apparel",1,3,0,0,4
"5273","appointments",3,0,0,1,4
"5274","approve",2,2,0,0,4
"5275","arch",2,1,0,1,4
"5276","arlington",4,0,0,0,4
"5277","arming",4,0,0,0,4
"5278","arrayed",2,2,0,0,4
"5279","artfully",1,2,1,0,4
"5280","arts",4,0,0,0,4
"5281","ascertaining",0,2,1,1,4
"5282","ashore",3,1,0,0,4
"5283","asif",4,0,0,0,4
"5284","asit",4,0,0,0,4
"5285","asmuch",4,0,0,0,4
"5286","aspires",1,3,0,0,4
"5287","ass",2,1,1,0,4
"5288","assassins",3,1,0,0,4
"5289","assemble",2,2,0,0,4
"5290","assertion",3,0,1,0,4
"5291","assing",4,0,0,0,4
"5292","associate",2,2,0,0,4
"5293","asthe",4,0,0,0,4
"5294","astonishing",1,2,1,0,4
"5295","aswell",4,0,0,0,4
"5296","atoned",2,2,0,0,4
"5297","attachments",2,2,0,0,4
"5298","attacked",3,1,0,0,4
"5299","attainable",2,2,0,0,4
"5300","attentively",2,1,1,0,4
"5301","attested",2,2,0,0,4
"5302","auction",2,2,0,0,4
"5303","augustus",1,1,2,0,4
"5304","autumn",2,1,0,1,4
"5305","auxiliaries",2,2,0,0,4
"5306","avarice",2,2,0,0,4
"5307","aversions",2,2,0,0,4
"5308","avery",4,0,0,0,4
"5309","avignon",0,0,0,4,4
"5310","back",0,0,0,4,4
"5311","baked",2,2,0,0,4
"5312","bald",1,2,1,0,4
"5313","ball",2,1,1,0,4
"5314","barns",2,2,0,0,4
"5315","barrel",2,2,0,0,4
"5316","barrels",2,2,0,0,4
"5317","barrier",1,1,2,0,4
"5318","baskets",1,1,1,1,4
"5319","beautifully",1,1,0,2,4
"5320","began",0,0,0,4,4
"5321","belt",2,1,0,1,4
"5322","berth",2,2,0,0,4
"5323","bestow",2,1,1,0,4
"5324","bestowed",2,2,0,0,4
"5325","betook",1,1,0,2,4
"5326","bettering",1,2,1,0,4
"5327","betwixt",1,1,2,0,4
"5328","bigger",1,3,0,0,4
"5329","bills",2,2,0,0,4
"5330","biscuit",1,2,1,0,4
"5331","biscuits",2,1,1,0,4
"5332","blackest",2,2,0,0,4
"5333","blacksmith",3,1,0,0,4
"5334","blacksmiths",1,3,0,0,4
"5335","blight",2,2,0,0,4
"5336","blighting",1,1,2,0,4
"5337","bloodshed",3,1,0,0,4
"5338","boded",2,2,0,0,4
"5339","bodily",2,2,0,0,4
"5340","boiled",1,2,1,0,4
"5341","boldest",2,1,1,0,4
"5342","boldly",1,3,0,0,4
"5343","boldness",1,3,0,0,4
"5344","boon",2,2,0,0,4
"5345","borgo",0,0,0,4,4
"5346","borrowed",2,2,0,0,4
"5347","bounded",3,1,0,0,4
"5348","brain",2,2,0,0,4
"5349","brandy",2,1,1,0,4
"5350","breathing",2,2,0,0,4
"5351","brooded",1,3,0,0,4
"5352","brotherly",2,2,0,0,4
"5353","brows",2,2,0,0,4
"5354","buck",3,1,0,0,4
"5355","burn",0,4,0,0,4
"5356","bury",2,1,1,0,4
"5357","burying",1,3,0,0,4
"5358","bush",1,2,1,0,4
"5359","butto",4,0,0,0,4
"5360","button",2,1,1,0,4
"5361","buzzards",2,2,0,0,4
"5362","bye",2,0,0,2,4
"5363","caldwell",2,1,1,0,4
"5364","calhoun",2,2,0,0,4
"5365","california",3,1,0,0,4
"5366","cameto",3,0,0,1,4
"5367","campbell’s",0,4,0,0,4
"5368","cap",1,1,1,1,4
"5369","captive",1,3,0,0,4
"5370","captors",2,2,0,0,4
"5371","caressing",2,2,0,0,4
"5372","carts",1,1,0,2,4
"5373","catalogue",0,4,0,0,4
"5374","catchers",2,2,0,0,4
"5375","central",2,2,0,0,4
"5376","certainly",0,0,0,4,4
"5377","certify",1,1,2,0,4
"5378","chambers",2,1,1,0,4
"5379","chapel",0,3,0,1,4
"5380","charitable",2,1,1,0,4
"5381","charter",4,0,0,0,4
"5382","chasm",4,0,0,0,4
"5383","chastisement",0,4,0,0,4
"5384","chastisements",1,2,1,0,4
"5385","checked",2,2,0,0,4
"5386","cheered",3,1,0,0,4
"5387","cheerfulness",2,1,0,1,4
"5388","cherishing",2,2,0,0,4
"5389","chilled",3,1,0,0,4
"5390","china",3,1,0,0,4
"5391","chisel",2,1,1,0,4
"5392","chopping",1,2,1,0,4
"5393","claimants",3,1,0,0,4
"5394","claimed",3,0,1,0,4
"5395","clarkson",4,0,0,0,4
"5396","clearness",2,2,0,0,4
"5397","clerk",2,1,1,0,4
"5398","clerks",3,1,0,0,4
"5399","climax",1,1,2,0,4
"5400","club",2,2,0,0,4
"5401","coaches",2,1,1,0,4
"5402","coarseness",1,3,0,0,4
"5403","coarsest",1,3,0,0,4
"5404","code",0,2,2,0,4
"5405","coercion",3,1,0,0,4
"5406","coffin",2,1,1,0,4
"5407","collectively",2,2,0,0,4
"5408","combat",1,3,0,0,4
"5409","combination",1,2,1,0,4
"5410","combining",1,2,1,0,4
"5411","come",0,0,0,4,4
"5412","commented",3,1,0,0,4
"5413","commissioners",4,0,0,0,4
"5414","commonly",2,1,1,0,4
"5415","commons",3,1,0,0,4
"5416","compare",1,2,1,0,4
"5417","complain",2,2,0,0,4
"5418","complied",4,0,0,0,4
"5419","compressed",2,1,1,0,4
"5420","confirmation",3,1,0,0,4
"5421","confused",2,2,0,0,4
"5422","congratulate",3,0,0,1,4
"5423","conquer",3,1,0,0,4
"5424","consciences",1,3,0,0,4
"5425","considerate",2,2,0,0,4
"5426","consigned",2,1,0,1,4
"5427","consisting",2,2,0,0,4
"5428","consoling",1,3,0,0,4
"5429","conspicuous",3,0,1,0,4
"5430","conspiracy",4,0,0,0,4
"5431","consternation",2,2,0,0,4
"5432","consul",1,0,0,3,4
"5433","contributed",2,2,0,0,4
"5434","convent",0,0,0,4,4
"5435","conventional",1,3,0,0,4
"5436","conveyance",2,1,1,0,4
"5437","cooled",2,2,0,0,4
"5438","coolly",2,1,0,1,4
"5439","coopers",1,3,0,0,4
"5440","copied",2,2,0,0,4
"5441","corpse",2,2,0,0,4
"5442","correctness",1,2,1,0,4
"5443","council",4,0,0,0,4
"5444","counterpart",2,2,0,0,4
"5445","counties",2,2,0,0,4
"5446","covers",2,1,1,0,4
"5447","creation",1,1,2,0,4
"5448","creator",0,2,1,1,4
"5449","criminal",2,2,0,0,4
"5450","crowning",2,2,0,0,4
"5451","cruelly",1,2,1,0,4
"5452","crumbs",2,2,0,0,4
"5453","cunard",1,3,0,0,4
"5454","damn",0,0,4,0,4
"5455","dance",0,4,0,0,4
"5456","danced",2,1,1,0,4
"5457","dat",2,2,0,0,4
"5458","dat’s",2,2,0,0,4
"5459","dates",1,2,1,0,4
"5460","dazzling",1,1,0,2,4
"5461","dealers",1,2,1,0,4
"5462","debasing",2,1,1,0,4
"5463","deceive",0,0,4,0,4
"5464","deceiving",0,1,3,0,4
"5465","decks",2,1,1,0,4
"5466","decoration",4,0,0,0,4
"5467","defender",2,1,1,0,4
"5468","defending",3,1,0,0,4
"5469","deference",1,2,1,0,4
"5470","defiance",2,0,2,0,4
"5471","deficiencies",1,3,0,0,4
"5472","deficiency",1,2,1,0,4
"5473","delegation",4,0,0,0,4
"5474","deluded",3,1,0,0,4
"5475","delusion",1,3,0,0,4
"5476","demonstrated",1,2,1,0,4
"5477","denunciations",1,2,1,0,4
"5478","deposited",3,1,0,0,4
"5479","derision",0,4,0,0,4
"5480","descriptions",3,1,0,0,4
"5481","deserted",3,1,0,0,4
"5482","desires",0,3,1,0,4
"5483","detain",4,0,0,0,4
"5484","detained",2,1,1,0,4
"5485","detect",0,2,2,0,4
"5486","detection",1,1,2,0,4
"5487","determine",1,3,0,0,4
"5488","detestable",2,2,0,0,4
"5489","detestation",0,3,1,0,4
"5490","detested",1,3,0,0,4
"5491","device",3,1,0,0,4
"5492","devote",3,1,0,0,4
"5493","devotional",0,2,2,0,4
"5494","devour",1,1,2,0,4
"5495","devout",1,2,0,1,4
"5496","dictate",3,0,1,0,4
"5497","differed",3,1,0,0,4
"5498","digest",1,3,0,0,4
"5499","disappear",3,0,1,0,4
"5500","disciple",1,3,0,0,4
"5501","disclose",1,3,0,0,4
"5502","discretion",2,2,0,0,4
"5503","disgrace",0,2,2,0,4
"5504","disparagement",2,2,0,0,4
"5505","dispensation",3,1,0,0,4
"5506","dispute",3,1,0,0,4
"5507","divines",1,3,0,0,4
"5508","dizziness",1,2,1,0,4
"5509","done",0,0,0,4,4
"5510","doubting",2,2,0,0,4
"5511","dove",1,2,1,0,4
"5512","downfall",3,0,1,0,4
"5513","dreaming",2,1,1,0,4
"5514","drowned",1,1,2,0,4
"5515","drunkard",1,1,2,0,4
"5516","ducks",2,2,0,0,4
"5517","dusty",4,0,0,0,4
"5518","dwellings",1,2,1,0,4
"5519","eaten",2,2,0,0,4
"5520","edmund",1,1,0,2,4
"5521","educate",2,2,0,0,4
"5522","effected",3,0,1,0,4
"5523","either",0,0,0,4,4
"5524","elaborate",2,2,0,0,4
"5525","elbowed",2,2,0,0,4
"5526","elegant",3,1,0,0,4
"5527","elegantly",2,1,0,1,4
"5528","elevating",2,2,0,0,4
"5529","eli",1,1,2,0,4
"5530","eligible",3,1,0,0,4
"5531","elm",0,4,0,0,4
"5532","elmwood",4,0,0,0,4
"5533","eloquently",1,2,0,1,4
"5534","else",0,0,0,4,4
"5535","emaciated",1,2,1,0,4
"5536","emerald",2,2,0,0,4
"5537","emigration",4,0,0,0,4
"5538","emphatically",1,2,1,0,4
"5539","encountering",2,1,1,0,4
"5540","endangered",1,3,0,0,4
"5541","endowed",0,3,1,0,4
"5542","energetic",2,1,1,0,4
"5543","engagements",3,1,0,0,4
"5544","enslavers",0,2,2,0,4
"5545","entangled",1,2,1,0,4
"5546","entreated",1,3,0,0,4
"5547","epithets",2,2,0,0,4
"5548","escapes",2,2,0,0,4
"5549","essence",2,2,0,0,4
"5550","eternity",2,2,0,0,4
"5551","everlasting",1,2,1,0,4
"5552","everything",0,0,0,4,4
"5553","examine",2,2,0,0,4
"5554","exchange",2,1,1,0,4
"5555","exemption",2,2,0,0,4
"5556","exercised",2,2,0,0,4
"5557","exile",2,2,0,0,4
"5558","extinction",4,0,0,0,4
"5559","extinguish",1,3,0,0,4
"5560","extremest",2,2,0,0,4
"5561","fact",0,0,0,4,4
"5562","factory",2,1,1,0,4
"5563","fails",1,3,0,0,4
"5564","fared",3,1,0,0,4
"5565","fashioned",3,1,0,0,4
"5566","faster",0,2,2,0,4
"5567","fastest",1,1,2,0,4
"5568","fearing",2,2,0,0,4
"5569","feast",1,2,1,0,4
"5570","felons",3,1,0,0,4
"5571","ferociously",2,2,0,0,4
"5572","fetter",1,3,0,0,4
"5573","file",3,0,1,0,4
"5574","filth",1,1,1,1,4
"5575","finance",4,0,0,0,4
"5576","fireplace",0,3,1,0,4
"5577","fists",1,2,1,0,4
"5578","flinty",2,1,1,0,4
"5579","float",2,2,0,0,4
"5580","floggings",2,2,0,0,4
"5581","flourishing",2,1,0,1,4
"5582","flow",2,1,1,0,4
"5583","flowing",1,2,0,1,4
"5584","fluent",2,1,1,0,4
"5585","foe",2,1,1,0,4
"5586","folks",1,3,0,0,4
"5587","fondly",3,1,0,0,4
"5588","fora",4,0,0,0,4
"5589","foretaste",2,2,0,0,4
"5590","formidable",3,1,0,0,4
"5591","forthwith",0,0,4,0,4
"5592","fortifications",3,0,0,1,4
"5593","fortnight",2,2,0,0,4
"5594","foundry",4,0,0,0,4
"5595","four",0,0,0,4,4
"5596","fremont",4,0,0,0,4
"5597","friendless",1,3,0,0,4
"5598","fright",2,1,1,0,4
"5599","frolic",2,2,0,0,4
"5600","fromslavery",4,0,0,0,4
"5601","funny",2,1,1,0,4
"5602","furnish",3,1,0,0,4
"5603","garments",1,3,0,0,4
"5604","gathering",1,2,1,0,4
"5605","gaveme",4,0,0,0,4
"5606","general",0,0,0,4,4
"5607","genial",1,3,0,0,4
"5608","gently",2,2,0,0,4
"5609","get",0,0,0,4,4
"5610","ghosts",1,2,1,0,4
"5611","giant’s",2,2,0,0,4
"5612","gigs",2,1,1,0,4
"5613","girl’s",1,2,1,0,4
"5614","given",0,0,0,4,4
"5615","glare",2,1,1,0,4
"5616","glossy",1,2,1,0,4
"5617","goose",2,2,0,0,4
"5618","governors",4,0,0,0,4
"5619","gracious",2,1,0,1,4
"5620","grade",1,2,1,0,4
"5621","graduate",1,3,0,0,4
"5622","grandest",2,2,0,0,4
"5623","gratifying",3,1,0,0,4
"5624","greenish",2,2,0,0,4
"5625","greeted",3,1,0,0,4
"5626","groan",2,2,0,0,4
"5627","guarantees",3,1,0,0,4
"5628","guarding",2,1,1,0,4
"5629","gulf",1,3,0,0,4
"5630","hadthe",4,0,0,0,4
"5631","hailed",3,0,1,0,4
"5632","hale",3,1,0,0,4
"5633","ham",0,1,3,0,4
"5634","handcuffed",1,1,2,0,4
"5635","handicraft",1,3,0,0,4
"5636","handled",3,1,0,0,4
"5637","hanging",2,1,0,1,4
"5638","harmless",3,1,0,0,4
"5639","harriet",1,2,1,0,4
"5640","harrison",1,1,2,0,4
"5641","hasten",3,1,0,0,4
"5642","hayti",4,0,0,0,4
"5643","hazardous",2,1,1,0,4
"5644","hazards",1,1,2,0,4
"5645","he’ll",2,2,0,0,4
"5646","heartfelt",3,1,0,0,4
"5647","hearty",1,1,0,2,4
"5648","heated",2,2,0,0,4
"5649","heavier",2,2,0,0,4
"5650","heaving",1,2,1,0,4
"5651","hecould",4,0,0,0,4
"5652","heedless",2,2,0,0,4
"5653","hen",2,2,0,0,4
"5654","hereditary",1,3,0,0,4
"5655","heretofore",1,2,1,0,4
"5656","herring",1,3,0,0,4
"5657","hewould",4,0,0,0,4
"5658","hid",1,2,1,0,4
"5659","historical",3,0,0,1,4
"5660","hoarse",3,1,0,0,4
"5661","hoes",1,2,1,0,4
"5662","hole",1,2,1,0,4
"5663","holiday",1,2,0,1,4
"5664","holiest",2,2,0,0,4
"5665","hoping",1,1,2,0,4
"5666","hopper",3,0,1,0,4
"5667","hospitably",2,1,1,0,4
"5668","hotels",3,1,0,0,4
"5669","household",2,2,0,0,4
"5670","howe",4,0,0,0,4
"5671","however",0,0,0,4,4
"5672","humphreys",2,2,0,0,4
"5673","hurrying",1,2,0,1,4
"5674","identified",1,3,0,0,4
"5675","idleness",1,3,0,0,4
"5676","ifelt",4,0,0,0,4
"5677","illustrating",1,3,0,0,4
"5678","imperfectly",2,2,0,0,4
"5679","imperious",2,2,0,0,4
"5680","import",1,3,0,0,4
"5681","improvident",1,3,0,0,4
"5682","improving",2,2,0,0,4
"5683","inall",4,0,0,0,4
"5684","inapt",1,3,0,0,4
"5685","inaugural",3,1,0,0,4
"5686","incurred",2,2,0,0,4
"5687","incurring",1,2,1,0,4
"5688","indescribable",1,2,1,0,4
"5689","indication",2,2,0,0,4
"5690","indignity",3,1,0,0,4
"5691","indolence",2,2,0,0,4
"5692","inducement",3,1,0,0,4
"5693","indulged",0,1,3,0,4
"5694","industriously",3,1,0,0,4
"5695","inengland",4,0,0,0,4
"5696","infamy",2,2,0,0,4
"5697","ingersoll",4,0,0,0,4
"5698","inherent",2,2,0,0,4
"5699","inheritance",3,1,0,0,4
"5700","iniquity",1,2,1,0,4
"5701","initials",1,3,0,0,4
"5702","inits",4,0,0,0,4
"5703","ink",1,2,1,0,4
"5704","inquiring",1,3,0,0,4
"5705","inserted",2,2,0,0,4
"5706","insolent",2,2,0,0,4
"5707","insults",1,3,0,0,4
"5708","intend",1,2,1,0,4
"5709","intent",1,1,2,0,4
"5710","interested",0,0,0,4,4
"5711","intimate",1,3,0,0,4
"5712","intothe",4,0,0,0,4
"5713","intruder",2,2,0,0,4
"5714","invention",1,3,0,0,4
"5715","invested",3,1,0,0,4
"5716","inveterate",3,1,0,0,4
"5717","ishall",4,0,0,0,4
"5718","isle",2,2,0,0,4
"5719","israel",2,2,0,0,4
"5720","italy",0,0,0,4,4
"5721","iv",0,2,2,0,4
"5722","ix",0,2,2,0,4
"5723","jack",1,1,2,0,4
"5724","jargon",1,2,1,0,4
"5725","jepson",0,2,2,0,4
"5726","jepson’s",0,2,2,0,4
"5727","jerry",2,2,0,0,4
"5728","johnbrown",4,0,0,0,4
"5729","jubilee",2,2,0,0,4
"5730","judgments",3,1,0,0,4
"5731","kissing",0,0,0,4,4
"5732","knocking",2,1,1,0,4
"5733","lanman",1,2,1,0,4
"5734","lawful",2,2,0,0,4
"5735","lawn",1,3,0,0,4
"5736","lawson’s",1,3,0,0,4
"5737","lazy",1,2,1,0,4
"5738","leaned",2,2,0,0,4
"5739","lee",4,0,0,0,4
"5740","legally",3,1,0,0,4
"5741","legislatures",2,2,0,0,4
"5742","liars",2,2,0,0,4
"5743","liberator",2,0,2,0,4
"5744","license",1,3,0,0,4
"5745","lighted",2,2,0,0,4
"5746","likes",1,2,0,1,4
"5747","limit",2,2,0,0,4
"5748","link",3,1,0,0,4
"5749","linked",2,1,1,0,4
"5750","literal",1,3,0,0,4
"5751","lock",2,1,0,1,4
"5752","lonely",3,1,0,0,4
"5753","longed",3,1,0,0,4
"5754","lookout",3,1,0,0,4
"5755","lovely",2,2,0,0,4
"5756","lovers",1,3,0,0,4
"5757","loyalty",3,1,0,0,4
"5758","lyceums",3,1,0,0,4
"5759","machinery",4,0,0,0,4
"5760","madam",4,0,0,0,4
"5761","magistrate",2,2,0,0,4
"5762","magnify",2,2,0,0,4
"5763","maid",1,3,0,0,4
"5764","maledictions",2,2,0,0,4
"5765","manliness",2,1,1,0,4
"5766","manumitted",2,2,0,0,4
"5767","map",3,1,0,0,4
"5768","marched",2,1,1,0,4
"5769","margin",2,2,0,0,4
"5770","marring",1,3,0,0,4
"5771","massive",2,0,0,2,4
"5772","matthews",1,0,3,0,4
"5773","maul",2,2,0,0,4
"5774","me.the",4,0,0,0,4
"5775","meantime",3,1,0,0,4
"5776","mechanic",4,0,0,0,4
"5777","meditated",1,2,0,1,4
"5778","meditations",2,2,0,0,4
"5779","men’s",1,1,2,0,4
"5780","mended",2,1,0,1,4
"5781","mentally",2,2,0,0,4
"5782","messengers",3,1,0,0,4
"5783","michigan",4,0,0,0,4
"5784","milk",2,2,0,0,4
"5785","milly",1,3,0,0,4
"5786","minor",2,2,0,0,4
"5787","mirth",1,3,0,0,4
"5788","mischievous",2,2,0,0,4
"5789","mobocratic",3,1,0,0,4
"5790","moderately",2,2,0,0,4
"5791","molasses",0,2,2,0,4
"5792","moment’s",1,2,1,0,4
"5793","momentous",2,2,0,0,4
"5794","monarchical",1,3,0,0,4
"5795","monotony",2,2,0,0,4
"5796","mood",2,2,0,0,4
"5797","mounted",3,1,0,0,4
"5798","mourner",1,2,1,0,4
"5799","mournful",1,2,0,1,4
"5800","mr.lincoln",4,0,0,0,4
"5801","mulatto",0,2,2,0,4
"5802","murmurs",2,2,0,0,4
"5803","muscular",1,2,0,1,4
"5804","mustbe",4,0,0,0,4
"5805","mustered",2,1,1,0,4
"5806","nails",2,2,0,0,4
"5807","nameless",2,2,0,0,4
"5808","narrating",1,2,1,0,4
"5809","nerved",1,1,2,0,4
"5810","nicholson",1,2,1,0,4
"5811","nigh",2,1,1,0,4
"5812","noah",2,1,1,0,4
"5813","noises",2,2,0,0,4
"5814","nominally",1,3,0,0,4
"5815","nomination",4,0,0,0,4
"5816","nook",2,2,0,0,4
"5817","not_",2,2,0,0,4
"5818","notonly",4,0,0,0,4
"5819","nudity",1,3,0,0,4
"5820","numbered",3,1,0,0,4
"5821","obeying",2,2,0,0,4
"5822","observing",1,3,0,0,4
"5823","obstacles",1,2,1,0,4
"5824","occupies",1,3,0,0,4
"5825","offend",2,2,0,0,4
"5826","officer",2,1,0,1,4
"5827","official",3,1,0,0,4
"5828","ofit",4,0,0,0,4
"5829","ofnew",4,0,0,0,4
"5830","ofour",4,0,0,0,4
"5831","oftenest",2,2,0,0,4
"5832","olden",4,0,0,0,4
"5833","oldmaster",4,0,0,0,4
"5834","omened",2,2,0,0,4
"5835","oppressors",2,1,1,0,4
"5836","oracular",2,2,0,0,4
"5837","ordinarily",1,2,1,0,4
"5838","organizations",0,4,0,0,4
"5839","organizing",4,0,0,0,4
"5840","originally",2,1,1,0,4
"5841","ormuz",0,0,0,4,4
"5842","overhauled",1,2,1,0,4
"5843","overpowered",2,1,1,0,4
"5844","overpowering",2,2,0,0,4
"5845","overseership",0,1,3,0,4
"5846","overshadowing",1,3,0,0,4
"5847","owed",1,2,1,0,4
"5848","ownership",1,2,1,0,4
"5849","owning",1,2,1,0,4
"5850","paddle",2,1,1,0,4
"5851","painted",2,2,0,0,4
"5852","paintings",0,0,0,4,4
"5853","palpable",1,2,1,0,4
"5854","panic",3,1,0,0,4
"5855","panted",2,2,0,0,4
"5856","parallel",2,2,0,0,4
"5857","parley",3,1,0,0,4
"5858","parried",2,2,0,0,4
"5859","partiality",1,2,1,0,4
"5860","partially",3,1,0,0,4
"5861","passages",2,1,1,0,4
"5862","patting",2,2,0,0,4
"5863","paul",0,0,0,4,4
"5864","peace_",2,2,0,0,4
"5865","peering",1,3,0,0,4
"5866","penetrated",2,2,0,0,4
"5867","pens",2,1,0,1,4
"5868","perpetuation",3,1,0,0,4
"5869","persistently",2,0,0,2,4
"5870","persuade",2,2,0,0,4
"5871","persuasion",3,1,0,0,4
"5872","pertaining",1,2,1,0,4
"5873","peter",1,1,1,1,4
"5874","petitions",2,1,1,0,4
"5875","petty",2,2,0,0,4
"5876","phases",2,2,0,0,4
"5877","philpot",0,2,2,0,4
"5878","pierced",1,2,0,1,4
"5879","piercing",0,3,0,1,4
"5880","pile",2,2,0,0,4
"5881","pillar",1,2,0,1,4
"5882","pillsbury",4,0,0,0,4
"5883","pirates",2,1,1,0,4
"5884","pistol",1,2,1,0,4
"5885","pit",2,1,1,0,4
"5886","plantation_",0,4,0,0,4
"5887","plausible",1,3,0,0,4
"5888","pleading",2,0,2,0,4
"5889","pledge",1,2,1,0,4
"5890","pledged",0,3,1,0,4
"5891","plow",1,2,0,1,4
"5892","plowing",0,2,0,2,4
"5893","politeness",4,0,0,0,4
"5894","pollution",0,2,2,0,4
"5895","porter",4,0,0,0,4
"5896","portico",3,1,0,0,4
"5897","portrait",2,0,2,0,4
"5898","ports",2,2,0,0,4
"5899","pot",2,2,0,0,4
"5900","pound",2,2,0,0,4
"5901","pouring",1,2,1,0,4
"5902","practices",1,3,0,0,4
"5903","preacher’s",4,0,0,0,4
"5904","preliminaries",1,3,0,0,4
"5905","presentation",3,1,0,0,4
"5906","pretext",3,1,0,0,4
"5907","prevail",3,1,0,0,4
"5908","priceless",2,2,0,0,4
"5909","principal",3,0,1,0,4
"5910","priscilla",0,3,1,0,4
"5911","privately",2,2,0,0,4
"5912","privileged",1,2,1,0,4
"5913","probabilities",1,3,0,0,4
"5914","proceedings",2,2,0,0,4
"5915","procuring",3,1,0,0,4
"5916","production",2,0,1,1,4
"5917","prof",3,0,0,1,4
"5918","profane",0,1,3,0,4
"5919","proffered",2,2,0,0,4
"5920","proficiency",2,2,0,0,4
"5921","profligate",1,2,1,0,4
"5922","profoundly",1,1,2,0,4
"5923","project",4,0,0,0,4
"5924","prominence",4,0,0,0,4
"5925","prompted",1,1,2,0,4
"5926","prophecy",2,1,1,0,4
"5927","propose",4,0,0,0,4
"5928","propositions",3,1,0,0,4
"5929","proudly",2,1,0,1,4
"5930","prudent",2,2,0,0,4
"5931","pulled",1,2,1,0,4
"5932","purvis",4,0,0,0,4
"5933","pushed",2,1,0,1,4
"5934","putnam",0,0,0,4,4
"5935","quakers",3,1,0,0,4
"5936","raiment",1,3,0,0,4
"5937","ransom",2,2,0,0,4
"5938","rapture",1,1,2,0,4
"5939","rapturous",0,2,2,0,4
"5940","rascality",2,2,0,0,4
"5941","reaction",4,0,0,0,4
"5942","rearing",1,3,0,0,4
"5943","rebellious",3,0,1,0,4
"5944","recent",0,4,0,0,4
"5945","recommended",3,1,0,0,4
"5946","reconciled",2,2,0,0,4
"5947","record",2,1,1,0,4
"5948","redeem",1,3,0,0,4
"5949","regretting",1,2,1,0,4
"5950","rekindled",2,1,1,0,4
"5951","relative",1,2,1,0,4
"5952","relegion",0,0,0,4,4
"5953","relieve",2,2,0,0,4
"5954","relish",2,1,1,0,4
"5955","rely",1,2,1,0,4
"5956","relying",1,2,1,0,4
"5957","remembrance",2,1,1,0,4
"5958","reminded",1,2,1,0,4
"5959","remotest",3,1,0,0,4
"5960","rending",0,2,2,0,4
"5961","repaired",3,1,0,0,4
"5962","repent",2,2,0,0,4
"5963","republicanism",1,3,0,0,4
"5964","reputed",2,2,0,0,4
"5965","resides",1,3,0,0,4
"5966","respective",4,0,0,0,4
"5967","responded",4,0,0,0,4
"5968","restraints",2,2,0,0,4
"5969","revealing",1,2,1,0,4
"5970","rewarded",2,1,0,1,4
"5971","riches",2,1,1,0,4
"5972","ricketson",3,0,1,0,4
"5973","rides",1,2,0,1,4
"5974","ridicule",1,2,1,0,4
"5975","rife",2,2,0,0,4
"5976","righteousness",2,2,0,0,4
"5977","ringing",2,2,0,0,4
"5978","rival",2,1,0,1,4
"5979","roads",3,1,0,0,4
"5980","rods",1,1,2,0,4
"5981","rum",2,1,1,0,4
"5982","russell",3,1,0,0,4
"5983","sacredness",1,2,1,0,4
"5984","saddest",3,1,0,0,4
"5985","saddled",2,2,0,0,4
"5986","saith",2,1,1,0,4
"5987","salts",2,1,1,0,4
"5988","san",1,0,0,3,4
"5989","sanctuary",1,3,0,0,4
"5990","sanguinary",4,0,0,0,4
"5991","saplings",2,2,0,0,4
"5992","satisfiedwith",4,0,0,0,4
"5993","saving",2,1,1,0,4
"5994","savings",4,0,0,0,4
"5995","saythat",4,0,0,0,4
"5996","scandal",2,2,0,0,4
"5997","scanty",0,2,1,1,4
"5998","scholar",4,0,0,0,4
"5999","scientific",2,1,0,1,4
"6000","scope",1,2,1,0,4
"6001","searched",2,1,1,0,4
"6002","seas",2,1,1,0,4
"6003","secede",4,0,0,0,4
"6004","secretaries",3,1,0,0,4
"6005","seedling",2,2,0,0,4
"6006","seeks",2,2,0,0,4
"6007","seems",0,0,0,4,4
"6008","senseless",3,1,0,0,4
"6009","sensitiveness",1,3,0,0,4
"6010","sentences",3,1,0,0,4
"6011","serpent",2,2,0,0,4
"6012","serviceable",0,3,1,0,4
"6013","severed",1,3,0,0,4
"6014","severest",0,1,3,0,4
"6015","shaken",3,0,0,1,4
"6016","sham",1,3,0,0,4
"6017","shed",4,0,0,0,4
"6018","sheet",3,1,0,0,4
"6019","sherman",4,0,0,0,4
"6020","shewas",4,0,0,0,4
"6021","shine",1,2,1,0,4
"6022","ship’s",2,2,0,0,4
"6023","shipping",1,2,1,0,4
"6024","shocks",2,2,0,0,4
"6025","shoots",2,2,0,0,4
"6026","shortly",2,2,0,0,4
"6027","shout",3,1,0,0,4
"6028","shrieks",1,1,2,0,4
"6029","shrug",2,2,0,0,4
"6030","shun",1,3,0,0,4
"6031","sickly",2,1,1,0,4
"6032","sincere",1,2,1,0,4
"6033","sinews",2,2,0,0,4
"6034","sinful",1,3,0,0,4
"6035","six",0,0,0,4,4
"6036","slash",1,2,1,0,4
"6037","slaverysociety",4,0,0,0,4
"6038","slavewoman",3,1,0,0,4
"6039","slavish",1,3,0,0,4
"6040","slightly",4,0,0,0,4
"6041","smite",2,1,1,0,4
"6042","snakes",1,1,2,0,4
"6043","solitude",1,2,0,1,4
"6044","solved",2,2,0,0,4
"6045","something",0,0,0,4,4
"6046","sores",1,2,1,0,4
"6047","soul’s",1,2,1,0,4
"6048","south_",1,3,0,0,4
"6049","spaces",1,1,1,1,4
"6050","spacious",3,1,0,0,4
"6051","spark",2,1,1,0,4
"6052","spell",0,2,2,0,4
"6053","spike",2,2,0,0,4
"6054","spontaneous",2,2,0,0,4
"6055","spree",2,2,0,0,4
"6056","startled",2,1,0,1,4
"6057","stealer",0,1,3,0,4
"6058","stealers",0,2,2,0,4
"6059","stimulated",3,1,0,0,4
"6060","stings",1,2,1,0,4
"6061","stir",3,1,0,0,4
"6062","stirring",1,2,1,0,4
"6063","stout",2,2,0,0,4
"6064","stray",3,1,0,0,4
"6065","stretched",1,2,1,0,4
"6066","strikes",2,2,0,0,4
"6067","structure",0,1,0,3,4
"6068","stuff",2,1,1,0,4
"6069","subordinate",2,2,0,0,4
"6070","succeededin",4,0,0,0,4
"6071","suggestions",2,2,0,0,4
"6072","suiting",1,2,1,0,4
"6073","summary",2,2,0,0,4
"6074","summons",2,1,1,0,4
"6075","sunder",1,2,1,0,4
"6076","superiority",2,2,0,0,4
"6077","suppressing",3,1,0,0,4
"6078","surely",1,2,1,0,4
"6079","surge",1,2,1,0,4
"6080","surveying",2,2,0,0,4
"6081","suspended",1,1,1,1,4
"6082","suspicions",2,2,0,0,4
"6083","swagger",2,2,0,0,4
"6084","swan",2,2,0,0,4
"6085","sweat",1,1,2,0,4
"6086","swell",1,3,0,0,4
"6087","swept",2,2,0,0,4
"6088","sympathize",1,2,1,0,4
"6089","tainted",2,2,0,0,4
"6090","tales",2,1,1,0,4
"6091","tantalizing",2,2,0,0,4
"6092","tastes",1,3,0,0,4
"6093","tattered",1,3,0,0,4
"6094","taxed",2,1,0,1,4
"6095","tea",4,0,0,0,4
"6096","team",1,1,2,0,4
"6097","tearful",0,2,2,0,4
"6098","temptation",1,2,1,0,4
"6099","terminate",3,1,0,0,4
"6100","tested",1,1,2,0,4
"6101","text",2,2,0,0,4
"6102","theabolition",4,0,0,0,4
"6103","theamerican",4,0,0,0,4
"6104","theanti",4,0,0,0,4
"6105","theater",4,0,0,0,4
"6106","thecircumstances",4,0,0,0,4
"6107","theconflict",4,0,0,0,4
"6108","thedistrict",4,0,0,0,4
"6109","thefollowing",4,0,0,0,4
"6110","thehead",4,0,0,0,4
"6111","theirown",4,0,0,0,4
"6112","thematter",4,0,0,0,4
"6113","themore",4,0,0,0,4
"6114","thenegro",4,0,0,0,4
"6115","theold",4,0,0,0,4
"6116","theplace",4,0,0,0,4
"6117","thereis",4,0,0,0,4
"6118","thereunto",2,2,0,0,4
"6119","theway",4,0,0,0,4
"6120","thewhite",4,0,0,0,4
"6121","thewhole",4,0,0,0,4
"6122","thewoods",4,0,0,0,4
"6123","thinker",2,2,0,0,4
"6124","thinly",2,2,0,0,4
"6125","thirsty",1,1,2,0,4
"6126","thomas’s",0,2,2,0,4
"6127","thorny",2,2,0,0,4
"6128","thou",1,3,0,0,4
"6129","throwing",1,1,2,0,4
"6130","thus",0,0,0,4,4
"6131","tigers",2,2,0,0,4
"6132","tilt",1,2,1,0,4
"6133","tobaltimore",4,0,0,0,4
"6134","tocarry",4,0,0,0,4
"6135","tocome",4,0,0,0,4
"6136","toldhim",4,0,0,0,4
"6137","toldme",4,0,0,0,4
"6138","toleave",4,0,0,0,4
"6139","tolerable",1,3,0,0,4
"6140","tolerate",3,1,0,0,4
"6141","tongues",1,1,0,2,4
"6142","tony",1,1,2,0,4
"6143","tops",1,2,0,1,4
"6144","tortured",2,1,0,1,4
"6145","tosay",4,0,0,0,4
"6146","tosee",4,0,0,0,4
"6147","totake",4,0,0,0,4
"6148","total",1,1,2,0,4
"6149","towering",1,2,0,1,4
"6150","trace",0,1,2,1,4
"6151","trades",4,0,0,0,4
"6152","traffic",0,4,0,0,4
"6153","tragic",2,2,0,0,4
"6154","trampled",1,3,0,0,4
"6155","transacted",2,2,0,0,4
"6156","transpired",2,2,0,0,4
"6157","travels",2,1,1,0,4
"6158","treacherous",1,2,1,0,4
"6159","treachery",2,2,0,0,4
"6160","treasure",3,1,0,0,4
"6161","treasury",3,1,0,0,4
"6162","trembled",0,2,2,0,4
"6163","trifling",2,2,0,0,4
"6164","truer",2,2,0,0,4
"6165","truly",0,0,0,4,4
"6166","trumpet",3,1,0,0,4
"6167","tumble",1,3,0,0,4
"6168","tutor",2,2,0,0,4
"6169","type",2,2,0,0,4
"6170","unacquainted",1,1,2,0,4
"6171","unarmed",2,1,1,0,4
"6172","unavailing",2,2,0,0,4
"6173","uncles",2,2,0,0,4
"6174","uncomfortable",2,2,0,0,4
"6175","unconcern",2,2,0,0,4
"6176","unconcerned",2,2,0,0,4
"6177","uncounted",3,1,0,0,4
"6178","underwent",1,1,2,0,4
"6179","undisguised",2,2,0,0,4
"6180","unexpectedly",1,2,1,0,4
"6181","unfold",1,2,1,0,4
"6182","unite",2,2,0,0,4
"6183","unmitigated",2,2,0,0,4
"6184","unobserved",2,2,0,0,4
"6185","unprofitable",2,2,0,0,4
"6186","unrelenting",1,2,1,0,4
"6187","untiring",1,1,2,0,4
"6188","unveiling",3,0,0,1,4
"6189","upper",2,2,0,0,4
"6190","uprightness",3,1,0,0,4
"6191","upset",1,1,2,0,4
"6192","vague",1,1,2,0,4
"6193","varied",1,2,0,1,4
"6194","varieties",3,1,0,0,4
"6195","variously",1,3,0,0,4
"6196","venerable",3,0,0,1,4
"6197","ventures",1,2,1,0,4
"6198","vermont",4,0,0,0,4
"6199","vi",0,2,2,0,4
"6200","vicinity",1,2,0,1,4
"6201","vicious",1,2,1,0,4
"6202","viewof",4,0,0,0,4
"6203","vigor",4,0,0,0,4
"6204","vii",0,2,2,0,4
"6205","viii",0,2,2,0,4
"6206","villages",1,2,1,0,4
"6207","vindicate",1,2,1,0,4
"6208","vindictive",1,3,0,0,4
"6209","violation",1,3,0,0,4
"6210","violently",1,3,0,0,4
"6211","visage",2,2,0,0,4
"6212","vocal",2,2,0,0,4
"6213","vulgar",2,2,0,0,4
"6214","wales",1,3,0,0,4
"6215","wanton",3,1,0,0,4
"6216","warmth",3,1,0,0,4
"6217","wasthen",4,0,0,0,4
"6218","wasvery",4,0,0,0,4
"6219","watchman",2,1,1,0,4
"6220","wave",4,0,0,0,4
"6221","waxed",2,2,0,0,4
"6222","week’s",1,1,2,0,4
"6223","wet",2,1,1,0,4
"6224","wheelwrights",1,3,0,0,4
"6225","whichhe",4,0,0,0,4
"6226","whilei",4,0,0,0,4
"6227","whispered",1,2,1,0,4
"6228","whohad",4,0,0,0,4
"6229","whowas",4,0,0,0,4
"6230","widow",3,1,0,0,4
"6231","wield",3,1,0,0,4
"6232","wielding",1,3,0,0,4
"6233","wilderness",3,1,0,0,4
"6234","wine",3,1,0,0,4
"6235","winning",2,1,1,0,4
"6236","withall",4,0,0,0,4
"6237","withblood",4,0,0,0,4
"6238","withdrawn",4,0,0,0,4
"6239","withholding",3,1,0,0,4
"6240","wont",2,2,0,0,4
"6241","works",0,0,0,4,4
"6242","worm",1,3,0,0,4
"6243","wrists",2,2,0,0,4
"6244","xi",0,2,2,0,4
"6245","zealous",3,1,0,0,4
"6246","_at",1,2,0,0,3
"6247","_bowse_",1,1,1,0,3
"6248","_class",0,3,0,0,3
"6249","_color_",0,3,0,0,3
"6250","_defensive_",1,2,0,0,3
"6251","_for",1,2,0,0,3
"6252","_free",2,1,0,0,3
"6253","_goads_",1,2,0,0,3
"6254","_good_",1,2,0,0,3
"6255","_he_",0,3,0,0,3
"6256","_herald_",3,0,0,0,3
"6257","_his",1,2,0,0,3
"6258","_i_",1,2,0,0,3
"6259","_it_",2,1,0,0,3
"6260","_master",1,2,0,0,3
"6261","_may_",0,2,1,0,3
"6262","_one",2,1,0,0,3
"6263","_right_",0,3,0,0,3
"6264","_seem_",1,2,0,0,3
"6265","_slavery",0,2,1,0,3
"6266","_stand",1,2,0,0,3
"6267","_that",2,1,0,0,3
"6268","_they",1,2,0,0,3
"6269","_twenty",1,2,0,0,3
"6270","_very",1,2,0,0,3
"6271","_well_",1,2,0,0,3
"6272","_why",1,2,0,0,3
"6273","_will",2,1,0,0,3
"6274","_you",0,2,1,0,3
"6275","11",0,3,0,0,3
"6276","157",1,2,0,0,3
"6277","1817",1,1,1,0,3
"6278","1842",2,1,0,0,3
"6279","1853",2,1,0,0,3
"6280","1871",3,0,0,0,3
"6281","1881",2,0,1,0,3
"6282","3d",2,1,0,0,3
"6283","6",0,3,0,0,3
"6284","7",1,2,0,0,3
"6285","7th",3,0,0,0,3
"6286","abel",1,2,0,0,3
"6287","abhor",1,1,1,0,3
"6288","abhorrent",1,2,0,0,3
"6289","able",0,0,0,3,3
"6290","aboutthe",3,0,0,0,3
"6291","abrahamlincoln",3,0,0,0,3
"6292","accompaniments",0,3,0,0,3
"6293","accompanying",2,1,0,0,3
"6294","accounted",2,1,0,0,3
"6295","accumulated",2,1,0,0,3
"6296","accuracy",2,1,0,0,3
"6297","accurate",0,1,2,0,3
"6298","accurately",2,1,0,0,3
"6299","accusation",0,2,1,0,3
"6300","accusations",2,1,0,0,3
"6301","ached",3,0,0,0,3
"6302","acquire",2,1,0,0,3
"6303","acquitted",2,1,0,0,3
"6304","actors",2,1,0,0,3
"6305","adapting",1,2,0,0,3
"6306","adds",0,3,0,0,3
"6307","adead",3,0,0,0,3
"6308","adjoining",1,2,0,0,3
"6309","adorn",1,2,0,0,3
"6310","adultery",0,0,3,0,3
"6311","advances",1,2,0,0,3
"6312","afew",3,0,0,0,3
"6313","affinities",1,2,0,0,3
"6314","againstslavery",3,0,0,0,3
"6315","aggression",1,2,0,0,3
"6316","agitate",2,1,0,0,3
"6317","agree",1,2,0,0,3
"6318","agreeably",3,0,0,0,3
"6319","agreement",2,1,0,0,3
"6320","akin",2,1,0,0,3
"6321","akind",3,0,0,0,3
"6322","alabaster",1,2,0,0,3
"6323","albeit",1,2,0,0,3
"6324","alert",2,1,0,0,3
"6325","alida",3,0,0,0,3
"6326","allender",2,1,0,0,3
"6327","allender’s",2,1,0,0,3
"6328","aman",3,0,0,0,3
"6329","anchored",2,1,0,0,3
"6330","andfor",3,0,0,0,3
"6331","andfrom",3,0,0,0,3
"6332","andleft",3,0,0,0,3
"6333","andmy",3,0,0,0,3
"6334","andof",3,0,0,0,3
"6335","andon",3,0,0,0,3
"6336","andpower",3,0,0,0,3
"6337","andthere",3,0,0,0,3
"6338","animate",1,1,1,0,3
"6339","annals",2,1,0,0,3
"6340","annoyance",1,2,0,0,3
"6341","antics",1,2,0,0,3
"6342","anxiously",2,1,0,0,3
"6343","anywise",3,0,0,0,3
"6344","apartments",1,2,0,0,3
"6345","apiece",2,1,0,0,3
"6346","apostrophe",1,1,1,0,3
"6347","appearing",2,1,0,0,3
"6348","appendix",0,1,2,0,3
"6349","appreciated",3,0,0,0,3
"6350","arbitrary",1,2,0,0,3
"6351","ardently",1,1,1,0,3
"6352","ardor",2,0,1,0,3
"6353","arduous",1,2,0,0,3
"6354","arises",0,2,1,0,3
"6355","around",0,0,0,3,3
"6356","arousing",3,0,0,0,3
"6357","arsenal",3,0,0,0,3
"6358","arsenals",3,0,0,0,3
"6359","article",1,2,0,0,3
"6360","asan",3,0,0,0,3
"6361","ascribe",2,1,0,0,3
"6362","asin",3,0,0,0,3
"6363","assailant",1,2,0,0,3
"6364","assailants",2,1,0,0,3
"6365","asto",3,0,0,0,3
"6366","astounded",2,1,0,0,3
"6367","asylum",1,0,2,0,3
"6368","attacking",2,1,0,0,3
"6369","attendants",1,1,1,0,3
"6370","attired",2,1,0,0,3
"6371","attitudes",1,2,0,0,3
"6372","attractive",3,0,0,0,3
"6373","attributing",2,1,0,0,3
"6374","aught",2,1,0,0,3
"6375","avidity",1,2,0,0,3
"6376","awe",1,2,0,0,3
"6377","awkwardly",1,2,0,0,3
"6378","ax",1,2,0,0,3
"6379","axe",2,0,1,0,3
"6380","aye",0,3,0,0,3
"6381","back_",2,1,0,0,3
"6382","bacon",2,1,0,0,3
"6383","bailey’s",0,1,2,0,3
"6384","bands",0,2,1,0,3
"6385","baneful",1,2,0,0,3
"6386","barefooted",0,0,2,1,3
"6387","bargains",1,2,0,0,3
"6388","bark",1,2,0,0,3
"6389","barney’s",1,1,1,0,3
"6390","barouches",1,1,1,0,3
"6391","barren",0,0,0,3,3
"6392","basket",1,1,1,0,3
"6393","bayonets",3,0,0,0,3
"6394","beal",1,1,1,0,3
"6395","bean",1,1,0,1,3
"6396","beck",1,1,1,0,3
"6397","bedone",3,0,0,0,3
"6398","beena",3,0,0,0,3
"6399","befall",0,2,1,0,3
"6400","befallen",1,1,1,0,3
"6401","begins",2,1,0,0,3
"6402","believe",0,0,0,3,3
"6403","bench",1,2,0,0,3
"6404","bend",2,1,0,0,3
"6405","benjamin",2,0,0,1,3
"6406","bethel",2,1,0,0,3
"6407","betrayal",2,1,0,0,3
"6408","betraying",1,1,1,0,3
"6409","betty",0,3,0,0,3
"6410","beware",0,3,0,0,3
"6411","bewildering",2,1,0,0,3
"6412","bible_",1,2,0,0,3
"6413","bibles",0,2,1,0,3
"6414","billy",1,2,0,0,3
"6415","bishops",1,1,0,1,3
"6416","bitten",1,1,1,0,3
"6417","bitterly",2,1,0,0,3
"6418","blackall",3,0,0,0,3
"6419","blacker",1,2,0,0,3
"6420","bled",2,1,0,0,3
"6421","bleed",1,1,1,0,3
"6422","blest",1,2,0,0,3
"6423","blown",1,1,1,0,3
"6424","blunder",3,0,0,0,3
"6425","boasted",0,3,0,0,3
"6426","bodied",1,1,1,0,3
"6427","bogs",1,1,1,0,3
"6428","bondly",0,0,3,0,3
"6429","bordered",2,1,0,0,3
"6430","bottom",1,2,0,0,3
"6431","bowed",2,1,0,0,3
"6432","bowie",0,3,0,0,3
"6433","boxing",1,1,1,0,3
"6434","boy’s",0,3,0,0,3
"6435","boyhood",0,3,0,0,3
"6436","brakemen",1,2,0,0,3
"6437","bran",1,2,0,0,3
"6438","branch",1,2,0,0,3
"6439","breaker_",0,3,0,0,3
"6440","breeding",0,3,0,0,3
"6441","breezes",1,2,0,0,3
"6442","brief",0,0,0,3,3
"6443","broken_",2,1,0,0,3
"6444","brook",2,0,1,0,3
"6445","brooms",1,1,1,0,3
"6446","brush",2,1,0,0,3
"6447","brutalized",1,2,0,0,3
"6448","brutally",1,2,0,0,3
"6449","buckingham",3,0,0,0,3
"6450","bullets",2,1,0,0,3
"6451","bullies",1,2,0,0,3
"6452","burleigh",2,1,0,0,3
"6453","bustle",2,1,0,0,3
"6454","buti",3,0,0,0,3
"6455","butin",3,0,0,0,3
"6456","bya",3,0,0,0,3
"6457","cabins",1,2,0,0,3
"6458","cakes",1,0,2,0,3
"6459","calculation",2,0,0,1,3
"6460","callous",1,1,1,0,3
"6461","camps",3,0,0,0,3
"6462","candle",2,1,0,0,3
"6463","cape",1,2,0,0,3
"6464","capitals",2,1,0,0,3
"6465","capricious",1,2,0,0,3
"6466","card",1,2,0,0,3
"6467","carelessness",0,1,2,0,3
"6468","carries",1,2,0,0,3
"6469","cash",1,2,0,0,3
"6470","castle",1,0,0,2,3
"6471","catholics",2,0,0,1,3
"6472","causeway",2,1,0,0,3
"6473","ceases",1,1,1,0,3
"6474","ceasing",1,1,1,0,3
"6475","celebration",2,1,0,0,3
"6476","cellars",2,1,0,0,3
"6477","certificate",1,0,2,0,3
"6478","chafed",1,2,0,0,3
"6479","chagrin",0,3,0,0,3
"6480","chairs",2,1,0,0,3
"6481","chambersburg",3,0,0,0,3
"6482","chanced",2,1,0,0,3
"6483","chandler",0,0,0,3,3
"6484","chapters",1,2,0,0,3
"6485","charging",2,1,0,0,3
"6486","charlessumner",3,0,0,0,3
"6487","charley",0,0,0,3,3
"6488","charred",1,2,0,0,3
"6489","chatham",2,1,0,0,3
"6490","cheerfully",3,0,0,0,3
"6491","cheers",0,3,0,0,3
"6492","cheese",1,1,0,1,3
"6493","chickens",2,1,0,0,3
"6494","childhood’s",0,3,0,0,3
"6495","chimneys",1,2,0,0,3
"6496","choosing",1,1,1,0,3
"6497","chorus",1,1,1,0,3
"6498","chose",2,1,0,0,3
"6499","cipher",2,1,0,0,3
"6500","cited",1,1,1,0,3
"6501","classic",1,0,0,2,3
"6502","cleanly",1,1,1,0,3
"6503","cleave",1,2,0,0,3
"6504","coat",3,0,0,0,3
"6505","cocked",1,1,1,0,3
"6506","collar",1,1,1,0,3
"6507","collect",2,1,0,0,3
"6508","colonel’s",1,0,2,0,3
"6509","coloredman",3,0,0,0,3
"6510","combed",1,1,0,1,3
"6511","comforted",1,2,0,0,3
"6512","commands",0,1,1,1,3
"6513","commencing",1,1,1,0,3
"6514","commensurate",1,1,1,0,3
"6515","commercial",2,1,0,0,3
"6516","commissioned",3,0,0,0,3
"6517","communion",0,1,2,0,3
"6518","companies",2,1,0,0,3
"6519","companion",0,3,0,0,3
"6520","competent",2,1,0,0,3
"6521","complained",2,0,1,0,3
"6522","complement",1,2,0,0,3
"6523","compliment",3,0,0,0,3
"6524","complying",2,1,0,0,3
"6525","compose",1,1,1,0,3
"6526","concede",3,0,0,0,3
"6527","conceded",0,2,1,0,3
"6528","concerns",1,2,0,0,3
"6529","concert",1,1,1,0,3
"6530","conclusions",2,1,0,0,3
"6531","condemning",2,1,0,0,3
"6532","confederacy",2,1,0,0,3
"6533","confide",1,1,1,0,3
"6534","confronted",2,1,0,0,3
"6535","congratulations",2,1,0,0,3
"6536","congressional",3,0,0,0,3
"6537","conjecture",1,1,1,0,3
"6538","consequent",2,1,0,0,3
"6539","conservative",2,1,0,0,3
"6540","consign",3,0,0,0,3
"6541","consolations",1,2,0,0,3
"6542","consoled",1,1,1,0,3
"6543","constructing",0,2,0,1,3
"6544","consulting",0,2,1,0,3
"6545","contemplation",1,2,0,0,3
"6546","contemptuously",2,1,0,0,3
"6547","contend",1,0,2,0,3
"6548","contracted",1,1,1,0,3
"6549","contracts",0,1,2,0,3
"6550","contrasted",1,2,0,0,3
"6551","contrasts",3,0,0,0,3
"6552","contrivances",2,1,0,0,3
"6553","controlled",2,1,0,0,3
"6554","converse",2,1,0,0,3
"6555","conversed",3,0,0,0,3
"6556","conversing",1,1,1,0,3
"6557","conveyances",3,0,0,0,3
"6558","cooks",2,1,0,0,3
"6559","coons",1,1,1,0,3
"6560","cooper",2,1,0,0,3
"6561","coöperate",3,0,0,0,3
"6562","cord",2,0,1,0,3
"6563","cordiality",2,1,0,0,3
"6564","cornfield",0,0,2,1,3
"6565","corrected",1,1,1,0,3
"6566","couldbe",3,0,0,0,3
"6567","councils",2,1,0,0,3
"6568","counsels",0,3,0,0,3
"6569","countless",1,1,1,0,3
"6570","coupled",1,2,0,0,3
"6571","coupling",2,1,0,0,3
"6572","courageously",2,1,0,0,3
"6573","coursein",3,0,0,0,3
"6574","courted",1,2,0,0,3
"6575","covent",3,0,0,0,3
"6576","cowhide",2,1,0,0,3
"6577","crabs",1,2,0,0,3
"6578","cracked",1,1,1,0,3
"6579","craftiness",1,2,0,0,3
"6580","crafty",0,3,0,0,3
"6581","craggy",1,1,1,0,3
"6582","create",1,2,0,0,3
"6583","creating",2,0,1,0,3
"6584","crew",1,2,0,0,3
"6585","criminality",1,2,0,0,3
"6586","critical",3,0,0,0,3
"6587","crop",1,2,0,0,3
"6588","crossed",2,1,0,0,3
"6589","cuba",2,1,0,0,3
"6590","culminated",2,1,0,0,3
"6591","cunningly",1,1,1,0,3
"6592","curry",1,1,1,0,3
"6593","curtis",1,1,1,0,3
"6594","daggers",2,1,0,0,3
"6595","darkey",1,2,0,0,3
"6596","dart",1,1,1,0,3
"6597","dated",2,1,0,0,3
"6598","dawned",1,2,0,0,3
"6599","deaden",1,2,0,0,3
"6600","deaf",2,1,0,0,3
"6601","dealer",0,1,2,0,3
"6602","dealings",1,2,0,0,3
"6603","dearly",2,1,0,0,3
"6604","deaths",1,2,0,0,3
"6605","debater",2,1,0,0,3
"6606","decade",3,0,0,0,3
"6607","deceased",3,0,0,0,3
"6608","deceptions",1,1,1,0,3
"6609","deciding",1,2,0,0,3
"6610","declined",3,0,0,0,3
"6611","declining",1,1,1,0,3
"6612","deepened",1,2,0,0,3
"6613","deer",2,1,0,0,3
"6614","defenceless",3,0,0,0,3
"6615","defied",3,0,0,0,3
"6616","deformed",2,1,0,0,3
"6617","defy",2,1,0,0,3
"6618","degrade",2,0,0,1,3
"6619","dehumanizing",0,1,2,0,3
"6620","dejected",1,2,0,0,3
"6621","delayed",3,0,0,0,3
"6622","delegate",3,0,0,0,3
"6623","delevan",3,0,0,0,3
"6624","deliberation",1,0,2,0,3
"6625","deliverer",2,1,0,0,3
"6626","delusive",2,1,0,0,3
"6627","dem",0,3,0,0,3
"6628","democrat",2,1,0,0,3
"6629","democrats",3,0,0,0,3
"6630","demonstrate",1,2,0,0,3
"6631","demonstrating",1,1,1,0,3
"6632","denies",1,1,1,0,3
"6633","densely",1,1,0,1,3
"6634","depart",3,0,0,0,3
"6635","dependence",2,1,0,0,3
"6636","depends",2,1,0,0,3
"6637","deplored",0,3,0,0,3
"6638","depot",2,1,0,0,3
"6639","descendants",0,1,2,0,3
"6640","descriptive",1,2,0,0,3
"6641","deserve",3,0,0,0,3
"6642","destinies",3,0,0,0,3
"6643","detailing",1,1,1,0,3
"6644","detest",0,2,1,0,3
"6645","developed",1,2,0,0,3
"6646","devising",1,0,2,0,3
"6647","devoting",1,2,0,0,3
"6648","dews",1,1,1,0,3
"6649","dexterity",2,1,0,0,3
"6650","digging",0,3,0,0,3
"6651","dilapidated",1,1,1,0,3
"6652","diminished",2,1,0,0,3
"6653","directness",1,2,0,0,3
"6654","disappointing",1,0,1,1,3
"6655","disasters",2,1,0,0,3
"6656","discourage",2,1,0,0,3
"6657","discouraged",2,1,0,0,3
"6658","discuss",2,1,0,0,3
"6659","diseases",2,1,0,0,3
"6660","disgraced",1,2,0,0,3
"6661","disguise",2,0,1,0,3
"6662","dishes",0,3,0,0,3
"6663","disinterested",2,1,0,0,3
"6664","dislike",0,3,0,0,3
"6665","disloyal",2,1,0,0,3
"6666","dismiss",1,2,0,0,3
"6667","dismounted",1,1,1,0,3
"6668","disobedience",0,3,0,0,3
"6669","disorder",1,2,0,0,3
"6670","dispelled",1,1,0,1,3
"6671","dispelling",1,1,1,0,3
"6672","dispense",0,2,0,1,3
"6673","disregarding",1,2,0,0,3
"6674","dissatisfaction",1,2,0,0,3
"6675","dissolution",1,2,0,0,3
"6676","dissolved",2,1,0,0,3
"6677","distances",2,1,0,0,3
"6678","disturb",2,1,0,0,3
"6679","divested",1,2,0,0,3
"6680","docile",2,1,0,0,3
"6681","dock",1,2,0,0,3
"6682","docks",1,0,0,2,3
"6683","document",3,0,0,0,3
"6684","dogma",0,0,0,3,3
"6685","dole",2,1,0,0,3
"6686","domination",1,2,0,0,3
"6687","dothe",3,0,0,0,3
"6688","doubly",2,1,0,0,3
"6689","drama",2,1,0,0,3
"6690","dray",1,2,0,0,3
"6691","dred",3,0,0,0,3
"6692","dregs",1,1,1,0,3
"6693","dried",0,3,0,0,3
"6694","droppings",0,3,0,0,3
"6695","drops",0,2,1,0,3
"6696","dungeon",1,2,0,0,3
"6697","durgin",0,1,2,0,3
"6698","dusky",2,1,0,0,3
"6699","dwelt",1,2,0,0,3
"6700","eagerness",1,2,0,0,3
"6701","earning",1,1,1,0,3
"6702","earthquake",1,1,1,0,3
"6703","easier",1,1,0,1,3
"6704","eats",1,2,0,0,3
"6705","editorials",2,1,0,0,3
"6706","editors",1,2,0,0,3
"6707","educating",2,1,0,0,3
"6708","egyptians",1,1,0,1,3
"6709","elapsed",2,1,0,0,3
"6710","elbow",2,1,0,0,3
"6711","eldest",1,1,1,0,3
"6712","elector",3,0,0,0,3
"6713","elevated",1,2,0,0,3
"6714","elizabeth",3,0,0,0,3
"6715","embracing",2,1,0,0,3
"6716","emigrants",1,2,0,0,3
"6717","emigrate",2,1,0,0,3
"6718","empire",3,0,0,0,3
"6719","encounter",1,2,0,0,3
"6720","end",0,0,0,3,3
"6721","endorsement",3,0,0,0,3
"6722","enlisted",2,1,0,0,3
"6723","enquiry",2,0,0,1,3
"6724","enrolled",1,2,0,0,3
"6725","enslaver",1,2,0,0,3
"6726","entertaining",1,1,0,1,3
"6727","enthusiastic",1,1,1,0,3
"6728","enthusiastically",2,1,0,0,3
"6729","entirely",0,0,0,3,3
"6730","envied",1,1,1,0,3
"6731","equalled",0,0,3,0,3
"6732","equivalent",1,1,1,0,3
"6733","era",1,2,0,0,3
"6734","erroneous",2,0,1,0,3
"6735","error",2,1,0,0,3
"6736","esquire",1,1,1,0,3
"6737","ethnology",1,1,0,1,3
"6738","evade",2,1,0,0,3
"6739","every",0,0,0,3,3
"6740","evidences",2,1,0,0,3
"6741","exacting",1,2,0,0,3
"6742","exactions",1,2,0,0,3
"6743","exaggerated",2,0,1,0,3
"6744","exasperate",2,1,0,0,3
"6745","exceeding",0,2,1,0,3
"6746","excellency",1,2,0,0,3
"6747","exceptional",1,2,0,0,3
"6748","excess",1,0,2,0,3
"6749","exclaimed",2,1,0,0,3
"6750","exculpate",0,2,1,0,3
"6751","excursion",0,0,0,3,3
"6752","excused",2,1,0,0,3
"6753","execrated",1,2,0,0,3
"6754","execrations",1,2,0,0,3
"6755","exert",1,2,0,0,3
"6756","exertions",3,0,0,0,3
"6757","exhortations",2,1,0,0,3
"6758","exhorted",1,1,1,0,3
"6759","expelled",1,1,0,1,3
"6760","expending",2,1,0,0,3
"6761","expressions",2,1,0,0,3
"6762","expressly",2,1,0,0,3
"6763","extorted",1,1,1,0,3
"6764","extravagance",2,1,0,0,3
"6765","extremes",0,3,0,0,3
"6766","extremities",1,1,1,0,3
"6767","exultingly",1,1,1,0,3
"6768","factthat",3,0,0,0,3
"6769","faded",1,2,0,0,3
"6770","failing",2,1,0,0,3
"6771","failures",2,1,0,0,3
"6772","famed",0,0,0,3,3
"6773","fanatic",2,1,0,0,3
"6774","faneuil",3,0,0,0,3
"6775","farewell",1,2,0,0,3
"6776","farmington",3,0,0,0,3
"6777","fashionable",1,1,1,0,3
"6778","fasten",1,1,1,0,3
"6779","favoring",2,1,0,0,3
"6780","favorof",3,0,0,0,3
"6781","favors",1,0,2,0,3
"6782","fearless",1,1,1,0,3
"6783","feasible",1,1,1,0,3
"6784","feather",1,2,0,0,3
"6785","feb",0,0,0,3,3
"6786","felon",1,1,1,0,3
"6787","female",1,1,1,0,3
"6788","fettered",0,3,0,0,3
"6789","fewest",2,1,0,0,3
"6790","fiddling",1,1,1,0,3
"6791","fiends",1,1,1,0,3
"6792","figs",1,1,0,1,3
"6793","fillmore",2,1,0,0,3
"6794","finsbury",0,3,0,0,3
"6795","firmer",3,0,0,0,3
"6796","fitly",1,1,0,1,3
"6797","flagrant",2,1,0,0,3
"6798","flags",1,1,0,1,3
"6799","flame",2,1,0,0,3
"6800","flames",3,0,0,0,3
"6801","flashing",1,2,0,0,3
"6802","flickered",1,1,1,0,3
"6803","flickering",1,1,1,0,3
"6804","flinging",1,2,0,0,3
"6805","flint",2,1,0,0,3
"6806","floating",0,2,0,1,3
"6807","flogged",2,1,0,0,3
"6808","flour",1,2,0,0,3
"6809","flowed",2,1,0,0,3
"6810","flowery",3,0,0,0,3
"6811","fold",1,1,1,0,3
"6812","followers",0,1,1,1,3
"6813","fool",2,1,0,0,3
"6814","footsteps",1,2,0,0,3
"6815","forbids",1,1,1,0,3
"6816","fore",1,1,0,1,3
"6817","forecastle",2,1,0,0,3
"6818","foreseen",2,1,0,0,3
"6819","foreshadowed",3,0,0,0,3
"6820","forests",2,1,0,0,3
"6821","forfeited",2,1,0,0,3
"6822","forgive",1,2,0,0,3
"6823","forhe",3,0,0,0,3
"6824","forhis",3,0,0,0,3
"6825","formerly",0,0,0,3,3
"6826","forsaken",1,2,0,0,3
"6827","forthis",3,0,0,0,3
"6828","fortified",3,0,0,0,3
"6829","fortunes",2,1,0,0,3
"6830","fostering",1,2,0,0,3
"6831","foulest",1,1,1,0,3
"6832","founder",2,1,0,0,3
"6833","fourthly",2,1,0,0,3
"6834","fragments",2,0,0,1,3
"6835","franchise",2,1,0,0,3
"6836","francis",2,1,0,0,3
"6837","franklin",2,0,0,1,3
"6838","freefrom",3,0,0,0,3
"6839","freestate",3,0,0,0,3
"6840","fret",1,1,1,0,3
"6841","frightened",2,1,0,0,3
"6842","frightfully",1,1,1,0,3
"6843","fromthis",3,0,0,0,3
"6844","frowned",1,2,0,0,3
"6845","frozen",1,1,1,0,3
"6846","fruitless",2,1,0,0,3
"6847","fundamental",1,2,0,0,3
"6848","funds",2,1,0,0,3
"6849","funeral",1,1,0,1,3
"6850","gains",1,1,0,1,3
"6851","gait",1,2,0,0,3
"6852","galled",1,1,0,1,3
"6853","gallery",0,1,0,2,3
"6854","gallop",1,2,0,0,3
"6855","garnet",3,0,0,0,3
"6856","gazed",2,1,0,0,3
"6857","gazing",0,2,1,0,3
"6858","geese",1,2,0,0,3
"6859","genealogical",1,2,0,0,3
"6860","generosity",2,1,0,0,3
"6861","gentleness",1,1,1,0,3
"6862","gentry",1,2,0,0,3
"6863","gestures",1,2,0,0,3
"6864","giddings",3,0,0,0,3
"6865","gifted",3,0,0,0,3
"6866","gilded",2,1,0,0,3
"6867","glanced",2,1,0,0,3
"6868","glances",1,2,0,0,3
"6869","glancing",2,1,0,0,3
"6870","gleesome",1,2,0,0,3
"6871","glimmering",0,2,1,0,3
"6872","glittering",2,1,0,0,3
"6873","godlike",0,1,2,0,3
"6874","gointo",3,0,0,0,3
"6875","gong",2,0,0,1,3
"6876","goodell",3,0,0,0,3
"6877","goodly",2,1,0,0,3
"6878","gore’s",1,1,1,0,3
"6879","goto",3,0,0,0,3
"6880","governing",2,1,0,0,3
"6881","graces",1,2,0,0,3
"6882","grafton",3,0,0,0,3
"6883","grander",2,1,0,0,3
"6884","grandparents",1,2,0,0,3
"6885","grandson",3,0,0,0,3
"6886","granting",2,1,0,0,3
"6887","grated",1,2,0,0,3
"6888","grating",1,2,0,0,3
"6889","greedily",1,1,1,0,3
"6890","greet",1,0,0,2,3
"6891","greeting",1,1,0,1,3
"6892","griefs",1,2,0,0,3
"6893","grievously",2,1,0,0,3
"6894","grinding",1,1,1,0,3
"6895","grindstone",1,1,1,0,3
"6896","grinned",1,1,1,0,3
"6897","groans",0,1,2,0,3
"6898","gropes",1,1,1,0,3
"6899","guidance",1,1,1,0,3
"6900","guided",1,2,0,0,3
"6901","gushed",1,1,1,0,3
"6902","hadbefore",3,0,0,0,3
"6903","haddone",3,0,0,0,3
"6904","hadin",3,0,0,0,3
"6905","hadnot",3,0,0,0,3
"6906","hadnow",3,0,0,0,3
"6907","haggard",1,2,0,0,3
"6908","halt",2,1,0,0,3
"6909","hammer",1,2,0,0,3
"6910","handsof",3,0,0,0,3
"6911","happier",1,0,2,0,3
"6912","hardest",0,3,0,0,3
"6913","hardness",1,1,0,1,3
"6914","harrowing",0,3,0,0,3
"6915","harvest",1,1,1,0,3
"6916","harvey",1,0,0,2,3
"6917","hatchet",1,1,1,0,3
"6918","hates",0,3,0,0,3
"6919","hath",2,1,0,0,3
"6920","haveno",3,0,0,0,3
"6921","hay",1,0,2,0,3
"6922","healed",2,1,0,0,3
"6923","hears",1,1,1,0,3
"6924","heartlessly",1,2,0,0,3
"6925","hebrew",2,0,0,1,3
"6926","heed",2,1,0,0,3
"6927","heeded",3,0,0,0,3
"6928","heels",0,2,0,1,3
"6929","hehad",3,0,0,0,3
"6930","helpful",3,0,0,0,3
"6931","hemmed",0,1,2,0,3
"6932","herewas",3,0,0,0,3
"6933","herod",1,1,1,0,3
"6934","herrings",1,2,0,0,3
"6935","hesitated",2,1,0,0,3
"6936","hester",0,0,3,0,3
"6937","hewing",1,1,1,0,3
"6938","hides",0,2,1,0,3
"6939","highland",3,0,0,0,3
"6940","hima",3,0,0,0,3
"6941","himthe",3,0,0,0,3
"6942","hindered",1,2,0,0,3
"6943","hindrance",3,0,0,0,3
"6944","hisown",3,0,0,0,3
"6945","historyof",3,0,0,0,3
"6946","hoboken",3,0,0,0,3
"6947","holder",0,3,0,0,3
"6948","holes",2,1,0,0,3
"6949","homage",2,0,1,0,3
"6950","homeless",0,1,2,0,3
"6951","hood",0,3,0,0,3
"6952","hour’s",2,1,0,0,3
"6953","house_",1,2,0,0,3
"6954","houseof",3,0,0,0,3
"6955","howling",0,1,0,2,3
"6956","humblest",1,1,1,0,3
"6957","hundreddollars",3,0,0,0,3
"6958","hurt",1,0,1,1,3
"6959","hypocritical",1,1,1,0,3
"6960","iam",3,0,0,0,3
"6961","iheard",3,0,0,0,3
"6962","illustrates",3,0,0,0,3
"6963","imbue",1,1,1,0,3
"6964","imbued",1,2,0,0,3
"6965","imitation",2,0,1,0,3
"6966","imparting",2,1,0,0,3
"6967","impatience",1,2,0,0,3
"6968","imperfect",1,2,0,0,3
"6969","implements",1,2,0,0,3
"6970","implication",3,0,0,0,3
"6971","implying",2,1,0,0,3
"6972","imported",1,2,0,0,3
"6973","impose",1,1,1,0,3
"6974","impropriety",1,1,1,0,3
"6975","imps",1,2,0,0,3
"6976","impudently",0,2,1,0,3
"6977","impulse",2,1,0,0,3
"6978","impulsive",2,1,0,0,3
"6979","ina",3,0,0,0,3
"6980","inborn",1,2,0,0,3
"6981","incentive",1,2,0,0,3
"6982","inclines",1,1,1,0,3
"6983","incoherent",1,1,1,0,3
"6984","incompany",2,0,0,1,3
"6985","indecent",2,1,0,0,3
"6986","indestructible",0,3,0,0,3
"6987","indicating",1,1,1,0,3
"6988","indirect",1,2,0,0,3
"6989","indirection",2,1,0,0,3
"6990","indulgence",2,1,0,0,3
"6991","ineffaceably",1,2,0,0,3
"6992","inever",3,0,0,0,3
"6993","infer",1,1,1,0,3
"6994","infested",2,1,0,0,3
"6995","infidel",2,0,1,0,3
"6996","inflict",1,1,1,0,3
"6997","inflictions",0,3,0,0,3
"6998","influenced",1,2,0,0,3
"6999","informant",1,1,1,0,3
"7000","infuriated",1,2,0,0,3
"7001","innumerable",1,1,0,1,3
"7002","inoperative",2,1,0,0,3
"7003","insect",1,1,1,0,3
"7004","insecure",3,0,0,0,3
"7005","insertion",1,2,0,0,3
"7006","insignificant",2,1,0,0,3
"7007","inspection",1,1,1,0,3
"7008","inspiring",1,1,1,0,3
"7009","instinct",1,2,0,0,3
"7010","instincts",1,2,0,0,3
"7011","instrumental",1,1,1,0,3
"7012","instrumentalities",1,2,0,0,3
"7013","insufficient",1,1,1,0,3
"7014","insuperable",2,1,0,0,3
"7015","insurgents",3,0,0,0,3
"7016","integrity",3,0,0,0,3
"7017","intellects",1,1,1,0,3
"7018","intensified",1,2,0,0,3
"7019","intercourse",2,1,0,0,3
"7020","interfered",1,1,1,0,3
"7021","interpose",1,1,1,0,3
"7022","interpretation",1,2,0,0,3
"7023","interval",1,1,1,0,3
"7024","intervening",2,1,0,0,3
"7025","intimacy",1,2,0,0,3
"7026","invite",1,1,0,1,3
"7027","involving",2,1,0,0,3
"7028","iremember",3,0,0,0,3
"7029","ironed",1,2,0,0,3
"7030","irresistible",1,1,0,1,3
"7031","isa",3,0,0,0,3
"7032","ishould",3,0,0,0,3
"7033","isnot",3,0,0,0,3
"7034","issuing",2,1,0,0,3
"7035","isthe",3,0,0,0,3
"7036","ithought",3,0,0,0,3
"7037","itis",3,0,0,0,3
"7038","java",2,1,0,0,3
"7039","jennie",3,0,0,0,3
"7040","johnsons",0,2,1,0,3
"7041","joining",0,3,0,0,3
"7042","jokes",1,1,1,0,3
"7043","judges",2,1,0,0,3
"7044","katy’s",2,1,0,0,3
"7045","keelson",2,1,0,0,3
"7046","kelly",3,0,0,0,3
"7047","kept",0,0,0,3,3
"7048","keys",2,1,0,0,3
"7049","kicks",1,1,1,0,3
"7050","kin",2,1,0,0,3
"7051","kindle",2,1,0,0,3
"7052","kindled",1,2,0,0,3
"7053","kindliest",2,1,0,0,3
"7054","kindling",1,2,0,0,3
"7055","kindnessof",3,0,0,0,3
"7056","kindred",0,1,1,1,3
"7057","kirk",3,0,0,0,3
"7058","kitchens",1,2,0,0,3
"7059","kossuth",0,3,0,0,3
"7060","langston",3,0,0,0,3
"7061","lapse",3,0,0,0,3
"7062","laughing",1,2,0,0,3
"7063","laughingly",1,1,1,0,3
"7064","launch",1,2,0,0,3
"7065","law’s",1,1,1,0,3
"7066","leaden",2,1,0,0,3
"7067","leader_",0,3,0,0,3
"7068","leadership",3,0,0,0,3
"7069","leaning",1,1,1,0,3
"7070","leaping",1,1,0,1,3
"7071","learns",0,3,0,0,3
"7072","lecturing",1,1,1,0,3
"7073","ledger",0,3,0,0,3
"7074","lends",0,2,1,0,3
"7075","lessthan",3,0,0,0,3
"7076","lifeof",3,0,0,0,3
"7077","likelyto",3,0,0,0,3
"7078","lineal",1,1,1,0,3
"7079","literature",2,1,0,0,3
"7080","livery",1,0,2,0,3
"7081","lo",2,1,0,0,3
"7082","loathed",1,1,1,0,3
"7083","lodged",2,1,0,0,3
"7084","lodging",1,1,0,1,3
"7085","log",1,2,0,0,3
"7086","loguen",2,1,0,0,3
"7087","longing",2,1,0,0,3
"7088","loosed",1,1,1,0,3
"7089","lots",1,2,0,0,3
"7090","louder",0,1,2,0,3
"7091","lowly",1,0,1,1,3
"7092","lucern",0,0,0,3,3
"7093","lukewarm",1,2,0,0,3
"7094","lunch",2,0,0,1,3
"7095","lust",0,2,0,1,3
"7096","luther",1,1,1,0,3
"7097","lynch",1,1,1,0,3
"7098","machines",2,1,0,0,3
"7099","mademe",3,0,0,0,3
"7100","madly",2,1,0,0,3
"7101","magnificence",2,1,0,0,3
"7102","magnitude",2,1,0,0,3
"7103","mail",3,0,0,0,3
"7104","maimed",2,1,0,0,3
"7105","mainspring",3,0,0,0,3
"7106","maintaining",2,1,0,0,3
"7107","major",3,0,0,0,3
"7108","makers",1,2,0,0,3
"7109","making",0,0,0,3,3
"7110","malady",3,0,0,0,3
"7111","malignant",2,1,0,0,3
"7112","maltreated",2,1,0,0,3
"7113","mancan",3,0,0,0,3
"7114","manchester",2,0,0,1,3
"7115","manifesting",1,1,1,0,3
"7116","manual",2,1,0,0,3
"7117","manufactured",1,0,0,2,3
"7118","manuscript",1,2,0,0,3
"7119","marching",3,0,0,0,3
"7120","maria",3,0,0,0,3
"7121","marred",1,1,0,1,3
"7122","marsh",2,0,0,1,3
"7123","martyr",3,0,0,0,3
"7124","martyrs",2,1,0,0,3
"7125","marvel",1,2,0,0,3
"7126","masterthomas",3,0,0,0,3
"7127","materials",1,2,0,0,3
"7128","maternal",1,2,0,0,3
"7129","mats",1,1,1,0,3
"7130","matted",1,1,1,0,3
"7131","maturity",1,2,0,0,3
"7132","mayor",1,2,0,0,3
"7133","mcgowan",3,0,0,0,3
"7134","me.i",3,0,0,0,3
"7135","mea",3,0,0,0,3
"7136","meansof",3,0,0,0,3
"7137","mediteranian",0,0,0,3,3
"7138","meekness",1,1,1,0,3
"7139","meets",0,2,1,0,3
"7140","mein",3,0,0,0,3
"7141","melancholy",1,2,0,0,3
"7142","memories",2,0,1,0,3
"7143","merrily",1,1,1,0,3
"7144","militia",3,0,0,0,3
"7145","miller",0,3,0,0,3
"7146","missed",1,2,0,0,3
"7147","missing",2,1,0,0,3
"7148","misty",1,1,1,0,3
"7149","mixed",1,2,0,0,3
"7150","moans",1,1,1,0,3
"7151","mobile",1,2,0,0,3
"7152","moderation",3,0,0,0,3
"7153","modified",2,1,0,0,3
"7154","molest",1,2,0,0,3
"7155","momentary",2,0,0,1,3
"7156","mongers",0,2,1,0,3
"7157","monsters",0,2,1,0,3
"7158","moods",2,1,0,0,3
"7159","moorings",1,1,1,0,3
"7160","morethan",3,0,0,0,3
"7161","moroni",0,0,0,3,3
"7162","morris",3,0,0,0,3
"7163","mortals",0,3,0,0,3
"7164","mortification",0,3,0,0,3
"7165","motto",1,0,2,0,3
"7166","mouldering",1,0,1,1,3
"7167","mouths",1,1,1,0,3
"7168","mr.covey",3,0,0,0,3
"7169","mr.garrison",3,0,0,0,3
"7170","mr.william",3,0,0,0,3
"7171","muchthat",3,0,0,0,3
"7172","muchto",3,0,0,0,3
"7173","mule",2,1,0,0,3
"7174","mules",2,1,0,0,3
"7175","murderers",2,0,1,0,3
"7176","muscle",3,0,0,0,3
"7177","muscles",1,2,0,0,3
"7178","museum",0,0,0,3,3
"7179","musical",2,1,0,0,3
"7180","mute",0,3,0,0,3
"7181","mutilated",3,0,0,0,3
"7182","mutton",1,1,1,0,3
"7183","mydear",3,0,0,0,3
"7184","mylabor",3,0,0,0,3
"7185","mylife",3,0,0,0,3
"7186","mypresence",3,0,0,0,3
"7187","myvisit",3,0,0,0,3
"7188","myvoice",3,0,0,0,3
"7189","name",0,0,0,3,3
"7190","napoleon",1,1,1,0,3
"7191","near",0,0,0,3,3
"7192","nearly",0,0,0,3,3
"7193","nearlyall",3,0,0,0,3
"7194","neat",1,2,0,0,3
"7195","nebraska",3,0,0,0,3
"7196","necks",1,1,1,0,3
"7197","negative",1,1,1,0,3
"7198","neighbor",1,0,0,2,3
"7199","neither",0,0,0,3,3
"7200","newengland",3,0,0,0,3
"7201","nineteen",2,1,0,0,3
"7202","nineteenth",2,1,0,0,3
"7203","nod",1,1,1,0,3
"7204","noisome",1,1,1,0,3
"7205","notable",1,2,0,0,3
"7206","noteworthy",3,0,0,0,3
"7207","numbering",2,0,1,0,3
"7208","numberof",3,0,0,0,3
"7209","nursed",3,0,0,0,3
"7210","nursing",1,2,0,0,3
"7211","o’er",1,2,0,0,3
"7212","objected",3,0,0,0,3
"7213","obligation",2,1,0,0,3
"7214","obnoxious",2,1,0,0,3
"7215","obscurity",2,1,0,0,3
"7216","oct",1,1,0,1,3
"7217","odious",2,1,0,0,3
"7218","odium",1,1,1,0,3
"7219","odor",1,2,0,0,3
"7220","ofanother",3,0,0,0,3
"7221","offender",2,1,0,0,3
"7222","offreedom",3,0,0,0,3
"7223","ofits",3,0,0,0,3
"7224","ofmaster",3,0,0,0,3
"7225","oftener",2,0,1,0,3
"7226","onboard",1,0,0,2,3
"7227","ontario",3,0,0,0,3
"7228","onthis",3,0,0,0,3
"7229","oozing",1,1,1,0,3
"7230","operating",2,1,0,0,3
"7231","opossums",1,1,1,0,3
"7232","oppress",2,1,0,0,3
"7233","orange",1,1,1,0,3
"7234","oranges",0,0,0,3,3
"7235","orations",2,1,0,0,3
"7236","ordained",1,1,1,0,3
"7237","organ",1,2,0,0,3
"7238","organs",1,2,0,0,3
"7239","ornamental",1,1,0,1,3
"7240","orof",3,0,0,0,3
"7241","ostensibly",2,1,0,0,3
"7242","outburst",2,1,0,0,3
"7243","outcry",1,2,0,0,3
"7244","outlived",1,1,1,0,3
"7245","outlook",2,0,0,1,3
"7246","outof",3,0,0,0,3
"7247","outsider",1,2,0,0,3
"7248","overheard",1,1,0,1,3
"7249","overlooked",1,2,0,0,3
"7250","overshadowed",1,2,0,0,3
"7251","overthrew",1,2,0,0,3
"7252","overwhelming",0,2,1,0,3
"7253","owl",1,1,1,0,3
"7254","pained",2,1,0,0,3
"7255","painstaking",2,1,0,0,3
"7256","paint",2,1,0,0,3
"7257","palms",1,1,0,1,3
"7258","parade",0,1,0,2,3
"7259","parcel",1,1,1,0,3
"7260","parental",0,2,1,0,3
"7261","parlance",1,2,0,0,3
"7262","paternity",1,2,0,0,3
"7263","pathetic",0,1,2,0,3
"7264","patient",1,1,1,0,3
"7265","patrol",1,1,1,0,3
"7266","paused",1,2,0,0,3
"7267","pavement",1,1,1,0,3
"7268","peaches",1,2,0,0,3
"7269","peck",0,2,1,0,3
"7270","peeped",2,1,0,0,3
"7271","peleg",3,0,0,0,3
"7272","penalties",1,2,0,0,3
"7273","penn",3,0,0,0,3
"7274","perceived",1,1,1,0,3
"7275","performing",3,0,0,0,3
"7276","perpetrating",1,1,1,0,3
"7277","perpetually",0,2,1,0,3
"7278","perplexing",0,2,1,0,3
"7279","persecutions",2,1,0,0,3
"7280","persist",1,1,1,0,3
"7281","persuasive",3,0,0,0,3
"7282","pestiferous",1,2,0,0,3
"7283","petted",1,2,0,0,3
"7284","phaetons",2,1,0,0,3
"7285","phenomenon",1,2,0,0,3
"7286","phil",0,3,0,0,3
"7287","philanthropic",1,2,0,0,3
"7288","pie",2,1,0,0,3
"7289","pilate",1,1,1,0,3
"7290","pillow",1,2,0,0,3
"7291","pin",2,1,0,0,3
"7292","pittsfield",2,1,0,0,3
"7293","plaintive",1,2,0,0,3
"7294","plank",2,1,0,0,3
"7295","plant",2,0,1,0,3
"7296","plunder",2,1,0,0,3
"7297","plundered",1,1,1,0,3
"7298","plundering",1,1,1,0,3
"7299","plunged",1,1,1,0,3
"7300","ply",1,1,1,0,3
"7301","pocketed",1,2,0,0,3
"7302","pockets",1,1,0,1,3
"7303","points",0,0,0,3,3
"7304","polite",1,1,0,1,3
"7305","politician",1,2,0,0,3
"7306","pollute",0,3,0,0,3
"7307","polluted",2,1,0,0,3
"7308","pompeii",0,0,0,3,3
"7309","pond",1,2,0,0,3
"7310","poplars",2,1,0,0,3
"7311","positively",1,2,0,0,3
"7312","potent",2,1,0,0,3
"7313","potomac",2,1,0,0,3
"7314","pounce",1,2,0,0,3
"7315","powerless",2,1,0,0,3
"7316","practicability",0,3,0,0,3
"7317","preceded",2,0,1,0,3
"7318","preceding",2,1,0,0,3
"7319","precise",1,2,0,0,3
"7320","predominating",2,1,0,0,3
"7321","prefix",2,1,0,0,3
"7322","pregnant",3,0,0,0,3
"7323","preliminary",1,2,0,0,3
"7324","preposterous",2,1,0,0,3
"7325","preserve",1,1,1,0,3
"7326","preside",3,0,0,0,3
"7327","presided",1,1,0,1,3
"7328","presidency",3,0,0,0,3
"7329","pretense",1,1,0,1,3
"7330","pretensions",0,1,2,0,3
"7331","pretentious",1,1,0,1,3
"7332","prevailing",2,1,0,0,3
"7333","prevalence",1,2,0,0,3
"7334","priest",1,0,0,2,3
"7335","priests",0,0,2,1,3
"7336","print",1,2,0,0,3
"7337","prisoner",2,0,0,1,3
"7338","prisons",1,2,0,0,3
"7339","privilegeof",3,0,0,0,3
"7340","prized",1,1,1,0,3
"7341","probably",0,0,0,3,3
"7342","proclaim",1,1,1,0,3
"7343","professions",1,1,1,0,3
"7344","profit",1,2,0,0,3
"7345","profusion",1,2,0,0,3
"7346","progressive",3,0,0,0,3
"7347","prohibited",2,1,0,0,3
"7348","prohibition",2,1,0,0,3
"7349","projectors",1,2,0,0,3
"7350","promises",2,1,0,0,3
"7351","promoted",3,0,0,0,3
"7352","promotion",1,1,1,0,3
"7353","promptness",1,2,0,0,3
"7354","proofs",0,1,2,0,3
"7355","proportions",0,2,1,0,3
"7356","proprietor",3,0,0,0,3
"7357","prospective",2,1,0,0,3
"7358","prosperous",1,2,0,0,3
"7359","protector",1,1,1,0,3
"7360","prouder",0,2,1,0,3
"7361","providing",1,2,0,0,3
"7362","proving",0,3,0,0,3
"7363","proximity",2,1,0,0,3
"7364","publicity",1,2,0,0,3
"7365","puffed",1,1,1,0,3
"7366","pulsation",2,1,0,0,3
"7367","punch",1,1,1,0,3
"7368","purchasers",0,3,0,0,3
"7369","purest",1,1,1,0,3
"7370","purple",1,2,0,0,3
"7371","push",2,0,0,1,3
"7372","pushing",1,1,0,1,3
"7373","quailed",2,0,1,0,3
"7374","qualified",1,1,1,0,3
"7375","quarry",3,0,0,0,3
"7376","queer",0,1,0,2,3
"7377","questionable",0,2,1,0,3
"7378","questioned",1,1,1,0,3
"7379","quincy",2,1,0,0,3
"7380","quitted",1,2,0,0,3
"7381","rabbits",1,2,0,0,3
"7382","racked",1,1,1,0,3
"7383","rags",2,1,0,0,3
"7384","railroads",2,1,0,0,3
"7385","rails",2,1,0,0,3
"7386","railway",1,0,0,2,3
"7387","rainy",1,0,0,2,3
"7388","rather",0,0,0,3,3
"7389","rattlesnake",1,2,0,0,3
"7390","ravages",2,0,1,0,3
"7391","raved",1,1,1,0,3
"7392","realize",1,1,1,0,3
"7393","realms",1,2,0,0,3
"7394","recalled",1,1,1,0,3
"7395","receipt",2,1,0,0,3
"7396","recommend",1,1,1,0,3
"7397","reconciling",1,1,1,0,3
"7398","recounted",1,1,1,0,3
"7399","recovered",1,2,0,0,3
"7400","recur",1,2,0,0,3
"7401","redeemed",2,1,0,0,3
"7402","redolent",1,2,0,0,3
"7403","reducing",1,2,0,0,3
"7404","reflect",1,2,0,0,3
"7405","reformers",0,2,1,0,3
"7406","refrain",1,1,1,0,3
"7407","regenerated",2,1,0,0,3
"7408","reign",2,1,0,0,3
"7409","reigns",1,2,0,0,3
"7410","reins",1,2,0,0,3
"7411","reject",1,1,1,0,3
"7412","rejoicing",1,2,0,0,3
"7413","relatives",1,2,0,0,3
"7414","religiously",2,1,0,0,3
"7415","remarked",1,1,1,0,3
"7416","remarking",1,2,0,0,3
"7417","renter",1,1,1,0,3
"7418","repair",0,2,0,1,3
"7419","repairing",1,2,0,0,3
"7420","repel",2,1,0,0,3
"7421","reprobation",2,1,0,0,3
"7422","repugnance",0,3,0,0,3
"7423","repulse",2,1,0,0,3
"7424","reputable",1,1,1,0,3
"7425","rescued",2,0,1,0,3
"7426","resident",1,0,2,0,3
"7427","resist_",2,1,0,0,3
"7428","responsibilities",0,1,2,0,3
"7429","rested",0,2,0,1,3
"7430","restored",2,0,1,0,3
"7431","resurrection",1,1,1,0,3
"7432","retaken",1,1,1,0,3
"7433","retreat",2,1,0,0,3
"7434","returns",1,1,1,0,3
"7435","reverberate",1,1,1,0,3
"7436","reverend",2,0,1,0,3
"7437","revival",1,2,0,0,3
"7438","richest",1,1,1,0,3
"7439","rigged",1,1,0,1,3
"7440","rightfulness",2,1,0,0,3
"7441","rightly",1,1,1,0,3
"7442","rightto",3,0,0,0,3
"7443","rises",2,1,0,0,3
"7444","rivet",1,2,0,0,3
"7445","riveted",1,2,0,0,3
"7446","roared",2,1,0,0,3
"7447","roaring",1,1,1,0,3
"7448","robed",1,1,1,0,3
"7449","robinson",3,0,0,0,3
"7450","robs",0,1,2,0,3
"7451","roguish",1,2,0,0,3
"7452","roller",1,1,1,0,3
"7453","roma",0,0,0,3,3
"7454","romish",0,0,0,3,3
"7455","roughly",2,1,0,0,3
"7456","rouse",3,0,0,0,3
"7457","rub",1,1,1,0,3
"7458","ruthlessly",1,2,0,0,3
"7459","sabbaths",2,1,0,0,3
"7460","sack",3,0,0,0,3
"7461","sadder",2,1,0,0,3
"7462","safeguards",3,0,0,0,3
"7463","sage",0,2,0,1,3
"7464","sailor’s",3,0,0,0,3
"7465","saint",1,2,0,0,3
"7466","sane",1,1,0,1,3
"7467","sarcasm",0,3,0,0,3
"7468","saturdaynight",3,0,0,0,3
"7469","scorpions",1,1,1,0,3
"7470","scotch",1,2,0,0,3
"7471","scourgings",0,2,1,0,3
"7472","scow",1,1,1,0,3
"7473","scrape",1,1,1,0,3
"7474","screw",0,3,0,0,3
"7475","scripture",1,1,1,0,3
"7476","sectional",2,1,0,0,3
"7477","sects",1,1,0,1,3
"7478","sedate",1,2,0,0,3
"7479","seemedto",3,0,0,0,3
"7480","selecting",2,1,0,0,3
"7481","seminary",3,0,0,0,3
"7482","sensations",1,2,0,0,3
"7483","sensibilities",2,1,0,0,3
"7484","serving",2,1,0,0,3
"7485","session",3,0,0,0,3
"7486","settlers",1,2,0,0,3
"7487","seven",0,0,0,3,3
"7488","seymour",3,0,0,0,3
"7489","shad",1,2,0,0,3
"7490","shaft",1,2,0,0,3
"7491","shaking",2,1,0,0,3
"7492","shameful",3,0,0,0,3
"7493","shamelessly",2,1,0,0,3
"7494","shaping",1,2,0,0,3
"7495","sharer",1,2,0,0,3
"7496","sharply",2,1,0,0,3
"7497","shells",1,1,1,0,3
"7498","sheltered",2,1,0,0,3
"7499","sheridan’s",1,1,1,0,3
"7500","sheriff",1,1,1,0,3
"7501","shipyard",0,2,1,0,3
"7502","shoemaker",2,1,0,0,3
"7503","shoemakers",1,2,0,0,3
"7504","shortened",1,1,1,0,3
"7505","shouldhave",3,0,0,0,3
"7506","shrill",1,1,1,0,3
"7507","shrinks",2,1,0,0,3
"7508","shudder",2,1,0,0,3
"7509","sideof",3,0,0,0,3
"7510","sighted",1,2,0,0,3
"7511","sightof",3,0,0,0,3
"7512","signed",1,1,1,0,3
"7513","significant",2,1,0,0,3
"7514","simultaneous",1,2,0,0,3
"7515","sincerity",1,0,1,1,3
"7516","singer",1,1,1,0,3
"7517","sinister",2,1,0,0,3
"7518","sixpence",2,1,0,0,3
"7519","skull",1,1,1,0,3
"7520","slater’s",1,1,1,0,3
"7521","slavehad",3,0,0,0,3
"7522","slavesto",3,0,0,0,3
"7523","sleepless",1,1,1,0,3
"7524","sleeps",1,2,0,0,3
"7525","sleeves",1,1,1,0,3
"7526","slumber",1,2,0,0,3
"7527","slumbering",0,1,2,0,3
"7528","smartest",0,1,2,0,3
"7529","smiling",1,2,0,0,3
"7530","smote",1,2,0,0,3
"7531","snap",1,2,0,0,3
"7532","snugly",1,2,0,0,3
"7533","soberly",1,1,1,0,3
"7534","sobriety",2,1,0,0,3
"7535","soi",3,0,0,0,3
"7536","sojourner",1,2,0,0,3
"7537","somethingmore",3,0,0,0,3
"7538","somewhat",0,0,0,3,3
"7539","soothing",2,0,1,0,3
"7540","sopha",1,2,0,0,3
"7541","souled",1,2,0,0,3
"7542","soundness",2,1,0,0,3
"7543","sour",1,2,0,0,3
"7544","sources",2,1,0,0,3
"7545","southerners",2,1,0,0,3
"7546","sovereign",1,2,0,0,3
"7547","sowell",3,0,0,0,3
"7548","spain",2,1,0,0,3
"7549","sphere",3,0,0,0,3
"7550","spies",1,1,1,0,3
"7551","spoil",2,1,0,0,3
"7552","spoiler",0,0,3,0,3
"7553","spoons",1,1,1,0,3
"7554","spreading",1,1,1,0,3
"7555","sprightly",1,1,1,0,3
"7556","springfield",3,0,0,0,3
"7557","springing",1,1,1,0,3
"7558","sprung",1,2,0,0,3
"7559","spurns",2,1,0,0,3
"7560","squads",3,0,0,0,3
"7561","stairway",2,1,0,0,3
"7562","stamp",1,2,0,0,3
"7563","star_",3,0,0,0,3
"7564","stateof",3,0,0,0,3
"7565","statesmanship",3,0,0,0,3
"7566","stating",0,3,0,0,3
"7567","statue",1,1,0,1,3
"7568","stature",1,1,1,0,3
"7569","statutes",2,0,1,0,3
"7570","steals",0,2,1,0,3
"7571","stiff",1,1,1,0,3
"7572","stinginess",1,2,0,0,3
"7573","stingy",1,2,0,0,3
"7574","stopt",0,0,0,3,3
"7575","storing",2,1,0,0,3
"7576","storms",2,1,0,0,3
"7577","stowing",1,1,1,0,3
"7578","stratagem",1,1,1,0,3
"7579","streak",2,1,0,0,3
"7580","strews",1,1,1,0,3
"7581","studying",1,1,0,1,3
"7582","stupid",0,2,1,0,3
"7583","succeeding",2,1,0,0,3
"7584","successor",3,0,0,0,3
"7585","suchas",3,0,0,0,3
"7586","suggestive",2,0,0,1,3
"7587","suits",1,1,0,1,3
"7588","summer’s",1,1,1,0,3
"7589","sums",3,0,0,0,3
"7590","sunday’s",2,1,0,0,3
"7591","sunset",2,0,1,0,3
"7592","superintendent",1,1,1,0,3
"7593","supplies",1,2,0,0,3
"7594","supplying",3,0,0,0,3
"7595","surpass",0,2,0,1,3
"7596","surprisingly",3,0,0,0,3
"7597","surrendered",2,1,0,0,3
"7598","survive",3,0,0,0,3
"7599","sustaining",3,0,0,0,3
"7600","swearing",0,2,1,0,3
"7601","sweetest",1,1,1,0,3
"7602","swimming",1,1,1,0,3
"7603","swing",1,0,2,0,3
"7604","swings",1,1,1,0,3
"7605","syllable",2,1,0,0,3
"7606","systematic",1,2,0,0,3
"7607","systematically",3,0,0,0,3
"7608","taber",2,0,1,0,3
"7609","tamed",1,1,1,0,3
"7610","tangible",2,1,0,0,3
"7611","tardiness",2,1,0,0,3
"7612","taunting",1,1,1,0,3
"7613","tax",2,0,0,1,3
"7614","taxes",3,0,0,0,3
"7615","teamsters",2,1,0,0,3
"7616","teeming",1,2,0,0,3
"7617","temperate",2,1,0,0,3
"7618","tempting",2,1,0,0,3
"7619","tendencies",2,1,0,0,3
"7620","tending",2,1,0,0,3
"7621","tenfold",0,0,3,0,3
"7622","tenths",1,1,1,0,3
"7623","termination",1,1,0,1,3
"7624","terrified",1,1,1,0,3
"7625","testimonies",2,1,0,0,3
"7626","thanever",3,0,0,0,3
"7627","thanked",3,0,0,0,3
"7628","thanksgiving",1,1,1,0,3
"7629","thati",3,0,0,0,3
"7630","thatmy",3,0,0,0,3
"7631","thatthere",3,0,0,0,3
"7632","thebeginning",3,0,0,0,3
"7633","thebest",3,0,0,0,3
"7634","theborder",3,0,0,0,3
"7635","thecart",3,0,0,0,3
"7636","thechildren",3,0,0,0,3
"7637","theenterprise",3,0,0,0,3
"7638","thefamily",3,0,0,0,3
"7639","thefreedmen",3,0,0,0,3
"7640","thefuture",3,0,0,0,3
"7641","theland",3,0,0,0,3
"7642","thelast",3,0,0,0,3
"7643","them.the",3,0,0,0,3
"7644","thema",3,0,0,0,3
"7645","themany",3,0,0,0,3
"7646","themoral",3,0,0,0,3
"7647","themto",3,0,0,0,3
"7648","thename",3,0,0,0,3
"7649","thenational",3,0,0,0,3
"7650","theone",3,0,0,0,3
"7651","theonly",3,0,0,0,3
"7652","theoverseer",3,0,0,0,3
"7653","thepen",3,0,0,0,3
"7654","thepurpose",3,0,0,0,3
"7655","therebellion",3,0,0,0,3
"7656","thereto",2,1,0,0,3
"7657","theright",3,0,0,0,3
"7658","thesecond",3,0,0,0,3
"7659","thesouthern",3,0,0,0,3
"7660","thestruggle",3,0,0,0,3
"7661","thetrue",3,0,0,0,3
"7662","thewar",3,0,0,0,3
"7663","thewisdom",3,0,0,0,3
"7664","thework",3,0,0,0,3
"7665","theyare",3,0,0,0,3
"7666","theyhad",3,0,0,0,3
"7667","thicket",1,1,1,0,3
"7668","things",0,0,0,3,3
"7669","thirdly",2,1,0,0,3
"7670","thirst",1,2,0,0,3
"7671","thisrespect",3,0,0,0,3
"7672","thoughtless",1,1,1,0,3
"7673","thoughtthat",3,0,0,0,3
"7674","thraldom",2,0,1,0,3
"7675","thrall",1,2,0,0,3
"7676","thrifty",1,2,0,0,3
"7677","thunders",0,2,1,0,3
"7678","timbers",1,2,0,0,3
"7679","tis",0,3,0,0,3
"7680","tobring",3,0,0,0,3
"7681","tobuy",3,0,0,0,3
"7682","togo",3,0,0,0,3
"7683","toils",1,2,0,0,3
"7684","token",2,1,0,0,3
"7685","tomeet",3,0,0,0,3
"7686","tomyself",3,0,0,0,3
"7687","tonight",0,3,0,0,3
"7688","toour",3,0,0,0,3
"7689","tormented",0,2,1,0,3
"7690","toslavery",3,0,0,0,3
"7691","towardthe",3,0,0,0,3
"7692","tower",0,0,0,3,3
"7693","towhich",3,0,0,0,3
"7694","tranquil",1,0,1,1,3
"7695","transformation",2,1,0,0,3
"7696","traveler",1,2,0,0,3
"7697","tremont",3,0,0,0,3
"7698","tremulous",3,0,0,0,3
"7699","trespass",1,1,1,0,3
"7700","trifles",1,2,0,0,3
"7701","triple",2,1,0,0,3
"7702","trump",1,1,1,0,3
"7703","truthfulness",1,2,0,0,3
"7704","truths",1,1,1,0,3
"7705","turban",1,1,0,1,3
"7706","turbid",1,1,1,0,3
"7707","twins",1,1,1,0,3
"7708","twisted",2,1,0,0,3
"7709","ugly",3,0,0,0,3
"7710","unapproachable",1,2,0,0,3
"7711","unasked",1,1,1,0,3
"7712","unbolted",1,2,0,0,3
"7713","unchangeable",2,1,0,0,3
"7714","uncompromising",2,1,0,0,3
"7715","uncover",1,1,1,0,3
"7716","undefended",1,2,0,0,3
"7717","undergone",1,1,0,1,3
"7718","uneducated",2,1,0,0,3
"7719","unequal",1,2,0,0,3
"7720","ungrateful",3,0,0,0,3
"7721","unhappiness",2,0,1,0,3
"7722","unhesitatingly",0,1,2,0,3
"7723","unique",0,3,0,0,3
"7724","unlimited",2,1,0,0,3
"7725","unmistakable",2,1,0,0,3
"7726","unmolested",0,2,1,0,3
"7727","unpardonable",0,1,2,0,3
"7728","unpopular",2,1,0,0,3
"7729","unprepared",1,1,1,0,3
"7730","unprotected",1,2,0,0,3
"7731","unreasoning",2,1,0,0,3
"7732","unscrupulous",1,2,0,0,3
"7733","unshaken",0,2,1,0,3
"7734","unsuspecting",1,2,0,0,3
"7735","untamed",1,2,0,0,3
"7736","unused",1,1,1,0,3
"7737","unwelcome",2,1,0,0,3
"7738","unwittingly",1,2,0,0,3
"7739","up_",1,2,0,0,3
"7740","upholders",1,1,1,0,3
"7741","uppermost",2,0,1,0,3
"7742","upturned",2,1,0,0,3
"7743","urchins",0,2,1,0,3
"7744","used",0,0,0,3,3
"7745","ushered",1,1,1,0,3
"7746","vacant",1,1,1,0,3
"7747","valor",3,0,0,0,3
"7748","valves",1,1,1,0,3
"7749","vatican",0,0,0,3,3
"7750","veal",1,1,1,0,3
"7751","veins",2,1,0,0,3
"7752","verge",2,1,0,0,3
"7753","verging",2,1,0,0,3
"7754","vestments",0,0,0,3,3
"7755","vigilant",2,0,1,0,3
"7756","villainous",1,2,0,0,3
"7757","villains",1,2,0,0,3
"7758","vindicated",0,2,0,1,3
"7759","violated",0,3,0,0,3
"7760","violates",0,3,0,0,3
"7761","virgin",1,0,0,2,3
"7762","visiting",1,2,0,0,3
"7763","visitor",3,0,0,0,3
"7764","visitors",2,0,0,1,3
"7765","vocation",2,0,1,0,3
"7766","vortex",2,1,0,0,3
"7767","voters",3,0,0,0,3
"7768","vulgarity",1,2,0,0,3
"7769","wade",3,0,0,0,3
"7770","waist",1,1,1,0,3
"7771","waiter",3,0,0,0,3
"7772","wallowing",1,1,1,0,3
"7773","wars",2,1,0,0,3
"7774","wascalled",3,0,0,0,3
"7775","wascompelled",3,0,0,0,3
"7776","wasgenerally",3,0,0,0,3
"7777","wasgoing",3,0,0,0,3
"7778","wash",1,1,0,1,3
"7779","wasmy",3,0,0,0,3
"7780","wasteful",2,1,0,0,3
"7781","watchful",1,1,1,0,3
"7782","watchfulness",0,2,1,0,3
"7783","watson’s",1,1,1,0,3
"7784","weaken",2,1,0,0,3
"7785","weakened",3,0,0,0,3
"7786","weaker",2,1,0,0,3
"7787","weave",1,1,1,0,3
"7788","wecould",3,0,0,0,3
"7789","weed",1,2,0,0,3
"7790","weeds",2,1,0,0,3
"7791","weeping",0,3,0,0,3
"7792","welcomes",2,1,0,0,3
"7793","wellas",3,0,0,0,3
"7794","wentto",3,0,0,0,3
"7795","werecompelled",3,0,0,0,3
"7796","wereno",3,0,0,0,3
"7797","werenot",3,0,0,0,3
"7798","wewere",3,0,0,0,3
"7799","whale",0,1,0,2,3
"7800","whati",3,0,0,0,3
"7801","whatthey",3,0,0,0,3
"7802","wheels",2,1,0,0,3
"7803","whenthe",3,0,0,0,3
"7804","whetting",2,1,0,0,3
"7805","whichwas",3,0,0,0,3
"7806","whipper",2,1,0,0,3
"7807","whispering",2,1,0,0,3
"7808","whit",1,1,0,1,3
"7809","whose",0,0,0,3,3
"7810","whowere",3,0,0,0,3
"7811","wields",0,2,1,0,3
"7812","wildest",1,1,1,0,3
"7813","wilmington",3,0,0,0,3
"7814","wiped",1,1,1,0,3
"7815","wiry",1,2,0,0,3
"7816","wiser",2,1,0,0,3
"7817","withdrawal",2,1,0,0,3
"7818","withheld",1,1,1,0,3
"7819","withthat",3,0,0,0,3
"7820","wolfish",1,2,0,0,3
"7821","wolves",0,2,0,1,3
"7822","wonder",0,0,0,3,3
"7823","woolen",2,1,0,0,3
"7824","workin",3,0,0,0,3
"7825","workmanship",2,1,0,0,3
"7826","workof",3,0,0,0,3
"7827","wouldnot",3,0,0,0,3
"7828","wrathful",1,2,0,0,3
"7829","writhed",1,1,1,0,3
"7830","writings",3,0,0,0,3
"7831","xvi",1,2,0,0,3
"7832","xviii",1,2,0,0,3
"7833","yankees",2,1,0,0,3
"7834","yearsbefore",3,0,0,0,3
"7835","yielded",3,0,0,0,3
"7836","zion",0,3,0,0,3
"7837","_act_",1,1,0,0,2
"7838","_after_",1,1,0,0,2
"7839","_alias_",1,1,0,0,2
"7840","_all_",0,2,0,0,2
"7841","_and",1,1,0,0,2
"7842","_another",0,2,0,0,2
"7843","_anti",1,1,0,0,2
"7844","_apprenticeship",0,2,0,0,2
"7845","_are_",0,2,0,0,2
"7846","_bad_",0,2,0,0,2
"7847","_behind_",1,1,0,0,2
"7848","_black",0,0,2,0,2
"7849","_boy_",1,1,0,0,2
"7850","_by_",1,1,0,0,2
"7851","_can_",0,2,0,0,2
"7852","_cannot_",2,0,0,0,2
"7853","_chance_",0,2,0,0,2
"7854","_childhood_",0,2,0,0,2
"7855","_christian_",0,2,0,0,2
"7856","_covey",0,2,0,0,2
"7857","_crime_",1,1,0,0,2
"7858","_democrat",2,0,0,0,2
"7859","_denouncing_",1,1,0,0,2
"7860","_do_",0,2,0,0,2
"7861","_emancipate",1,1,0,0,2
"7862","_epsom",0,2,0,0,2
"7863","_equals_",1,1,0,0,2
"7864","_experience",0,2,0,0,2
"7865","_father_",0,2,0,0,2
"7866","_fiends_",1,1,0,0,2
"7867","_fight_",1,1,0,0,2
"7868","_fixed",1,1,0,0,2
"7869","_furore_",1,1,0,0,2
"7870","_generally_",1,1,0,0,2
"7871","_get",0,0,2,0,2
"7872","_good",1,1,0,0,2
"7873","_gradual",0,2,0,0,2
"7874","_great",1,0,1,0,2
"7875","_great_",2,0,0,0,2
"7876","_greek_",1,1,0,0,2
"7877","_his_",0,2,0,0,2
"7878","_holy",1,1,0,0,2
"7879","_honor_",1,1,0,0,2
"7880","_how_",0,2,0,0,2
"7881","_ill_",1,1,0,0,2
"7882","_impudence_",2,0,0,0,2
"7883","_incidents_",1,1,0,0,2
"7884","_introduced",0,2,0,0,2
"7885","_is",0,2,0,0,2
"7886","_italics_",1,1,0,0,2
"7887","_kind_",0,2,0,0,2
"7888","_legal_",1,1,0,0,2
"7889","_let",1,1,0,0,2
"7890","_liberty",0,2,0,0,2
"7891","_life_",1,1,0,0,2
"7892","_little_",0,2,0,0,2
"7893","_lived_",1,1,0,0,2
"7894","_make",1,1,0,0,2
"7895","_make_",1,1,0,0,2
"7896","_mildly_",1,1,0,0,2
"7897","_monday_",1,1,0,0,2
"7898","_money",1,1,0,0,2
"7899","_must",1,1,0,0,2
"7900","_mystery_",1,1,0,0,2
"7901","_national",2,0,0,0,2
"7902","_new_",1,1,0,0,2
"7903","_nine",1,1,0,0,2
"7904","_no_",1,1,0,0,2
"7905","_non",1,1,0,0,2
"7906","_north",2,0,0,0,2
"7907","_now_",0,2,0,0,2
"7908","_on",1,1,0,0,2
"7909","_overseer_",1,1,0,0,2
"7910","_own",0,0,2,0,2
"7911","_parentage_",0,2,0,0,2
"7912","_past_",1,1,0,0,2
"7913","_perdition_",1,1,0,0,2
"7914","_personal",0,2,0,0,2
"7915","_pity_",1,1,0,0,2
"7916","_poor",0,1,1,0,2
"7917","_practically_",1,1,0,0,2
"7918","_prejudged_",1,1,0,0,2
"7919","_present_",1,1,0,0,2
"7920","_prichard’s",0,2,0,0,2
"7921","_probable_",1,1,0,0,2
"7922","_property_",0,2,0,0,2
"7923","_put",1,1,0,0,2
"7924","_religious",0,2,0,0,2
"7925","_removed",0,2,0,0,2
"7926","_rightfully_",1,1,0,0,2
"7927","_run_",1,1,0,0,2
"7928","_sabbath_",1,1,0,0,2
"7929","_shoot",2,0,0,0,2
"7930","_singly_",1,1,0,0,2
"7931","_slaves_",1,1,0,0,2
"7932","_somebody_",1,1,0,0,2
"7933","_soured_",1,1,0,0,2
"7934","_such_",1,1,0,0,2
"7935","_sunday_",1,1,0,0,2
"7936","_that_",1,1,0,0,2
"7937","_theft_",1,1,0,0,2
"7938","_there",1,1,0,0,2
"7939","_this_",0,2,0,0,2
"7940","_thousand",1,1,0,0,2
"7941","_tie",1,1,0,0,2
"7942","_till",0,0,2,0,2
"7943","_times_",1,1,0,0,2
"7944","_to_",1,1,0,0,2
"7945","_treatment",0,2,0,0,2
"7946","_understand_",1,1,0,0,2
"7947","_various",0,2,0,0,2
"7948","_was",1,1,0,0,2
"7949","_well",1,1,0,0,2
"7950","_will_",1,1,0,0,2
"7951","_you_",1,1,0,0,2
"7952","12",0,2,0,0,2
"7953","12th",2,0,0,0,2
"7954","14",2,0,0,0,2
"7955","15",0,0,2,0,2
"7956","17",1,0,1,0,2
"7957","1818",1,0,1,0,2
"7958","1825",2,0,0,0,2
"7959","1832",0,0,2,0,2
"7960","1837",1,1,0,0,2
"7961","1840",2,0,0,0,2
"7962","1856",2,0,0,0,2
"7963","1862",2,0,0,0,2
"7964","1864",2,0,0,0,2
"7965","1876",2,0,0,0,2
"7966","224",1,1,0,0,2
"7967","28",1,0,1,0,2
"7968","4th",1,1,0,0,2
"7969","57",0,2,0,0,2
"7970","5th",1,1,0,0,2
"7971","9",0,2,0,0,2
"7972","9th",1,1,0,0,2
"7973","a_",1,1,0,0,2
"7974","abaft",2,0,0,0,2
"7975","abandonment",2,0,0,0,2
"7976","abated",1,1,0,0,2
"7977","aberdeen",1,1,0,0,2
"7978","abide",1,0,1,0,2
"7979","abiding",1,0,1,0,2
"7980","ableto",2,0,0,0,2
"7981","ably",1,0,1,0,2
"7982","abolitionists_",0,2,0,0,2
"7983","abolitionmovement",2,0,0,0,2
"7984","abominations",0,2,0,0,2
"7985","abound",0,0,2,0,2
"7986","abridge",1,1,0,0,2
"7987","abroadthat",2,0,0,0,2
"7988","absented",1,1,0,0,2
"7989","absorbed",2,0,0,0,2
"7990","abstain",1,1,0,0,2
"7991","abstraction",1,1,0,0,2
"7992","abusing",1,1,0,0,2
"7993","acceptance",1,1,0,0,2
"7994","accepting",2,0,0,0,2
"7995","accession",2,0,0,0,2
"7996","accidental",1,1,0,0,2
"7997","accountability",1,1,0,0,2
"7998","accountable",0,1,1,0,2
"7999","accusers",1,1,0,0,2
"8000","achieve",2,0,0,0,2
"8001","achild",2,0,0,0,2
"8002","acknowledgement",0,2,0,0,2
"8003","aclass",2,0,0,0,2
"8004","acommon",2,0,0,0,2
"8005","acquaintances",1,0,1,0,2
"8006","acquainting",1,1,0,0,2
"8007","activities",1,1,0,0,2
"8008","actuated",1,1,0,0,2
"8009","addto",2,0,0,0,2
"8010","ademocrat",2,0,0,0,2
"8011","adequate",0,1,1,0,2
"8012","adjourn",2,0,0,0,2
"8013","adjusting",1,1,0,0,2
"8014","adjutant",2,0,0,0,2
"8015","admirable",1,1,0,0,2
"8016","admiral",2,0,0,0,2
"8017","admiring",1,1,0,0,2
"8018","admitting",1,0,1,0,2
"8019","adoration",1,1,0,0,2
"8020","adroitly",1,1,0,0,2
"8021","advancement",0,2,0,0,2
"8022","adventure",1,1,0,0,2
"8023","adventurous",2,0,0,0,2
"8024","advertise",1,1,0,0,2
"8025","advertised",2,0,0,0,2
"8026","advisable",1,1,0,0,2
"8027","adviser",1,0,1,0,2
"8028","adze",1,1,0,0,2
"8029","afflicts",0,1,1,0,2
"8030","affray",1,1,0,0,2
"8031","africans",2,0,0,0,2
"8032","afterthe",2,0,0,0,2
"8033","agencies",2,0,0,0,2
"8034","aggravatingly",1,1,0,0,2
"8035","aggregation",0,2,0,0,2
"8036","aggressions",1,1,0,0,2
"8037","aggressor",1,1,0,0,2
"8038","agile",1,1,0,0,2
"8039","agility",1,1,0,0,2
"8040","agonizing",0,2,0,0,2
"8041","agood",2,0,0,0,2
"8042","aided",1,1,0,0,2
"8043","aiming",0,2,0,0,2
"8044","ain’t",1,1,0,0,2
"8045","aisle",1,1,0,0,2
"8046","aldermen",1,1,0,0,2
"8047","alexandrian",0,0,1,1,2
"8048","aliens",1,1,0,0,2
"8049","all_",0,2,0,0,2
"8050","all.he",2,0,0,0,2
"8051","allegations",1,1,0,0,2
"8052","allege",1,1,0,0,2
"8053","alliances",1,1,0,0,2
"8054","allmy",2,0,0,0,2
"8055","allothers",2,0,0,0,2
"8056","allowances",2,0,0,0,2
"8057","allright",2,0,0,0,2
"8058","almanac",1,1,0,0,2
"8059","almonds",1,1,0,0,2
"8060","alteration",1,1,0,0,2
"8061","amark",2,0,0,0,2
"8062","amazing",2,0,0,0,2
"8063","ambassadors",1,1,0,0,2
"8064","ambiguity",1,1,0,0,2
"8065","ambush",1,1,0,0,2
"8066","american_",1,1,0,0,2
"8067","amighty",2,0,0,0,2
"8068","ammunition",2,0,0,0,2
"8069","amnot",2,0,0,0,2
"8070","amounted",1,1,0,0,2
"8071","amy",2,0,0,0,2
"8072","analyze",0,1,1,0,2
"8073","aname",2,0,0,0,2
"8074","anarchy",2,0,0,0,2
"8075","andabroad",2,0,0,0,2
"8076","andalthough",2,0,0,0,2
"8077","andamong",2,0,0,0,2
"8078","andapproval",2,0,0,0,2
"8079","andas",2,0,0,0,2
"8080","andbeing",2,0,0,0,2
"8081","andblood",2,0,0,0,2
"8082","andcarry",2,0,0,0,2
"8083","andcities",2,0,0,0,2
"8084","andconsideration",2,0,0,0,2
"8085","andcould",2,0,0,0,2
"8086","anddeath",2,0,0,0,2
"8087","andeasily",2,0,0,0,2
"8088","andespecially",2,0,0,0,2
"8089","andformed",2,0,0,0,2
"8090","andfree",2,0,0,0,2
"8091","andfreedom",2,0,0,0,2
"8092","andits",2,0,0,0,2
"8093","andmeasures",2,0,0,0,2
"8094","andmortification",2,0,0,0,2
"8095","andmurderers",2,0,0,0,2
"8096","andmyself",2,0,0,0,2
"8097","andour",2,0,0,0,2
"8098","andover",2,0,0,0,2
"8099","andperseverance",2,0,0,0,2
"8100","andpolitical",2,0,0,0,2
"8101","andpublic",2,0,0,0,2
"8102","andremained",2,0,0,0,2
"8103","andself",2,0,0,0,2
"8104","andselfish",2,0,0,0,2
"8105","andspace",2,0,0,0,2
"8106","andtelling",2,0,0,0,2
"8107","andthough",2,0,0,0,2
"8108","andtrue",2,0,0,0,2
"8109","andwhen",2,0,0,0,2
"8110","andwhere",2,0,0,0,2
"8111","andwherever",2,0,0,0,2
"8112","andwho",2,0,0,0,2
"8113","andwith",2,0,0,0,2
"8114","angelina",2,0,0,0,2
"8115","animates",1,1,0,0,2
"8116","animus",1,1,0,0,2
"8117","aninterest",2,0,0,0,2
"8118","annihilating",1,1,0,0,2
"8119","annoyed",0,2,0,0,2
"8120","anopportunity",2,0,0,0,2
"8121","answerto",2,0,0,0,2
"8122","antagonistic",0,2,0,0,2
"8123","anthem",2,0,0,0,2
"8124","anticipation",1,1,0,0,2
"8125","anticipations",0,2,0,0,2
"8126","antidote",1,1,0,0,2
"8127","antiquities",0,1,0,1,2
"8128","antislavery",0,2,0,0,2
"8129","anyother",2,0,0,0,2
"8130","anyrate",2,0,0,0,2
"8131","apartment",1,1,0,0,2
"8132","aplace",2,0,0,0,2
"8133","apologists",1,1,0,0,2
"8134","apologize",0,2,0,0,2
"8135","apowerful",2,0,0,0,2
"8136","appenines",0,0,0,2,2
"8137","applauded",2,0,0,0,2
"8138","apple",0,1,1,0,2
"8139","appointing",1,0,1,0,2
"8140","appraisers",1,1,0,0,2
"8141","appreciates",1,1,0,0,2
"8142","appreciating",2,0,0,0,2
"8143","apprehend",1,1,0,0,2
"8144","apprehensive",1,0,1,0,2
"8145","approaches",0,1,0,1,2
"8146","appropriately",0,1,1,0,2
"8147","appropriating",1,1,0,0,2
"8148","appropriations",1,1,0,0,2
"8149","aptness",1,1,0,0,2
"8150","apublic",2,0,0,0,2
"8151","arbors",1,1,0,0,2
"8152","archetectural",0,0,0,2,2
"8153","archetecture",0,0,0,2,2
"8154","architecture",0,0,0,2,2
"8155","aregenerally",2,0,0,0,2
"8156","arisen",2,0,0,0,2
"8157","aristocracies",1,1,0,0,2
"8158","armory",1,0,1,0,2
"8159","aromatic",1,1,0,0,2
"8160","aroused",0,2,0,0,2
"8161","arraying",1,1,0,0,2
"8162","artfulness",1,1,0,0,2
"8163","arthur",2,0,0,0,2
"8164","articulate",1,1,0,0,2
"8165","artist",0,0,0,2,2
"8166","artistic",1,1,0,0,2
"8167","ascended",0,1,0,1,2
"8168","ascribed",1,1,0,0,2
"8169","aserious",2,0,0,0,2
"8170","ashing",0,0,0,2,2
"8171","aship",2,0,0,0,2
"8172","aside",0,0,0,2,2
"8173","asimilar",2,0,0,0,2
"8174","asone",2,0,0,0,2
"8175","asparagus",1,1,0,0,2
"8176","aspects",0,2,0,0,2
"8177","aspersions",1,1,0,0,2
"8178","aspirants",2,0,0,0,2
"8179","aspire",1,1,0,0,2
"8180","aspossible",2,0,0,0,2
"8181","assassin",2,0,0,0,2
"8182","assaulting",1,1,0,0,2
"8183","assembling",1,0,0,1,2
"8184","assent",1,1,0,0,2
"8185","assents",0,2,0,0,2
"8186","asserter",1,1,0,0,2
"8187","asserts",1,1,0,0,2
"8188","assistedby",2,0,0,0,2
"8189","assumption",2,0,0,0,2
"8190","asthey",2,0,0,0,2
"8191","ata",2,0,0,0,2
"8192","atfirst",2,0,0,0,2
"8193","atheism",1,1,0,0,2
"8194","atime",2,0,0,0,2
"8195","atolerably",2,0,0,0,2
"8196","atrocity",0,1,1,0,2
"8197","atsuch",2,0,0,0,2
"8198","attained_",0,2,0,0,2
"8199","attaining",0,2,0,0,2
"8200","attendant",1,1,0,0,2
"8201","attends",0,2,0,0,2
"8202","attentionto",2,0,0,0,2
"8203","atthat",2,0,0,0,2
"8204","attract",2,0,0,0,2
"8205","atwhich",2,0,0,0,2
"8206","audiences",1,1,0,0,2
"8207","auditory",0,1,1,0,2
"8208","auntkaty",2,0,0,0,2
"8209","aunts",0,2,0,0,2
"8210","australia",0,0,0,2,2
"8211","authenticity",1,1,0,0,2
"8212","authoress",2,0,0,0,2
"8213","authorize",1,1,0,0,2
"8214","autobiography",0,2,0,0,2
"8215","avails",1,1,0,0,2
"8216","avenues",1,1,0,0,2
"8217","average",1,0,1,0,2
"8218","aview",2,0,0,0,2
"8219","avocation",1,1,0,0,2
"8220","avowed",2,0,0,0,2
"8221","avowing",0,1,1,0,2
"8222","await",1,1,0,0,2
"8223","awakened_",0,2,0,0,2
"8224","awakens",1,1,0,0,2
"8225","awarded",2,0,0,0,2
"8226","axle",1,1,0,0,2
"8227","backslidden",0,2,0,0,2
"8228","backward",1,1,0,0,2
"8229","backwoodsman",2,0,0,0,2
"8230","badge",1,1,0,0,2
"8231","baffle",2,0,0,0,2
"8232","baffled",1,1,0,0,2
"8233","bagger",2,0,0,0,2
"8234","bake",1,1,0,0,2
"8235","baking",1,1,0,0,2
"8236","balanced",1,1,0,0,2
"8237","ballast",1,1,0,0,2
"8238","balm",1,1,0,0,2
"8239","baltimore_",0,2,0,0,2
"8240","baltimore.i",2,0,0,0,2
"8241","banish",2,0,0,0,2
"8242","banished",1,1,0,0,2
"8243","banishment",1,0,1,0,2
"8244","banners",1,1,0,0,2
"8245","baptism",2,0,0,0,2
"8246","baptist",2,0,0,0,2
"8247","baptize",2,0,0,0,2
"8248","barefaced",1,1,0,0,2
"8249","barely",0,0,2,0,2
"8250","bargained",1,1,0,0,2
"8251","baronial",1,1,0,0,2
"8252","bars",1,1,0,0,2
"8253","baseness",0,1,1,0,2
"8254","baser",1,1,0,0,2
"8255","bases",2,0,0,0,2
"8256","basest",0,1,1,0,2
"8257","bated",1,1,0,0,2
"8258","battled",2,0,0,0,2
"8259","bea",2,0,0,0,2
"8260","beach",1,1,0,0,2
"8261","beaming",0,1,1,0,2
"8262","beans",1,1,0,0,2
"8263","bearers",1,1,0,0,2
"8264","beater",1,1,0,0,2
"8265","became",0,0,0,2,2
"8266","beckoning",0,1,1,0,2
"8267","bedside",2,0,0,0,2
"8268","bedsteads",0,2,0,0,2
"8269","beeninvited",2,0,0,0,2
"8270","beets",1,1,0,0,2
"8271","beforeme",2,0,0,0,2
"8272","beforemy",2,0,0,0,2
"8273","befriend",1,0,1,0,2
"8274","beganto",2,0,0,0,2
"8275","beget",0,2,0,0,2
"8276","beggars",1,1,0,0,2
"8277","begged",2,0,0,0,2
"8278","beinga",2,0,0,0,2
"8279","believedin",2,0,0,0,2
"8280","believethat",2,0,0,0,2
"8281","bells",0,1,0,1,2
"8282","beneaththe",2,0,0,0,2
"8283","benighted",1,0,0,1,2
"8284","benj",2,0,0,0,2
"8285","beprepared",2,0,0,0,2
"8286","beready",2,0,0,0,2
"8287","bereavement",2,0,0,0,2
"8288","beseech",1,1,0,0,2
"8289","besought",2,0,0,0,2
"8290","betaught",2,0,0,0,2
"8291","betide",0,1,1,0,2
"8292","betrayed_",1,1,0,0,2
"8293","bets",0,1,1,0,2
"8294","bevalued",2,0,0,0,2
"8295","beverly",1,1,0,0,2
"8296","beyond",0,0,0,2,2
"8297","bibb",1,1,0,0,2
"8298","bid",0,2,0,0,2
"8299","bidding",1,1,0,0,2
"8300","bids",0,2,0,0,2
"8301","binds",1,1,0,0,2
"8302","biting",0,2,0,0,2
"8303","blackbirds",2,0,0,0,2
"8304","blacks_",1,1,0,0,2
"8305","blew",0,0,2,0,2
"8306","blinded",1,1,0,0,2
"8307","blissful",1,1,0,0,2
"8308","blistered",2,0,0,0,2
"8309","bllelock",0,0,0,2,2
"8310","blooded",2,0,0,0,2
"8311","bloods",1,1,0,0,2
"8312","bludgeons",2,0,0,0,2
"8313","blunt",0,1,1,0,2
"8314","boardof",2,0,0,0,2
"8315","boards",1,1,0,0,2
"8316","boastfully",1,1,0,0,2
"8317","boatman",2,0,0,0,2
"8318","boisterous",1,1,0,0,2
"8319","bony",1,1,0,0,2
"8320","borrow",2,0,0,0,2
"8321","bottle",1,1,0,0,2
"8322","boundlessness",1,1,0,0,2
"8323","bouquet",2,0,0,0,2
"8324","bouquets",2,0,0,0,2
"8325","bowly’s",1,1,0,0,2
"8326","brandings",0,1,1,0,2
"8327","brandishing",1,1,0,0,2
"8328","bravado",1,1,0,0,2
"8329","bravery",2,0,0,0,2
"8330","breakers",1,1,0,0,2
"8331","breastbone",0,0,2,0,2
"8332","breasts",1,1,0,0,2
"8333","breathless",0,0,0,2,2
"8334","bred",1,1,0,0,2
"8335","breed",0,1,0,1,2
"8336","breeder_",0,1,1,0,2
"8337","breeds",1,1,0,0,2
"8338","brev",1,1,0,0,2
"8339","bribes",0,2,0,0,2
"8340","bridges",1,1,0,0,2
"8341","brig",1,1,0,0,2
"8342","brigade",2,0,0,0,2
"8343","briggs",1,1,0,0,2
"8344","brightening",1,0,1,0,2
"8345","britain_",0,2,0,0,2
"8346","broiling",1,1,0,0,2
"8347","bronze",1,0,0,1,2
"8348","brood",0,2,0,0,2
"8349","brooding",1,1,0,0,2
"8350","brother’s",0,1,1,0,2
"8351","brougham",2,0,0,0,2
"8352","brownish",1,1,0,0,2
"8353","browns",2,0,0,0,2
"8354","brownwas",2,0,0,0,2
"8355","bruff",2,0,0,0,2
"8356","brutehood",1,1,0,0,2
"8357","brutes",0,1,1,0,2
"8358","brutification",1,1,0,0,2
"8359","brutual",0,2,0,0,2
"8360","buds",1,1,0,0,2
"8361","bully",1,1,0,0,2
"8362","bundle",1,1,0,0,2
"8363","bunker",2,0,0,0,2
"8364","buoyant",1,1,0,0,2
"8365","burdensome",1,1,0,0,2
"8366","bushes",1,1,0,0,2
"8367","busily",1,1,0,0,2
"8368","bust",2,0,0,0,2
"8369","butchered",1,1,0,0,2
"8370","butfrom",2,0,0,0,2
"8371","buthe",2,0,0,0,2
"8372","butmy",2,0,0,0,2
"8373","butthey",2,0,0,0,2
"8374","butwas",2,0,0,0,2
"8375","byhim",2,0,0,0,2
"8376","byhis",2,0,0,0,2
"8377","byits",2,0,0,0,2
"8378","bythem",2,0,0,0,2
"8379","cab",1,1,0,0,2
"8380","cæsar",2,0,0,0,2
"8381","cage",1,1,0,0,2
"8382","calamitous",1,1,0,0,2
"8383","calming",1,1,0,0,2
"8384","camel",0,0,2,0,2
"8385","camenear",2,0,0,0,2
"8386","campmeetings",0,1,0,1,2
"8387","candor",1,0,1,0,2
"8388","canoeadrift",2,0,0,0,2
"8389","canoes",1,1,0,0,2
"8390","cantelopes",1,1,0,0,2
"8391","canvassed",1,1,0,0,2
"8392","capacities",0,2,0,0,2
"8393","caper",1,1,0,0,2
"8394","capped",1,0,0,1,2
"8395","captains",2,0,0,0,2
"8396","captainthomas",2,0,0,0,2
"8397","captious",1,1,0,0,2
"8398","captivating",0,2,0,0,2
"8399","capturing",0,2,0,0,2
"8400","capuchin",0,0,0,2,2
"8401","cardinal",1,1,0,0,2
"8402","cardinals",0,0,0,2,2
"8403","caricatured",1,1,0,0,2
"8404","caring",1,1,0,0,2
"8405","carpets",1,1,0,0,2
"8406","carrion",1,1,0,0,2
"8407","cartwright",1,1,0,0,2
"8408","cass",2,0,0,0,2
"8409","casting",1,1,0,0,2
"8410","castor",1,1,0,0,2
"8411","casualties",1,1,0,0,2
"8412","catharines",2,0,0,0,2
"8413","cats",1,1,0,0,2
"8414","caucasus",0,2,0,0,2
"8415","cauliflower",1,1,0,0,2
"8416","celebrations",1,0,0,1,2
"8417","celery",1,1,0,0,2
"8418","cellar",1,1,0,0,2
"8419","cemetary",0,0,0,2,2
"8420","censured",0,1,1,0,2
"8421","census",2,0,0,0,2
"8422","ceremonious",1,1,0,0,2
"8423","chagrined",1,1,0,0,2
"8424","chalk",0,1,1,0,2
"8425","chamber",1,1,0,0,2
"8426","champion",1,0,1,0,2
"8427","channel",0,2,0,0,2
"8428","chanting",1,1,0,0,2
"8429","chargeable",0,2,0,0,2
"8430","chargeof",2,0,0,0,2
"8431","charlestown",2,0,0,0,2
"8432","charmless",0,1,1,0,2
"8433","chastity",1,1,0,0,2
"8434","chatham’s",1,1,0,0,2
"8435","chattelhood",1,1,0,0,2
"8436","cheated",1,1,0,0,2
"8437","cheeked",1,1,0,0,2
"8438","cheeks",1,0,0,1,2
"8439","chewing",1,1,0,0,2
"8440","chicago",1,1,0,0,2
"8441","childish",1,1,0,0,2
"8442","childrenof",2,0,0,0,2
"8443","chime",0,1,1,0,2
"8444","chinaman",2,0,0,0,2
"8445","chivalrous",2,0,0,0,2
"8446","chivalry",1,1,0,0,2
"8447","choke",0,1,1,0,2
"8448","choptank",0,2,0,0,2
"8449","christendom",1,1,0,0,2
"8450","cicero",0,0,0,2,2
"8451","cinder",1,1,0,0,2
"8452","circumspect",1,1,0,0,2
"8453","circumstantial",1,1,0,0,2
"8454","circumvented",1,1,0,0,2
"8455","circumventing",1,1,0,0,2
"8456","citadel",1,0,0,1,2
"8457","cite",0,2,0,0,2
"8458","citizens_",2,0,0,0,2
"8459","cityof",2,0,0,0,2
"8460","claiming",1,1,0,0,2
"8461","clams",0,2,0,0,2
"8462","clank",1,1,0,0,2
"8463","classified",1,1,0,0,2
"8464","claws",1,1,0,0,2
"8465","cleaner",1,1,0,0,2
"8466","clearer",0,1,1,0,2
"8467","clergy",1,1,0,0,2
"8468","clerk’s",0,1,1,0,2
"8469","climbed",1,0,0,1,2
"8470","climes",1,1,0,0,2
"8471","cline",1,1,0,0,2
"8472","clue",1,1,0,0,2
"8473","clung",1,1,0,0,2
"8474","cluster",1,1,0,0,2
"8475","coachmen",1,1,0,0,2
"8476","coating",1,1,0,0,2
"8477","coats",1,0,1,0,2
"8478","cobb",2,0,0,0,2
"8479","codes",1,1,0,0,2
"8480","coffee",1,1,0,0,2
"8481","coincidence",1,1,0,0,2
"8482","col.lloyd",2,0,0,0,2
"8483","col.lloyd’s",2,0,0,0,2
"8484","coldness",1,1,0,0,2
"8485","collecting",0,2,0,0,2
"8486","collection",1,1,0,0,2
"8487","collision",1,1,0,0,2
"8488","coloredsoldiers",2,0,0,0,2
"8489","combe",2,0,0,0,2
"8490","cometo",2,0,0,0,2
"8491","commandingobject",2,0,0,0,2
"8492","commence",0,1,1,0,2
"8493","commendation",1,1,0,0,2
"8494","commends",0,1,0,1,2
"8495","commissioner",2,0,0,0,2
"8496","commodious",1,1,0,0,2
"8497","commodity",0,2,0,0,2
"8498","commonwealth",2,0,0,0,2
"8499","communicated",2,0,0,0,2
"8500","communications",1,1,0,0,2
"8501","communistic",2,0,0,0,2
"8502","communities",1,1,0,0,2
"8503","compassionated",1,1,0,0,2
"8504","compels",1,0,1,0,2
"8505","compensated",0,2,0,0,2
"8506","complains",0,1,1,0,2
"8507","completed",1,1,0,0,2
"8508","completing",1,1,0,0,2
"8509","complicated",1,1,0,0,2
"8510","complimentary",2,0,0,0,2
"8511","composition",2,0,0,0,2
"8512","comprehending",1,1,0,0,2
"8513","concealments",1,1,0,0,2
"8514","concedes",1,1,0,0,2
"8515","conceding",1,1,0,0,2
"8516","concentration",1,1,0,0,2
"8517","concession",2,0,0,0,2
"8518","concessions",2,0,0,0,2
"8519","conclude",1,0,1,0,2
"8520","conclusive",2,0,0,0,2
"8521","condign",1,1,0,0,2
"8522","conditionof",2,0,0,0,2
"8523","conducting",1,1,0,0,2
"8524","confederated",1,1,0,0,2
"8525","conference",1,1,0,0,2
"8526","confidencein",2,0,0,0,2
"8527","confidential",2,0,0,0,2
"8528","confinement",1,0,1,0,2
"8529","confining",1,1,0,0,2
"8530","confirms",0,2,0,0,2
"8531","conflicting",1,1,0,0,2
"8532","congratulating",1,1,0,0,2
"8533","congregate",2,0,0,0,2
"8534","congressmen",2,0,0,0,2
"8535","conjurer",1,1,0,0,2
"8536","conkling",2,0,0,0,2
"8537","connect",2,0,0,0,2
"8538","connectedwith",2,0,0,0,2
"8539","consenting",1,1,0,0,2
"8540","consistency",1,1,0,0,2
"8541","consistently",1,0,1,0,2
"8542","consolate",0,0,0,2,2
"8543","console",0,1,1,0,2
"8544","conspirators",1,1,0,0,2
"8545","conspired",0,1,1,0,2
"8546","constituting",1,1,0,0,2
"8547","constructions",1,1,0,0,2
"8548","construed",0,2,0,0,2
"8549","consult",2,0,0,0,2
"8550","consumer",1,1,0,0,2
"8551","consumers",1,1,0,0,2
"8552","contagion",1,1,0,0,2
"8553","containing",0,0,0,2,2
"8554","contemptuous",1,1,0,0,2
"8555","contiguity",1,1,0,0,2
"8556","continent",2,0,0,0,2
"8557","contingencies",0,2,0,0,2
"8558","continuing",0,1,1,0,2
"8559","contraband",2,0,0,0,2
"8560","contradicts",1,1,0,0,2
"8561","contrasting",1,1,0,0,2
"8562","contributing",0,2,0,0,2
"8563","contributions",1,1,0,0,2
"8564","convenience",1,1,0,0,2
"8565","conveniences",1,1,0,0,2
"8566","conversant",1,1,0,0,2
"8567","converting",0,1,1,0,2
"8568","converts",1,0,1,0,2
"8569","conveyed",1,1,0,0,2
"8570","conveying",1,1,0,0,2
"8571","convict",2,0,0,0,2
"8572","convincing",1,1,0,0,2
"8573","cooped",1,1,0,0,2
"8574","coopering",0,1,1,0,2
"8575","copious",1,1,0,0,2
"8576","coran",0,0,0,2,2
"8577","cords",0,1,1,0,2
"8578","corinthian",2,0,0,0,2
"8579","corners",1,1,0,0,2
"8580","cornish",1,1,0,0,2
"8581","cornmeal",1,1,0,0,2
"8582","coroner’s",1,1,0,0,2
"8583","costume",1,0,0,1,2
"8584","couldhave",2,0,0,0,2
"8585","couldsay",2,0,0,0,2
"8586","counteract",1,1,0,0,2
"8587","counters",2,0,0,0,2
"8588","countryand",2,0,0,0,2
"8589","couple",1,1,0,0,2
"8590","courses",1,1,0,0,2
"8591","courtesies",1,1,0,0,2
"8592","courtship",1,1,0,0,2
"8593","cousins",0,2,0,0,2
"8594","covert",1,1,0,0,2
"8595","cowed",1,1,0,0,2
"8596","cower",1,1,0,0,2
"8597","cowskins",0,2,0,0,2
"8598","crack",0,1,1,0,2
"8599","crackers",1,1,0,0,2
"8600","cracks",1,1,0,0,2
"8601","crafts",0,2,0,0,2
"8602","cramped",0,1,0,1,2
"8603","crash",0,2,0,0,2
"8604","crashy",1,1,0,0,2
"8605","cream",1,1,0,0,2
"8606","creep",1,1,0,0,2
"8607","criminals",1,1,0,0,2
"8608","crisped",1,1,0,0,2
"8609","critically",1,1,0,0,2
"8610","criticism",2,0,0,0,2
"8611","criticisms",1,1,0,0,2
"8612","crocus",1,1,0,0,2
"8613","crofts",1,0,0,1,2
"8614","crops",1,1,0,0,2
"8615","crouching",0,1,1,0,2
"8616","crown",0,1,1,0,2
"8617","crueltyand",2,0,0,0,2
"8618","crust",1,1,0,0,2
"8619","cultivating",1,1,0,0,2
"8620","curly",1,1,0,0,2
"8621","curran",1,1,0,0,2
"8622","curtain",1,1,0,0,2
"8623","customary",1,1,0,0,2
"8624","cuts",0,2,0,0,2
"8625","dairies",1,1,0,0,2
"8626","dairy",1,1,0,0,2
"8627","dallas",2,0,0,0,2
"8628","damaging",1,0,0,1,2
"8629","damnation",0,1,1,0,2
"8630","damped",1,1,0,0,2
"8631","dan",2,0,0,0,2
"8632","dana",2,0,0,0,2
"8633","darby",1,1,0,0,2
"8634","darkand",2,0,0,0,2
"8635","darling",1,1,0,0,2
"8636","dastardly",1,1,0,0,2
"8637","daunt",1,1,0,0,2
"8638","day.i",2,0,0,0,2
"8639","day.this",2,0,0,0,2
"8640","dayof",2,0,0,0,2
"8641","dazzle",0,1,0,1,2
"8642","deacon",1,1,0,0,2
"8643","dead_",1,1,0,0,2
"8644","deadened",1,1,0,0,2
"8645","dearer",1,1,0,0,2
"8646","deathof",2,0,0,0,2
"8647","debased",1,1,0,0,2
"8648","debates",1,1,0,0,2
"8649","debtor",2,0,0,0,2
"8650","deceivers",1,1,0,0,2
"8651","decisions",1,1,0,0,2
"8652","declares",0,2,0,0,2
"8653","declaring",2,0,0,0,2
"8654","dedicated",1,1,0,0,2
"8655","deduce",1,1,0,0,2
"8656","deepening",0,2,0,0,2
"8657","defaced",1,1,0,0,2
"8658","defaces",0,1,1,0,2
"8659","defenseless",0,2,0,0,2
"8660","defensive",1,1,0,0,2
"8661","defies",1,1,0,0,2
"8662","deformity",1,0,0,1,2
"8663","dejean",0,0,0,2,2
"8664","delegations",2,0,0,0,2
"8665","delicacy",1,1,0,0,2
"8666","delicious",1,1,0,0,2
"8667","delighting",0,1,0,1,2
"8668","demandedby",2,0,0,0,2
"8669","democracy",0,2,0,0,2
"8670","democraticparty",2,0,0,0,2
"8671","demolished",1,1,0,0,2
"8672","demonstrations",0,1,1,0,2
"8673","demoralizing",1,1,0,0,2
"8674","denizens",1,1,0,0,2
"8675","denominations",1,0,0,1,2
"8676","departments",1,1,0,0,2
"8677","depending",1,1,0,0,2
"8678","deplorably",1,1,0,0,2
"8679","deplore",1,1,0,0,2
"8680","depositors",2,0,0,0,2
"8681","deprivation",1,1,0,0,2
"8682","deputy",1,1,0,0,2
"8683","dereliction",1,1,0,0,2
"8684","dervishers",0,0,0,2,2
"8685","descended",0,2,0,0,2
"8686","descending",1,1,0,0,2
"8687","descry",1,1,0,0,2
"8688","deserves",0,2,0,0,2
"8689","designated",1,1,0,0,2
"8690","desirableness",1,1,0,0,2
"8691","desiring",1,0,1,0,2
"8692","despairing",1,1,0,0,2
"8693","despicable",1,1,0,0,2
"8694","destination",0,1,0,1,2
"8695","destinedto",2,0,0,0,2
"8696","detected",1,1,0,0,2
"8697","determines",1,1,0,0,2
"8698","deterring",1,1,0,0,2
"8699","detract",0,2,0,0,2
"8700","detracted",1,1,0,0,2
"8701","devil_",1,1,0,0,2
"8702","devise",2,0,0,0,2
"8703","devised",0,1,1,0,2
"8704","diabolical",0,1,1,0,2
"8705","diameter",1,1,0,0,2
"8706","dictated",2,0,0,0,2
"8707","dictates",1,1,0,0,2
"8708","didthe",2,0,0,0,2
"8709","die_",1,1,0,0,2
"8710","diet",1,1,0,0,2
"8711","difficultto",2,0,0,0,2
"8712","digressing",0,1,1,0,2
"8713","diminishing",1,1,0,0,2
"8714","diminution",1,1,0,0,2
"8715","dipping",1,1,0,0,2
"8716","directing",0,2,0,0,2
"8717","disappoint",1,1,0,0,2
"8718","disapprobation",2,0,0,0,2
"8719","disapproval",1,0,1,0,2
"8720","disapproved",2,0,0,0,2
"8721","disaster",1,1,0,0,2
"8722","disbanded",2,0,0,0,2
"8723","discerned",2,0,0,0,2
"8724","discerning",1,1,0,0,2
"8725","disciples",0,2,0,0,2
"8726","disclosing",1,1,0,0,2
"8727","discord",1,0,1,0,2
"8728","discourses",0,2,0,0,2
"8729","discover",2,0,0,0,2
"8730","discovering",2,0,0,0,2
"8731","disdaining",0,2,0,0,2
"8732","disease",2,0,0,0,2
"8733","disenthrall",0,2,0,0,2
"8734","disfigured",1,1,0,0,2
"8735","disguises",2,0,0,0,2
"8736","disgusted",1,1,0,0,2
"8737","dishearten",1,1,0,0,2
"8738","disheartening",2,0,0,0,2
"8739","dishonor",1,1,0,0,2
"8740","dislikes",0,2,0,0,2
"8741","dislodge",2,0,0,0,2
"8742","dismal",1,1,0,0,2
"8743","dismissed",0,2,0,0,2
"8744","disobeyed",0,0,2,0,2
"8745","dispatched",2,0,0,0,2
"8746","dispensed",0,1,1,0,2
"8747","dispersed",2,0,0,0,2
"8748","displeased",0,1,0,1,2
"8749","disposer",1,1,0,0,2
"8750","disposing",1,1,0,0,2
"8751","disprove",0,2,0,0,2
"8752","disproved",1,0,1,0,2
"8753","disquiet",0,2,0,0,2
"8754","disraeli",2,0,0,0,2
"8755","disrepute",1,1,0,0,2
"8756","dissolve",1,1,0,0,2
"8757","dissolving",1,1,0,0,2
"8758","distillment",1,1,0,0,2
"8759","distinguishing",2,0,0,0,2
"8760","districts",2,0,0,0,2
"8761","distrustful",1,1,0,0,2
"8762","disturbance",1,1,0,0,2
"8763","disturber",1,1,0,0,2
"8764","disunion",0,2,0,0,2
"8765","ditch",1,1,0,0,2
"8766","divers",1,1,0,0,2
"8767","divide",1,0,1,0,2
"8768","divulged",1,1,0,0,2
"8769","dixon",1,1,0,0,2
"8770","dollars_",2,0,0,0,2
"8771","domains",1,1,0,0,2
"8772","dominions",1,1,0,0,2
"8773","doso",2,0,0,0,2
"8774","dotted",1,1,0,0,2
"8775","douglass’s",0,2,0,0,2
"8776","downcast",1,1,0,0,2
"8777","downstairs",1,1,0,0,2
"8778","downward",0,1,1,0,2
"8779","downy",1,1,0,0,2
"8780","dozenwords",2,0,0,0,2
"8781","dragon",1,1,0,0,2
"8782","draining",1,1,0,0,2
"8783","drains",1,1,0,0,2
"8784","drawbridge",1,0,1,0,2
"8785","draws",1,1,0,0,2
"8786","dreamer",1,1,0,0,2
"8787","drenching",1,1,0,0,2
"8788","dressing",1,1,0,0,2
"8789","dripping",0,1,1,0,2
"8790","drives",0,2,0,0,2
"8791","drover",0,2,0,0,2
"8792","drovers",0,1,1,0,2
"8793","drums",1,1,0,0,2
"8794","dues",1,1,0,0,2
"8795","dueto",2,0,0,0,2
"8796","dumas",0,1,0,1,2
"8797","duncan",1,1,0,0,2
"8798","durgan",1,1,0,0,2
"8799","duties_",0,2,0,0,2
"8800","dutiesof",2,0,0,0,2
"8801","dyspepsia",1,1,0,0,2
"8802","eachother",2,0,0,0,2
"8803","easterly",0,1,1,0,2
"8804","eaton",1,1,0,0,2
"8805","ecstacy",1,1,0,0,2
"8806","ecstatic",1,1,0,0,2
"8807","editor’s",0,2,0,0,2
"8808","edwardlloyd",2,0,0,0,2
"8809","efficiently",1,1,0,0,2
"8810","egotism",1,1,0,0,2
"8811","egotistical",0,1,1,0,2
"8812","eight",0,0,0,2,2
"8813","elaborately",1,1,0,0,2
"8814","elders",1,1,0,0,2
"8815","elective",2,0,0,0,2
"8816","electoral",2,0,0,0,2
"8817","elegance",1,1,0,0,2
"8818","eleventh",2,0,0,0,2
"8819","ellen",1,1,0,0,2
"8820","emanate",1,1,0,0,2
"8821","emanating",1,1,0,0,2
"8822","emancipates",1,1,0,0,2
"8823","embarrassed",2,0,0,0,2
"8824","embodied",1,1,0,0,2
"8825","embodiment",1,1,0,0,2
"8826","embowered",1,1,0,0,2
"8827","eminently",2,0,0,0,2
"8828","enables",1,1,0,0,2
"8829","enacting",1,1,0,0,2
"8830","enactments",0,2,0,0,2
"8831","enacts",1,1,0,0,2
"8832","encouragedby",2,0,0,0,2
"8833","endanger",2,0,0,0,2
"8834","endeared",0,1,1,0,2
"8835","enemy’s",1,1,0,0,2
"8836","enervating",1,1,0,0,2
"8837","enfeebled",1,1,0,0,2
"8838","engrossing",0,2,0,0,2
"8839","enhance",0,1,1,0,2
"8840","enhanced",1,1,0,0,2
"8841","enigma",1,1,0,0,2
"8842","enjoined",1,1,0,0,2
"8843","enjoys",0,1,1,0,2
"8844","enkindling",1,1,0,0,2
"8845","enlighten",0,2,0,0,2
"8846","enlightening",0,0,2,0,2
"8847","enterprises",0,2,0,0,2
"8848","entertainment",0,1,1,0,2
"8849","entertainments",1,1,0,0,2
"8850","entitle",1,1,0,0,2
"8851","entreaties",0,1,1,0,2
"8852","entreating",1,0,1,0,2
"8853","enviable",1,1,0,0,2
"8854","envious",1,1,0,0,2
"8855","environments",1,1,0,0,2
"8856","episcopal",1,1,0,0,2
"8857","epsom",2,0,0,0,2
"8858","equaled",1,1,0,0,2
"8859","equalto",2,0,0,0,2
"8860","equip",2,0,0,0,2
"8861","ere",0,2,0,0,2
"8862","erie",2,0,0,0,2
"8863","escape.i",2,0,0,0,2
"8864","escorted",2,0,0,0,2
"8865","especially",0,0,0,2,2
"8866","espoused",1,1,0,0,2
"8867","essentially",0,1,1,0,2
"8868","estherwas",2,0,0,0,2
"8869","estimated",1,1,0,0,2
"8870","etiquette",1,1,0,0,2
"8871","eulogies",2,0,0,0,2
"8872","european",0,1,0,1,2
"8873","evento",2,0,0,0,2
"8874","everglades",1,1,0,0,2
"8875","evincing",0,1,1,0,2
"8876","ewing",1,0,0,1,2
"8877","ewry",1,1,0,0,2
"8878","exaggerations",0,1,1,0,2
"8879","exceed",1,0,0,1,2
"8880","exceeded",0,0,1,1,2
"8881","except",0,0,0,2,2
"8882","excepted",1,1,0,0,2
"8883","exclamations",1,1,0,0,2
"8884","exclude",2,0,0,0,2
"8885","excludes",1,1,0,0,2
"8886","excuses",1,1,0,0,2
"8887","execrable",0,1,1,0,2
"8888","execrate",0,1,1,0,2
"8889","executioner",1,1,0,0,2
"8890","executivemansion",2,0,0,0,2
"8891","exemplary",0,2,0,0,2
"8892","exempt",0,1,0,1,2
"8893","exhaustion",1,1,0,0,2
"8894","exhaustive",2,0,0,0,2
"8895","exhorter",0,1,1,0,2
"8896","existing",2,0,0,0,2
"8897","expatriation",1,1,0,0,2
"8898","expedients",1,1,0,0,2
"8899","expeditions",2,0,0,0,2
"8900","expensive",1,0,0,1,2
"8901","experiencing",1,1,0,0,2
"8902","expert",1,1,0,0,2
"8903","explaining",0,0,2,0,2
"8904","exposures",0,1,1,0,2
"8905","expressing",2,0,0,0,2
"8906","extant",0,1,0,1,2
"8907","extenuation",1,1,0,0,2
"8908","external",0,1,0,1,2
"8909","extinct",1,0,1,0,2
"8910","extinguished",1,1,0,0,2
"8911","eyeball",0,1,1,0,2
"8912","eyed",0,2,0,0,2
"8913","f.butler",2,0,0,0,2
"8914","fabled",1,1,0,0,2
"8915","fabulous",1,1,0,0,2
"8916","face",0,0,0,2,2
"8917","faces",0,0,0,2,2
"8918","facility",2,0,0,0,2
"8919","faction",2,0,0,0,2
"8920","fade",0,0,0,2,2
"8921","failedto",2,0,0,0,2
"8922","fairs",2,0,0,0,2
"8923","faithfulness",0,2,0,0,2
"8924","falls",1,0,1,0,2
"8925","falsehood",1,1,0,0,2
"8926","familiarity",1,1,0,0,2
"8927","fanaticism",1,1,0,0,2
"8928","fanned",0,1,1,0,2
"8929","fans",1,1,0,0,2
"8930","fares",2,0,0,0,2
"8931","farmer",1,1,0,0,2
"8932","fated",1,1,0,0,2
"8933","fatherly",1,1,0,0,2
"8934","fatigue",1,0,1,0,2
"8935","faultless",1,1,0,0,2
"8936","fawn",1,1,0,0,2
"8937","fearfully",1,1,0,0,2
"8938","feasibility",1,1,0,0,2
"8939","feasted",1,1,0,0,2
"8940","feasting",0,1,1,0,2
"8941","feddy",1,1,0,0,2
"8942","fee",2,0,0,0,2
"8943","feebleness",1,1,0,0,2
"8944","feeds",0,0,1,1,2
"8945","feelingthat",2,0,0,0,2
"8946","feign",1,1,0,0,2
"8947","fellowshiped",1,1,0,0,2
"8948","feltthat",2,0,0,0,2
"8949","fertility",1,1,0,0,2
"8950","fervently",2,0,0,0,2
"8951","fessenden",2,0,0,0,2
"8952","festering",0,1,1,0,2
"8953","feud",1,1,0,0,2
"8954","feverish",1,1,0,0,2
"8955","fight_",1,1,0,0,2
"8956","fights",1,0,1,0,2
"8957","figures",1,0,0,1,2
"8958","filthy",1,1,0,0,2
"8959","financial",2,0,0,0,2
"8960","fines",0,2,0,0,2
"8961","finish",2,0,0,0,2
"8962","finite",1,1,0,0,2
"8963","fir",1,1,0,0,2
"8964","fired",2,0,0,0,2
"8965","fireside",2,0,0,0,2
"8966","fisherwoman",2,0,0,0,2
"8967","fisted",1,1,0,0,2
"8968","fixture",1,1,0,0,2
"8969","flagrantly",1,1,0,0,2
"8970","flavor",1,1,0,0,2
"8971","flay",0,2,0,0,2
"8972","fleet",1,1,0,0,2
"8973","flights",1,1,0,0,2
"8974","fling",1,1,0,0,2
"8975","flintiest",2,0,0,0,2
"8976","flit",1,1,0,0,2
"8977","flitting",1,1,0,0,2
"8978","floats",2,0,0,0,2
"8979","flogging_",0,2,0,0,2
"8980","flourished",2,0,0,0,2
"8981","fluency",1,0,1,0,2
"8982","fluttering",1,1,0,0,2
"8983","fog",1,1,0,0,2
"8984","folds",1,1,0,0,2
"8985","follies",2,0,0,0,2
"8986","fond",1,1,0,0,2
"8987","fondness",1,1,0,0,2
"8988","footnotes",0,2,0,0,2
"8989","footprints",0,1,1,0,2
"8990","forany",2,0,0,0,2
"8991","forbearance",2,0,0,0,2
"8992","forcibly",1,1,0,0,2
"8993","forego",1,1,0,0,2
"8994","foreshadowing",1,1,0,0,2
"8995","forge",1,1,0,0,2
"8996","forgetfulness",1,1,0,0,2
"8997","forgets",2,0,0,0,2
"8998","forgetting",0,2,0,0,2
"8999","forgiven",1,1,0,0,2
"9000","forgiving",1,1,0,0,2
"9001","fori",2,0,0,0,2
"9002","forlorn",1,1,0,0,2
"9003","form_",1,1,0,0,2
"9004","form’s",1,1,0,0,2
"9005","formalities",1,1,0,0,2
"9006","formy",2,0,0,0,2
"9007","fornication",1,1,0,0,2
"9008","forthcoming",0,1,1,0,2
"9009","fortheir",2,0,0,0,2
"9010","forums",0,0,0,2,2
"9011","forwhile",2,0,0,0,2
"9012","foundedcomplaint",2,0,0,0,2
"9013","foundery",0,2,0,0,2
"9014","fourpence",1,1,0,0,2
"9015","fourteenyears",2,0,0,0,2
"9016","fouryears",2,0,0,0,2
"9017","fragrant",2,0,0,0,2
"9018","franks",0,0,0,2,2
"9019","freight",2,0,0,0,2
"9020","frenzy",1,0,0,1,2
"9021","frequency",0,1,1,0,2
"9022","friendsof",2,0,0,0,2
"9023","fromher",2,0,0,0,2
"9024","fromhim",2,0,0,0,2
"9025","fromhis",2,0,0,0,2
"9026","fromits",2,0,0,0,2
"9027","fromnew",2,0,0,0,2
"9028","fromthere",2,0,0,0,2
"9029","fronted",0,2,0,0,2
"9030","fronting",1,1,0,0,2
"9031","frosty",1,1,0,0,2
"9032","frying",1,1,0,0,2
"9033","fuel",2,0,0,0,2
"9034","fulfil",1,0,1,0,2
"9035","fulfill",2,0,0,0,2
"9036","fulfilling",1,1,0,0,2
"9037","fulfillment",0,2,0,0,2
"9038","fumes",1,1,0,0,2
"9039","furder",1,1,0,0,2
"9040","furiously",1,1,0,0,2
"9041","furnace",2,0,0,0,2
"9042","furtherance",2,0,0,0,2
"9043","fused",1,1,0,0,2
"9044","gala",1,1,0,0,2
"9045","galileo",0,0,0,2,2
"9046","gall",1,1,0,0,2
"9047","gallantly",1,1,0,0,2
"9048","galleries",0,0,0,2,2
"9049","gang",2,0,0,0,2
"9050","garment",1,1,0,0,2
"9051","garnett",1,1,0,0,2
"9052","garrett",2,0,0,0,2
"9053","garrison’s",1,1,0,0,2
"9054","garrisonian",0,2,0,0,2
"9055","gatewas",2,0,0,0,2
"9056","gateway",1,0,1,0,2
"9057","gaunt",1,1,0,0,2
"9058","gee",1,1,0,0,2
"9059","genesee",2,0,0,0,2
"9060","genuineness",1,1,0,0,2
"9061","geo",2,0,0,0,2
"9062","geographical",2,0,0,0,2
"9063","gesticulating",1,1,0,0,2
"9064","ghastly",0,2,0,0,2
"9065","giles",0,1,1,0,2
"9066","ginger",1,1,0,0,2
"9067","gip",0,0,2,0,2
"9068","gird",1,1,0,0,2
"9069","give",0,0,0,2,2
"9070","giver",1,1,0,0,2
"9071","glasgow",1,1,0,0,2
"9072","glass",1,0,0,1,2
"9073","glee",1,1,0,0,2
"9074","glimpse",1,0,0,1,2
"9075","glimpses",2,0,0,0,2
"9076","glistening",1,1,0,0,2
"9077","gloat",0,2,0,0,2
"9078","glocester",2,0,0,0,2
"9079","glorified",1,0,0,1,2
"9080","glorying",1,1,0,0,2
"9081","glossiness",1,1,0,0,2
"9082","gnat",0,0,2,0,2
"9083","gnawing",1,1,0,0,2
"9084","gnawings",0,0,2,0,2
"9085","goading",0,2,0,0,2
"9086","goads",1,1,0,0,2
"9087","goal",1,1,0,0,2
"9088","goin",1,1,0,0,2
"9089","gone",0,0,0,2,2
"9090","gorsuch",2,0,0,0,2
"9091","gory",0,0,2,0,2
"9092","got",0,0,0,2,2
"9093","goulds",2,0,0,0,2
"9094","gout",1,1,0,0,2
"9095","gov",1,1,0,0,2
"9096","govern",0,1,1,0,2
"9097","governorwise",2,0,0,0,2
"9098","grabbed",1,1,0,0,2
"9099","graced",1,1,0,0,2
"9100","granddaughter",2,0,0,0,2
"9101","granville",2,0,0,0,2
"9102","grapes",1,1,0,0,2
"9103","graphically",1,1,0,0,2
"9104","gratefully",2,0,0,0,2
"9105","gravity",1,1,0,0,2
"9106","greatadvantage",2,0,0,0,2
"9107","greatest",0,0,0,2,2
"9108","greece",0,0,0,2,2
"9109","greedy",1,1,0,0,2
"9110","greener",2,0,0,0,2
"9111","greenes",2,0,0,0,2
"9112","greenfield",1,1,0,0,2
"9113","greenock",1,1,0,0,2
"9114","greenwood",2,0,0,0,2
"9115","grimes",2,0,0,0,2
"9116","grimke",2,0,0,0,2
"9117","groaned",1,1,0,0,2
"9118","groomes",1,1,0,0,2
"9119","grotto",0,0,0,2,2
"9120","groundto",2,0,0,0,2
"9121","growl",1,1,0,0,2
"9122","grows",1,1,0,0,2
"9123","guarantee",2,0,0,0,2
"9124","guaranteed",2,0,0,0,2
"9125","guards",0,2,0,0,2
"9126","gullies",1,1,0,0,2
"9127","guthrie",2,0,0,0,2
"9128","gutters",1,1,0,0,2
"9129","ha",0,0,2,0,2
"9130","habiliments",0,1,1,0,2
"9131","habitable",0,1,1,0,2
"9132","habitations",1,1,0,0,2
"9133","hadbecome",2,0,0,0,2
"9134","hadcome",2,0,0,0,2
"9135","hadgone",2,0,0,0,2
"9136","hadmade",2,0,0,0,2
"9137","hadno",2,0,0,0,2
"9138","hadpassed",2,0,0,0,2
"9139","hallowell",2,0,0,0,2
"9140","halted",1,0,1,0,2
"9141","halter",1,0,1,0,2
"9142","halting",0,1,1,0,2
"9143","hampton",2,0,0,0,2
"9144","handicrafts",2,0,0,0,2
"9145","handle",0,2,0,0,2
"9146","handling",1,1,0,0,2
"9147","handspike",0,0,2,0,2
"9148","handwriting",2,0,0,0,2
"9149","hanged_",1,1,0,0,2
"9150","harassing",1,1,0,0,2
"9151","harbor",1,0,0,1,2
"9152","hardihood",1,1,0,0,2
"9153","hardly",0,0,0,2,2
"9154","harm’s",1,1,0,0,2
"9155","harmlessly",1,1,0,0,2
"9156","harnesses",1,1,0,0,2
"9157","harper’sferry",2,0,0,0,2
"9158","harrington",1,1,0,0,2
"9159","harshand",2,0,0,0,2
"9160","hasty",2,0,0,0,2
"9161","haughty",1,1,0,0,2
"9162","hauling",1,1,0,0,2
"9163","havecontinued",2,0,0,0,2
"9164","havefound",2,0,0,0,2
"9165","havemet",2,0,0,0,2
"9166","haven’t",1,0,1,0,2
"9167","havingbeen",2,0,0,0,2
"9168","havre",2,0,0,0,2
"9169","hazarded",1,1,0,0,2
"9170","hazily",1,1,0,0,2
"9171","hazy",1,1,0,0,2
"9172","he’s",1,1,0,0,2
"9173","headache",1,1,0,0,2
"9174","heartedness",1,1,0,0,2
"9175","hearths",1,0,1,0,2
"9176","heaven’s",1,1,0,0,2
"9177","heavers",1,1,0,0,2
"9178","heavings",1,1,0,0,2
"9179","hecalled",2,0,0,0,2
"9180","hector",1,1,0,0,2
"9181","hedid",2,0,0,0,2
"9182","heighten",0,1,0,1,2
"9183","heightened",1,1,0,0,2
"9184","heinousness",1,1,0,0,2
"9185","heis",2,0,0,0,2
"9186","heldin",2,0,0,0,2
"9187","hellish",0,2,0,0,2
"9188","hencethey",2,0,0,0,2
"9189","here’s",1,1,0,0,2
"9190","hereunto",1,1,0,0,2
"9191","herto",2,0,0,0,2
"9192","hesitating",1,1,0,0,2
"9193","hew",1,1,0,0,2
"9194","hewanted",2,0,0,0,2
"9195","hewed",1,1,0,0,2
"9196","hickey",0,1,1,0,2
"9197","hicks’s",0,1,1,0,2
"9198","high",0,0,0,2,2
"9199","hildreth",0,0,0,2,2
"9200","him.i",2,0,0,0,2
"9201","himi",2,0,0,0,2
"9202","himin",2,0,0,0,2
"9203","himinjustice",2,0,0,0,2
"9204","himof",2,0,0,0,2
"9205","himto",2,0,0,0,2
"9206","hinderance",0,2,0,0,2
"9207","hinderances",0,2,0,0,2
"9208","hint",1,0,0,1,2
"9209","hischaracter",2,0,0,0,2
"9210","hisduty",2,0,0,0,2
"9211","hismaster",2,0,0,0,2
"9212","hisnew",2,0,0,0,2
"9213","historian",2,0,0,0,2
"9214","histories",0,1,0,1,2
"9215","hoeing",0,1,1,0,2
"9216","holley",2,0,0,0,2
"9217","hollow",0,2,0,0,2
"9218","home_",0,2,0,0,2
"9219","homeward",0,1,0,1,2
"9220","honesty",1,1,0,0,2
"9221","honorables",1,1,0,0,2
"9222","hooks",1,1,0,0,2
"9223","horatio",2,0,0,0,2
"9224","horrors_",0,2,0,0,2
"9225","hospital",0,0,0,2,2
"9226","housein",2,0,0,0,2
"9227","housewas",2,0,0,0,2
"9228","howeverdistinguished",2,0,0,0,2
"9229","howitt",2,0,0,0,2
"9230","howland",2,0,0,0,2
"9231","howth",1,1,0,0,2
"9232","hucksters",1,1,0,0,2
"9233","hue",1,1,0,0,2
"9234","hughs",0,2,0,0,2
"9235","humannature",2,0,0,0,2
"9236","humanprogress",2,0,0,0,2
"9237","humphrey",1,1,0,0,2
"9238","hundreds",2,0,0,0,2
"9239","hunker",1,1,0,0,2
"9240","hurl",0,2,0,0,2
"9241","hurra",0,1,1,0,2
"9242","hurting",2,0,0,0,2
"9243","husbandry",1,1,0,0,2
"9244","hush",0,0,1,1,2
"9245","huss",1,1,0,0,2
"9246","huts",1,1,0,0,2
"9247","ibeen",2,0,0,0,2
"9248","icertainly",2,0,0,0,2
"9249","ideal",0,2,0,0,2
"9250","identity",1,0,1,0,2
"9251","idid",2,0,0,0,2
"9252","ifthe",2,0,0,0,2
"9253","iknew",2,0,0,0,2
"9254","iknow",2,0,0,0,2
"9255","ilearned",2,0,0,0,2
"9256","imaged",0,2,0,0,2
"9257","imaginary",1,1,0,0,2
"9258","imbedded",1,1,0,0,2
"9259","imbibe",0,1,1,0,2
"9260","imbibed",0,1,1,0,2
"9261","imbruted",1,0,1,0,2
"9262","imention",2,0,0,0,2
"9263","immeasurably",2,0,0,0,2
"9264","imminent",2,0,0,0,2
"9265","immoderately",1,1,0,0,2
"9266","immovable",1,1,0,0,2
"9267","impalpable",1,1,0,0,2
"9268","impartiality",2,0,0,0,2
"9269","impassable",0,1,1,0,2
"9270","imperative",1,1,0,0,2
"9271","imperiled",2,0,0,0,2
"9272","imperiously",1,1,0,0,2
"9273","impetus",1,0,1,0,2
"9274","impiously",0,2,0,0,2
"9275","imply",0,1,1,0,2
"9276","importunities",0,2,0,0,2
"9277","impostor",1,1,0,0,2
"9278","imposture",0,0,1,1,2
"9279","impracticable",1,1,0,0,2
"9280","improperly",0,1,1,0,2
"9281","improves",1,1,0,0,2
"9282","imputation",0,2,0,0,2
"9283","imputations",0,1,1,0,2
"9284","inability",2,0,0,0,2
"9285","inamerica",2,0,0,0,2
"9286","inan",2,0,0,0,2
"9287","inany",2,0,0,0,2
"9288","inbaltimore",2,0,0,0,2
"9289","incidents_",0,2,0,0,2
"9290","incipient",1,1,0,0,2
"9291","incite",1,1,0,0,2
"9292","incited",1,0,0,1,2
"9293","incompatible",0,1,1,0,2
"9294","incompetent",1,0,1,0,2
"9295","inconsiderable",1,1,0,0,2
"9296","inconversation",2,0,0,0,2
"9297","incorporated",2,0,0,0,2
"9298","increasingly",1,0,1,0,2
"9299","inculcated",1,1,0,0,2
"9300","indefatigable",2,0,0,0,2
"9301","indelicate",0,1,1,0,2
"9302","indians",1,1,0,0,2
"9303","indigent",1,1,0,0,2
"9304","indignantly",1,1,0,0,2
"9305","indignities",0,2,0,0,2
"9306","indirections",1,1,0,0,2
"9307","indistinct",1,1,0,0,2
"9308","indulge",0,1,1,0,2
"9309","indulging",1,1,0,0,2
"9310","inexperience",2,0,0,0,2
"9311","inexpressible",0,2,0,0,2
"9312","infamous",1,1,0,0,2
"9313","infantile",0,2,0,0,2
"9314","infavor",2,0,0,0,2
"9315","infedel",0,0,0,2,2
"9316","inflexible",1,0,1,0,2
"9317","inflicting",1,1,0,0,2
"9318","inflicts",0,2,0,0,2
"9319","informal",2,0,0,0,2
"9320","ingeneering",0,0,0,2,2
"9321","ingenuity",2,0,0,0,2
"9322","ingetting",2,0,0,0,2
"9323","ingraft",0,2,0,0,2
"9324","ingredients",0,1,1,0,2
"9325","inignorance",2,0,0,0,2
"9326","init",2,0,0,0,2
"9327","initiating",1,1,0,0,2
"9328","initiation",0,2,0,0,2
"9329","injuries",1,1,0,0,2
"9330","injurious",0,1,1,0,2
"9331","injusticeand",2,0,0,0,2
"9332","inmissouri",2,0,0,0,2
"9333","inmost",0,2,0,0,2
"9334","innate",0,2,0,0,2
"9335","inoculated",1,1,0,0,2
"9336","inorder",2,0,0,0,2
"9337","inour",2,0,0,0,2
"9338","inquirer",0,1,1,0,2
"9339","inquisition",2,0,0,0,2
"9340","inscription",0,0,0,2,2
"9341","insearch",2,0,0,0,2
"9342","insert",2,0,0,0,2
"9343","insidethe",2,0,0,0,2
"9344","insistedupon",2,0,0,0,2
"9345","insists",1,1,0,0,2
"9346","instantaneous",2,0,0,0,2
"9347","instil",1,0,1,0,2
"9348","instinctively",1,1,0,0,2
"9349","institute",0,1,1,0,2
"9350","instituted",0,2,0,0,2
"9351","instructing",1,0,1,0,2
"9352","instructor",1,1,0,0,2
"9353","insulting",1,1,0,0,2
"9354","intangible",1,1,0,0,2
"9355","intensify",1,1,0,0,2
"9356","intents",1,1,0,0,2
"9357","interior",2,0,0,0,2
"9358","interment",2,0,0,0,2
"9359","international",1,0,0,1,2
"9360","interrogator",1,1,0,0,2
"9361","interruption",0,1,1,0,2
"9362","interspersed",1,1,0,0,2
"9363","intervals",1,1,0,0,2
"9364","intestate",1,1,0,0,2
"9365","intheir",2,0,0,0,2
"9366","intimately",1,1,0,0,2
"9367","intoa",2,0,0,0,2
"9368","intrude",1,1,0,0,2
"9369","inupon",2,0,0,0,2
"9370","invaders",2,0,0,0,2
"9371","invasion",1,0,0,1,2
"9372","invective",0,2,0,0,2
"9373","invest",1,1,0,0,2
"9374","invidious",0,2,0,0,2
"9375","invitedto",2,0,0,0,2
"9376","inviter",1,1,0,0,2
"9377","invoked",1,1,0,0,2
"9378","involuntary",1,0,1,0,2
"9379","involve",0,2,0,0,2
"9380","involvedin",2,0,0,0,2
"9381","involves",1,1,0,0,2
"9382","inwashington",2,0,0,0,2
"9383","irksome",1,1,0,0,2
"9384","irony",0,2,0,0,2
"9385","irreconcilable",0,2,0,0,2
"9386","irrecoverable",1,1,0,0,2
"9387","irregular",1,1,0,0,2
"9388","irritation",1,1,0,0,2
"9389","is_",0,1,1,0,2
"9390","isaid",2,0,0,0,2
"9391","isaw",2,0,0,0,2
"9392","ismalia",0,0,0,2,2
"9393","istepped",2,0,0,0,2
"9394","isucceeded",2,0,0,0,2
"9395","ita",2,0,0,0,2
"9396","itcould",2,0,0,0,2
"9397","ithad",2,0,0,0,2
"9398","itmeant",2,0,0,0,2
"9399","itseemed",2,0,0,0,2
"9400","itto",2,0,0,0,2
"9401","iwill",2,0,0,0,2
"9402","iwould",2,0,0,0,2
"9403","jackson",2,0,0,0,2
"9404","jackson’s",1,1,0,0,2
"9405","janesville",2,0,0,0,2
"9406","jar",1,1,0,0,2
"9407","jealous",1,1,0,0,2
"9408","jealousy",1,1,0,0,2
"9409","jeered",2,0,0,0,2
"9410","jeers",0,2,0,0,2
"9411","jersey",1,1,0,0,2
"9412","jerusalem",1,1,0,0,2
"9413","jip",0,2,0,0,2
"9414","jobs",1,1,0,0,2
"9415","johnbright",2,0,0,0,2
"9416","joshua",2,0,0,0,2
"9417","journeymen",0,1,1,0,2
"9418","joyfully",1,1,0,0,2
"9419","joyously",1,1,0,0,2
"9420","jr",1,0,1,0,2
"9421","juba",1,1,0,0,2
"9422","judicious",2,0,0,0,2
"9423","judkins",1,1,0,0,2
"9424","jug",1,1,0,0,2
"9425","julius",1,0,0,1,2
"9426","junior",1,1,0,0,2
"9427","justiceand",2,0,0,0,2
"9428","justifier",0,1,1,0,2
"9429","justly",1,1,0,0,2
"9430","jutting",1,1,0,0,2
"9431","kagi",2,0,0,0,2
"9432","keep",0,0,0,2,2
"9433","keepers",0,0,2,0,2
"9434","keepingthe",2,0,0,0,2
"9435","kelton",2,0,0,0,2
"9436","khedeive",0,0,0,2,2
"9437","kicking",1,1,0,0,2
"9438","kidnapped",1,1,0,0,2
"9439","kidnapping",0,2,0,0,2
"9440","knapp",1,1,0,0,2
"9441","knewof",2,0,0,0,2
"9442","knewsomething",2,0,0,0,2
"9443","knight",1,1,0,0,2
"9444","knives",1,1,0,0,2
"9445","knot",1,1,0,0,2
"9446","knots",1,1,0,0,2
"9447","known",0,0,0,2,2
"9448","knownas",2,0,0,0,2
"9449","knownto",2,0,0,0,2
"9450","knows",0,0,0,2,2
"9451","knowwhat",2,0,0,0,2
"9452","la",2,0,0,0,2
"9453","labeled",1,1,0,0,2
"9454","lain",1,1,0,0,2
"9455","lakes",1,1,0,0,2
"9456","lameness",1,1,0,0,2
"9457","lampers",1,1,0,0,2
"9458","landlord",1,1,0,0,2
"9459","languages",1,0,0,1,2
"9460","languished",0,1,1,0,2
"9461","lap",1,1,0,0,2
"9462","lashed",0,1,1,0,2
"9463","lashings",0,1,1,0,2
"9464","latin",1,0,0,1,2
"9465","latitudes",1,1,0,0,2
"9466","lattice",1,1,0,0,2
"9467","laudable",1,1,0,0,2
"9468","laurels",1,1,0,0,2
"9469","lavish",1,1,0,0,2
"9470","lawyer",1,1,0,0,2
"9471","leaked",1,1,0,0,2
"9472","learningto",2,0,0,0,2
"9473","learnt",0,2,0,0,2
"9474","least",0,0,0,2,2
"9475","lee’s",0,1,1,0,2
"9476","leered",1,1,0,0,2
"9477","legislated",2,0,0,0,2
"9478","lemon",1,1,0,0,2
"9479","lemons",0,0,0,2,2
"9480","lengthy",1,1,0,0,2
"9481","lent",1,1,0,0,2
"9482","leprous",1,1,0,0,2
"9483","less",0,0,0,2,2
"9484","lessen",0,2,0,0,2
"9485","lessencouraging",2,0,0,0,2
"9486","lettuce",1,1,0,0,2
"9487","lever",1,1,0,0,2
"9488","lewes",0,0,0,2,2
"9489","libels",0,0,2,0,2
"9490","liberality",1,1,0,0,2
"9491","liberally",2,0,0,0,2
"9492","lieutenant",1,1,0,0,2
"9493","lighter",1,1,0,0,2
"9494","lights",0,1,0,1,2
"9495","likea",2,0,0,0,2
"9496","likenesses",1,0,0,1,2
"9497","likewise",0,2,0,0,2
"9498","liking",1,1,0,0,2
"9499","limber",1,1,0,0,2
"9500","limitations",1,1,0,0,2
"9501","lined",1,1,0,0,2
"9502","lip",1,1,0,0,2
"9503","liquor",1,1,0,0,2
"9504","liquors",1,1,0,0,2
"9505","lists",1,1,0,0,2
"9506","lit",1,1,0,0,2
"9507","lite",0,0,0,2,2
"9508","littlemore",2,0,0,0,2
"9509","livewith",2,0,0,0,2
"9510","loans",2,0,0,0,2
"9511","located",2,0,0,0,2
"9512","location",2,0,0,0,2
"9513","lockermans",1,1,0,0,2
"9514","logically",1,1,0,0,2
"9515","lonelinessand",2,0,0,0,2
"9516","longand",2,0,0,0,2
"9517","longenough",2,0,0,0,2
"9518","longer",0,0,0,2,2
"9519","longings",0,1,1,0,2
"9520","lookedat",2,0,0,0,2
"9521","loomed",0,1,0,1,2
"9522","loosely",1,1,0,0,2
"9523","lordly",0,1,1,0,2
"9524","lords",1,1,0,0,2
"9525","loses",1,1,0,0,2
"9526","loudon",1,1,0,0,2
"9527","louis",1,1,0,0,2
"9528","lounged",1,1,0,0,2
"9529","loves",1,0,1,0,2
"9530","lowe’s",1,1,0,0,2
"9531","lowering",2,0,0,0,2
"9532","lownes",0,2,0,0,2
"9533","loyaldead",2,0,0,0,2
"9534","loyalist",2,0,0,0,2
"9535","lucas",0,1,0,1,2
"9536","lucrative",2,0,0,0,2
"9537","lumbago",1,1,0,0,2
"9538","luminous",2,0,0,0,2
"9539","lurking",1,1,0,0,2
"9540","lustily",1,1,0,0,2
"9541","lustrous",1,1,0,0,2
"9542","luxurious",1,1,0,0,2
"9543","lyceum",1,1,0,0,2
"9544","lydia",2,0,0,0,2
"9545","lyons",0,0,0,2,2
"9546","maddened",1,1,0,0,2
"9547","magnanimity",1,1,0,0,2
"9548","mahogany",2,0,0,0,2
"9549","mahomet",1,1,0,0,2
"9550","mailed",1,0,0,1,2
"9551","maine",2,0,0,0,2
"9552","makea",2,0,0,0,2
"9553","makesus",2,0,0,0,2
"9554","maliciously",1,1,0,0,2
"9555","mallet",0,1,1,0,2
"9556","man’schildren",2,0,0,0,2
"9557","manand",2,0,0,0,2
"9558","mangle",1,1,0,0,2
"9559","manhad",2,0,0,0,2
"9560","manifestations",1,1,0,0,2
"9561","manifestly",1,0,1,0,2
"9562","mann",2,0,0,0,2
"9563","mansions",1,1,0,0,2
"9564","manufacturing",1,1,0,0,2
"9565","manumission",1,1,0,0,2
"9566","manumit",1,1,0,0,2
"9567","manure",0,1,1,0,2
"9568","manwho",2,0,0,0,2
"9569","manyfriends",2,0,0,0,2
"9570","manyof",2,0,0,0,2
"9571","mar",0,1,0,1,2
"9572","mariner",0,0,1,1,2
"9573","marketable",0,2,0,0,2
"9574","marking",2,0,0,0,2
"9575","marquis",1,1,0,0,2
"9576","marriedand",2,0,0,0,2
"9577","marseilles",0,0,0,2,2
"9578","marshal’s",2,0,0,0,2
"9579","marshaling",2,0,0,0,2
"9580","marshalof",2,0,0,0,2
"9581","marvellous",0,0,0,2,2
"9582","marylanders",0,2,0,0,2
"9583","mas’r",2,0,0,0,2
"9584","massachusettsanti",2,0,0,0,2
"9585","masses",2,0,0,0,2
"9586","massof",2,0,0,0,2
"9587","masterand",2,0,0,0,2
"9588","masterhugh",2,0,0,0,2
"9589","masterly",2,0,0,0,2
"9590","materially",0,1,1,0,2
"9591","mature",1,1,0,0,2
"9592","mayors",1,1,0,0,2
"9593","mcdermot",2,0,0,0,2
"9594","mcdermott",1,1,0,0,2
"9595","me.during",2,0,0,0,2
"9596","meagain",2,0,0,0,2
"9597","measurably",1,1,0,0,2
"9598","measureof",2,0,0,0,2
"9599","meats",1,1,0,0,2
"9600","meditating",1,1,0,0,2
"9601","medium",1,1,0,0,2
"9602","meek",0,0,1,1,2
"9603","meekly",1,1,0,0,2
"9604","mefrom",2,0,0,0,2
"9605","melons",1,1,0,0,2
"9606","membersof",2,0,0,0,2
"9607","memorials",1,1,0,0,2
"9608","memoryof",2,0,0,0,2
"9609","memphis",0,0,0,2,2
"9610","men_",1,1,0,0,2
"9611","menace",1,1,0,0,2
"9612","menagerie",1,1,0,0,2
"9613","menof",2,0,0,0,2
"9614","meof",2,0,0,0,2
"9615","mercer",2,0,0,0,2
"9616","mercies",2,0,0,0,2
"9617","merest",0,0,2,0,2
"9618","merit",1,0,1,0,2
"9619","messages",1,1,0,0,2
"9620","messenger",1,1,0,0,2
"9621","methodists",0,2,0,0,2
"9622","methus",2,0,0,0,2
"9623","mewith",2,0,0,0,2
"9624","mexican",0,1,1,0,2
"9625","michael’s_",0,2,0,0,2
"9626","might",0,0,0,2,2
"9627","mightbe",2,0,0,0,2
"9628","mightiest",0,1,1,0,2
"9629","milan",0,0,0,2,2
"9630","mildest",1,1,0,0,2
"9631","mildew",1,1,0,0,2
"9632","mindof",2,0,0,0,2
"9633","mindthat",2,0,0,0,2
"9634","mingle",0,0,1,1,2
"9635","minutely",1,1,0,0,2
"9636","minuteness",1,1,0,0,2
"9637","misapprehension",1,0,1,0,2
"9638","misdemeanor",0,0,2,0,2
"9639","misfortunes",1,1,0,0,2
"9640","mismanagement",0,1,1,0,2
"9641","misses",2,0,0,0,2
"9642","missionary",1,0,0,1,2
"9643","mitchells",2,0,0,0,2
"9644","mitigate",1,1,0,0,2
"9645","mitigating",1,1,0,0,2
"9646","mobocrats",1,1,0,0,2
"9647","mocked",1,1,0,0,2
"9648","mocking",1,1,0,0,2
"9649","molested",1,1,0,0,2
"9650","monarchial",2,0,0,0,2
"9651","mongrels",1,1,0,0,2
"9652","monstrous",0,2,0,0,2
"9653","monte",0,0,0,2,2
"9654","moorfields",0,2,0,0,2
"9655","morose",1,1,0,0,2
"9656","morpeth",2,0,0,0,2
"9657","mortally",2,0,0,0,2
"9658","morton",2,0,0,0,2
"9659","mosques",0,0,0,2,2
"9660","mouthed",1,1,0,0,2
"9661","moves",0,2,0,0,2
"9662","mow",2,0,0,0,2
"9663","mr.freeland’s",2,0,0,0,2
"9664","mr.gardiner",2,0,0,0,2
"9665","mr.hamilton",2,0,0,0,2
"9666","mr.ingersoll",2,0,0,0,2
"9667","mr.lincoln’s",2,0,0,0,2
"9668","mrs.buchanan",2,0,0,0,2
"9669","munitions",1,1,0,0,2
"9670","murderess",0,1,1,0,2
"9671","murmur",2,0,0,0,2
"9672","muscovite",1,1,0,0,2
"9673","musiem",0,0,0,2,2
"9674","musings",1,1,0,0,2
"9675","musty",1,1,0,0,2
"9676","mutilations",1,0,1,0,2
"9677","myability",2,0,0,0,2
"9678","myaddress",2,0,0,0,2
"9679","mycondition",2,0,0,0,2
"9680","myduty",2,0,0,0,2
"9681","myers",1,1,0,0,2
"9682","myexperience",2,0,0,0,2
"9683","myhead",2,0,0,0,2
"9684","myhouse",2,0,0,0,2
"9685","mylearning",2,0,0,0,2
"9686","mylot",2,0,0,0,2
"9687","mymistress",2,0,0,0,2
"9688","myrace",2,0,0,0,2
"9689","myriads",0,1,1,0,2
"9690","myron",2,0,0,0,2
"9691","myselfa",2,0,0,0,2
"9692","mysoul",2,0,0,0,2
"9693","myspeech",2,0,0,0,2
"9694","mytrade",2,0,0,0,2
"9695","narrations",1,1,0,0,2
"9696","narrowest",2,0,0,0,2
"9697","nationalities",1,0,0,1,2
"9698","nationalization",1,1,0,0,2
"9699","nationalized",1,1,0,0,2
"9700","nature’s",1,1,0,0,2
"9701","naught",2,0,0,0,2
"9702","naval",0,0,0,2,2
"9703","neatness",1,1,0,0,2
"9704","needful",0,1,1,0,2
"9705","needles",2,0,0,0,2
"9706","needy",1,0,1,0,2
"9707","negatively",1,1,0,0,2
"9708","negro’s",2,0,0,0,2
"9709","negrocar",2,0,0,0,2
"9710","nep",1,1,0,0,2
"9711","newconstitution",2,0,0,0,2
"9712","newhampshire",2,0,0,0,2
"9713","nextappointment",2,0,0,0,2
"9714","niagara",2,0,0,0,2
"9715","nicely",1,1,0,0,2
"9716","night’s",1,1,0,0,2
"9717","nobility",1,1,0,0,2
"9718","nobler",1,1,0,0,2
"9719","noiselessly",0,0,1,1,2
"9720","noman",2,0,0,0,2
"9721","nominated",2,0,0,0,2
"9722","north_",1,1,0,0,2
"9723","northwas",2,0,0,0,2
"9724","notabilities",1,1,0,0,2
"9725","notably",2,0,0,0,2
"9726","notaltogether",2,0,0,0,2
"9727","notentirely",2,0,0,0,2
"9728","notfree",2,0,0,0,2
"9729","nothaving",2,0,0,0,2
"9730","nothingfor",2,0,0,0,2
"9731","notlooking",2,0,0,0,2
"9732","notmy",2,0,0,0,2
"9733","notoriety",0,2,0,0,2
"9734","notsee",2,0,0,0,2
"9735","notso",2,0,0,0,2
"9736","notwell",2,0,0,0,2
"9737","nowlook",2,0,0,0,2
"9738","noxious",1,1,0,0,2
"9739","nuisance",1,1,0,0,2
"9740","number",0,0,0,2,2
"9741","o’connell_",0,0,2,0,2
"9742","oaken",1,1,0,0,2
"9743","oakum",1,1,0,0,2
"9744","objecting",1,1,0,0,2
"9745","objectof",2,0,0,0,2
"9746","obligations",1,1,0,0,2
"9747","obligedto",2,0,0,0,2
"9748","obtainment",1,1,0,0,2
"9749","obvious",2,0,0,0,2
"9750","occasioned",1,0,1,0,2
"9751","oclk",0,0,0,2,2
"9752","october",1,0,0,1,2
"9753","odiousness",0,1,1,0,2
"9754","odors",1,1,0,0,2
"9755","ofamerican",2,0,0,0,2
"9756","ofan",2,0,0,0,2
"9757","ofanti",2,0,0,0,2
"9758","ofany",2,0,0,0,2
"9759","ofcolumbia",2,0,0,0,2
"9760","offal",0,1,1,0,2
"9761","offending",1,1,0,0,2
"9762","offices",0,1,1,0,2
"9763","officially",1,0,1,0,2
"9764","offspring",0,2,0,0,2
"9765","ofgratitude",2,0,0,0,2
"9766","ofjames",2,0,0,0,2
"9767","ofjanuary",2,0,0,0,2
"9768","ofjustice",2,0,0,0,2
"9769","ofknowledge",2,0,0,0,2
"9770","ofliberty",2,0,0,0,2
"9771","ofmoney",2,0,0,0,2
"9772","ofmr",2,0,0,0,2
"9773","ofpiety",2,0,0,0,2
"9774","ofright",2,0,0,0,2
"9775","ofrunning",2,0,0,0,2
"9776","ofsending",2,0,0,0,2
"9777","ofslaveholders",2,0,0,0,2
"9778","oft",1,1,0,0,2
"9779","ofthem",2,0,0,0,2
"9780","oftwenty",2,0,0,0,2
"9781","ofus",2,0,0,0,2
"9782","ofwar",2,0,0,0,2
"9783","ole",2,0,0,0,2
"9784","oligarchy",1,1,0,0,2
"9785","onaccount",2,0,0,0,2
"9786","once_",0,2,0,0,2
"9787","onevery",2,0,0,0,2
"9788","onewhich",2,0,0,0,2
"9789","onhis",2,0,0,0,2
"9790","onlya",2,0,0,0,2
"9791","onlythe",2,0,0,0,2
"9792","onour",2,0,0,0,2
"9793","oo",0,2,0,0,2
"9794","opening",0,0,0,2,2
"9795","operator",2,0,0,0,2
"9796","opponent",1,0,1,0,2
"9797","opposedto",2,0,0,0,2
"9798","oppressions",0,2,0,0,2
"9799","oppressive",1,1,0,0,2
"9800","opprobrious",1,1,0,0,2
"9801","option",2,0,0,0,2
"9802","opulent",2,0,0,0,2
"9803","ordains",1,1,0,0,2
"9804","order",0,0,0,2,2
"9805","ordinances",0,2,0,0,2
"9806","orextenuation",2,0,0,0,2
"9807","organic",1,1,0,0,2
"9808","originated",1,1,0,0,2
"9809","orin",2,0,0,0,2
"9810","ornament",0,0,1,1,2
"9811","orphans",2,0,0,0,2
"9812","ortwo",2,0,0,0,2
"9813","oughtto",2,0,0,0,2
"9814","ourcountry",2,0,0,0,2
"9815","ournational",2,0,0,0,2
"9816","outall",2,0,0,0,2
"9817","outbid",1,1,0,0,2
"9818","outbreaks",0,1,1,0,2
"9819","outgrowth",2,0,0,0,2
"9820","outlaw",1,1,0,0,2
"9821","outlay",0,2,0,0,2
"9822","outright",1,1,0,0,2
"9823","outside",0,0,0,2,2
"9824","outspread",0,1,0,1,2
"9825","overboard",1,1,0,0,2
"9826","overhanging",1,0,0,1,2
"9827","overshadows",1,0,1,0,2
"9828","overus",2,0,0,0,2
"9829","overwhelmingly",1,1,0,0,2
"9830","paddles",1,0,1,0,2
"9831","padlock",1,1,0,0,2
"9832","paestum",0,0,0,2,2
"9833","palazza",0,0,0,2,2
"9834","paler",1,1,0,0,2
"9835","pall",1,1,0,0,2
"9836","palsy",2,0,0,0,2
"9837","pampered",0,1,1,0,2
"9838","panting",0,0,2,0,2
"9839","parcels",0,2,0,0,2
"9840","parks",1,1,0,0,2
"9841","parliamentary",2,0,0,0,2
"9842","parody",0,0,2,0,2
"9843","paroxysm",1,1,0,0,2
"9844","parry",1,1,0,0,2
"9845","parsnips",1,1,0,0,2
"9846","partake",1,1,0,0,2
"9847","participated",1,1,0,0,2
"9848","partisan",2,0,0,0,2
"9849","partner",2,0,0,0,2
"9850","partridges",1,1,0,0,2
"9851","passport",2,0,0,0,2
"9852","pasturage",1,1,0,0,2
"9853","pat",1,1,0,0,2
"9854","patched",1,1,0,0,2
"9855","patent",1,1,0,0,2
"9856","paths",1,1,0,0,2
"9857","pathwayof",2,0,0,0,2
"9858","paton",1,1,0,0,2
"9859","pauper",1,1,0,0,2
"9860","paved",1,1,0,0,2
"9861","paws",0,1,1,0,2
"9862","payment",1,1,0,0,2
"9863","pays",2,0,0,0,2
"9864","peacebetween",2,0,0,0,2
"9865","pearly",1,1,0,0,2
"9866","peas",1,1,0,0,2
"9867","peasantry",1,1,0,0,2
"9868","pebbles",1,1,0,0,2
"9869","pecked",0,2,0,0,2
"9870","peculiarity",1,0,0,1,2
"9871","peerless",2,0,0,0,2
"9872","pegged",1,1,0,0,2
"9873","pelting",0,2,0,0,2
"9874","pencil",1,1,0,0,2
"9875","pending",1,1,0,0,2
"9876","penning",1,1,0,0,2
"9877","peopled",0,1,1,0,2
"9878","perceive",1,0,1,0,2
"9879","perch",1,1,0,0,2
"9880","perchance",1,1,0,0,2
"9881","perched",1,1,0,0,2
"9882","perfections",1,0,0,1,2
"9883","perhaps",0,0,0,2,2
"9884","periodical",1,1,0,0,2
"9885","perishing",0,1,1,0,2
"9886","permanently",2,0,0,0,2
"9887","pernicious",0,0,2,0,2
"9888","perniciously",1,1,0,0,2
"9889","perpetrate",1,1,0,0,2
"9890","perpetrator",0,1,1,0,2
"9891","perpetrators",1,1,0,0,2
"9892","perpetuity",2,0,0,0,2
"9893","perplexities",2,0,0,0,2
"9894","persevere",1,1,0,0,2
"9895","persevered",1,1,0,0,2
"9896","persistence",1,1,0,0,2
"9897","personage",1,1,0,0,2
"9898","personalexperience",2,0,0,0,2
"9899","perturbation",1,1,0,0,2
"9900","pervade",1,1,0,0,2
"9901","perverted",1,1,0,0,2
"9902","peters",0,0,0,2,2
"9903","pheasants",1,1,0,0,2
"9904","phelps",2,0,0,0,2
"9905","philadelphiain",2,0,0,0,2
"9906","philanthropist",0,1,0,1,2
"9907","philosopher",2,0,0,0,2
"9908","philosophical",1,1,0,0,2
"9909","physically",1,1,0,0,2
"9910","piazza",0,0,0,2,2
"9911","pick",2,0,0,0,2
"9912","picking",1,1,0,0,2
"9913","pickled",1,1,0,0,2
"9914","picturesque",0,0,0,2,2
"9915","pieceof",2,0,0,0,2
"9916","pierpont",1,1,0,0,2
"9917","pigeon",1,1,0,0,2
"9918","pigeons",1,1,0,0,2
"9919","pilgrim",0,1,1,0,2
"9920","pilgrimage",1,1,0,0,2
"9921","pillowed",1,1,0,0,2
"9922","pinioned",1,1,0,0,2
"9923","pint",1,1,0,0,2
"9924","piracy",0,2,0,0,2
"9925","pisa",0,0,0,2,2
"9926","pitiable",1,1,0,0,2
"9927","pittsburgh",1,1,0,0,2
"9928","places",0,0,0,2,2
"9929","placeto",2,0,0,0,2
"9930","plains",0,1,0,1,2
"9931","planks",2,0,0,0,2
"9932","planter",0,1,1,0,2
"9933","planters",1,0,1,0,2
"9934","platforms",1,1,0,0,2
"9935","playfully",1,1,0,0,2
"9936","plays",0,2,0,0,2
"9937","pleaded",1,1,0,0,2
"9938","pleases",1,1,0,0,2
"9939","plentiful",0,2,0,0,2
"9940","plot_",0,2,0,0,2
"9941","plotting",1,1,0,0,2
"9942","ploughing",0,0,2,0,2
"9943","plummer’s",1,1,0,0,2
"9944","plump",1,1,0,0,2
"9945","plunderers",0,1,1,0,2
"9946","plunge",1,1,0,0,2
"9947","plunging",0,1,1,0,2
"9948","plying",1,1,0,0,2
"9949","poetic",2,0,0,0,2
"9950","polished",1,1,0,0,2
"9951","polls",2,0,0,0,2
"9952","pompand",2,0,0,0,2
"9953","ponderous",1,1,0,0,2
"9954","poorest",1,1,0,0,2
"9955","pope",0,0,0,2,2
"9956","poplar",1,1,0,0,2
"9957","populace",2,0,0,0,2
"9958","popularprejudice",2,0,0,0,2
"9959","populated",1,1,0,0,2
"9960","portentous",2,0,0,0,2
"9961","portions",1,1,0,0,2
"9962","portly",1,1,0,0,2
"9963","portrayed",1,1,0,0,2
"9964","possessor",1,1,0,0,2
"9965","possessors",1,1,0,0,2
"9966","possible",0,0,0,2,2
"9967","postal",2,0,0,0,2
"9968","poste",0,0,0,2,2
"9969","postmaster",2,0,0,0,2
"9970","posts",1,1,0,0,2
"9971","pounding",1,1,0,0,2
"9972","powerand",2,0,0,0,2
"9973","powerto",2,0,0,0,2
"9974","prairie",1,1,0,0,2
"9975","praises",1,1,0,0,2
"9976","praiseworthy",1,1,0,0,2
"9977","precepts",0,1,1,0,2
"9978","precursor",1,1,0,0,2
"9979","predecessor",1,1,0,0,2
"9980","preeminent",0,2,0,0,2
"9981","preëminent",2,0,0,0,2
"9982","preferable",0,1,1,0,2
"9983","prefers",1,1,0,0,2
"9984","prejudicial",1,1,0,0,2
"9985","premature",2,0,0,0,2
"9986","presbyterian",1,1,0,0,2
"9987","prescience",1,1,0,0,2
"9988","prescriptions",1,1,0,0,2
"9989","present",0,0,0,2,2
"9990","presented",0,0,0,2,2
"9991","presently",1,1,0,0,2
"9992","presses",1,1,0,0,2
"9993","presumptuous",0,1,1,0,2
"9994","prevents",1,1,0,0,2
"9995","previousto",2,0,0,0,2
"9996","price’s",1,1,0,0,2
"9997","prices",1,1,0,0,2
"9998","princes",1,0,0,1,2
"9999","principle_",1,1,0,0,2
"10000","privation",0,1,1,0,2
"10001","privations",1,0,1,0,2
"10002","privilegeto",2,0,0,0,2
"10003","prize",1,1,0,0,2
"10004","processes",0,2,0,0,2
"10005","proclaims",0,1,1,0,2
"10006","prodigy",0,1,1,0,2
"10007","profaning",1,1,0,0,2
"10008","profanity",0,1,1,0,2
"10009","professional",2,0,0,0,2
"10010","profitable",0,1,1,0,2
"10011","profits",0,2,0,0,2
"10012","profligacy",1,1,0,0,2
"10013","profounder",0,2,0,0,2
"10014","programme",1,1,0,0,2
"10015","prohibitory",0,2,0,0,2
"10016","promoting",1,1,0,0,2
"10017","pronounce",0,2,0,0,2
"10018","propensity",1,1,0,0,2
"10019","properties",0,1,0,1,2
"10020","prophet",0,1,0,1,2
"10021","proportioned",0,2,0,0,2
"10022","proposal",1,0,1,0,2
"10023","proposedto",2,0,0,0,2
"10024","proposes",1,1,0,0,2
"10025","proscriptions",2,0,0,0,2
"10026","prosecuted",2,0,0,0,2
"10027","prosecution",2,0,0,0,2
"10028","prostrate",1,0,1,0,2
"10029","providential",1,1,0,0,2
"10030","providentially",0,2,0,0,2
"10031","provisions",1,1,0,0,2
"10032","provocation",0,2,0,0,2
"10033","provoke",1,1,0,0,2
"10034","provoked",2,0,0,0,2
"10035","proximate",1,1,0,0,2
"10036","prying",1,1,0,0,2
"10037","psalm",0,1,1,0,2
"10038","publisher",2,0,0,0,2
"10039","pulling",1,1,0,0,2
"10040","pump",1,1,0,0,2
"10041","punishable",0,2,0,0,2
"10042","puny",1,1,0,0,2
"10043","pupil",0,2,0,0,2
"10044","pursuance",2,0,0,0,2
"10045","pursuits",1,1,0,0,2
"10046","putnams",0,0,0,2,2
"10047","puzzle",0,2,0,0,2
"10048","puzzling",0,2,0,0,2
"10049","pyramid",0,0,0,2,2
"10050","quails",1,1,0,0,2
"10051","qualify",2,0,0,0,2
"10052","quarrels",0,1,1,0,2
"10053","queerest",0,0,0,2,2
"10054","quelled",1,1,0,0,2
"10055","questionwas",2,0,0,0,2
"10056","quitting",1,1,0,0,2
"10057","quotations",2,0,0,0,2
"10058","rabbi",0,0,2,0,2
"10059","racing",1,1,0,0,2
"10060","radishes",1,1,0,0,2
"10061","ragged",1,1,0,0,2
"10062","rainbow",1,1,0,0,2
"10063","rained",1,1,0,0,2
"10064","raises",0,2,0,0,2
"10065","raisins",1,1,0,0,2
"10066","rambler",1,1,0,0,2
"10067","ramses",0,1,0,1,2
"10068","ranking",0,2,0,0,2
"10069","rapine",1,1,0,0,2
"10070","rated",1,1,0,0,2
"10071","ratherthan",2,0,0,0,2
"10072","ration",1,1,0,0,2
"10073","raymond",0,2,0,0,2
"10074","rays",1,1,0,0,2
"10075","readiness",1,0,1,0,2
"10076","realities",1,1,0,0,2
"10077","realizing",1,1,0,0,2
"10078","realm",2,0,0,0,2
"10079","reasoned",1,0,1,0,2
"10080","reasonis",2,0,0,0,2
"10081","reasonto",2,0,0,0,2
"10082","reassures",1,1,0,0,2
"10083","rebuking",1,1,0,0,2
"10084","recaptured",1,1,0,0,2
"10085","receding",0,0,1,1,2
"10086","receivedme",2,0,0,0,2
"10087","recital",0,1,1,0,2
"10088","reconciliation",2,0,0,0,2
"10089","reconsideration",1,1,0,0,2
"10090","recorder",1,0,1,0,2
"10091","records",0,2,0,0,2
"10092","recount",2,0,0,0,2
"10093","recourse",1,1,0,0,2
"10094","recreancy",1,1,0,0,2
"10095","rectitude",0,2,0,0,2
"10096","recurrence",0,1,1,0,2
"10097","reduces",0,1,1,0,2
"10098","reed",1,0,0,1,2
"10099","refers",1,1,0,0,2
"10100","reflects",1,1,0,0,2
"10101","reflex",1,1,0,0,2
"10102","reformation",1,1,0,0,2
"10103","refrained",1,1,0,0,2
"10104","refreshed",1,1,0,0,2
"10105","refreshing",1,1,0,0,2
"10106","refreshment",1,1,0,0,2
"10107","refuses",1,1,0,0,2
"10108","refutation",1,1,0,0,2
"10109","rehearsed",1,1,0,0,2
"10110","reigned",1,1,0,0,2
"10111","relaxed",1,1,0,0,2
"10112","relent",1,1,0,0,2
"10113","relieving",1,1,0,0,2
"10114","religionists",0,1,1,0,2
"10115","reluctance",2,0,0,0,2
"10116","renovating",1,1,0,0,2
"10117","rented",0,1,1,0,2
"10118","repelling",1,1,0,0,2
"10119","repenting",1,1,0,0,2
"10120","replace",2,0,0,0,2
"10121","replaced",1,1,0,0,2
"10122","replying",2,0,0,0,2
"10123","reports",1,1,0,0,2
"10124","reposed",1,0,1,0,2
"10125","representations",2,0,0,0,2
"10126","repressed",1,1,0,0,2
"10127","reproached",1,1,0,0,2
"10128","reproachful",1,1,0,0,2
"10129","reproaching",1,1,0,0,2
"10130","reproof",2,0,0,0,2
"10131","repulsed",1,1,0,0,2
"10132","resembling",1,0,0,1,2
"10133","resent",1,1,0,0,2
"10134","reside",0,2,0,0,2
"10135","residences",1,1,0,0,2
"10136","resistancewas",2,0,0,0,2
"10137","resolutely",2,0,0,0,2
"10138","respectto",2,0,0,0,2
"10139","respite",1,1,0,0,2
"10140","restrain",0,1,1,0,2
"10141","restricted",0,2,0,0,2
"10142","restriction",2,0,0,0,2
"10143","rests",0,2,0,0,2
"10144","resultof",2,0,0,0,2
"10145","retaining",1,1,0,0,2
"10146","reticent",2,0,0,0,2
"10147","retired",2,0,0,0,2
"10148","retraced",1,1,0,0,2
"10149","retreated",2,0,0,0,2
"10150","retribution",1,1,0,0,2
"10151","retrospect",1,1,0,0,2
"10152","returninghome",2,0,0,0,2
"10153","revelations",1,1,0,0,2
"10154","reverberating",0,1,0,1,2
"10155","revered",1,1,0,0,2
"10156","reverently",2,0,0,0,2
"10157","revised",0,2,0,0,2
"10158","revisit",2,0,0,0,2
"10159","reviving",1,1,0,0,2
"10160","revolt",2,0,0,0,2
"10161","rewards",1,1,0,0,2
"10162","rheumatism",1,1,0,0,2
"10163","ribaldry",1,1,0,0,2
"10164","richmond’s",0,2,0,0,2
"10165","riders",1,1,0,0,2
"10166","ridges",0,0,2,0,2
"10167","ridingvery",2,0,0,0,2
"10168","rifle",1,1,0,0,2
"10169","right",0,0,0,2,2
"10170","rightfully",0,1,1,0,2
"10171","rightsand",2,0,0,0,2
"10172","rigidly",0,2,0,0,2
"10173","rigorsof",2,0,0,0,2
"10174","ring",1,1,0,0,2
"10175","roam",0,2,0,0,2
"10176","roast",1,1,0,0,2
"10177","robb",1,1,0,0,2
"10178","robe",1,0,0,1,2
"10179","robes",0,0,2,0,2
"10180","rock",1,1,0,0,2
"10181","rocking",1,1,0,0,2
"10182","rodney",1,1,0,0,2
"10183","roses",1,0,0,1,2
"10184","rosy",1,1,0,0,2
"10185","roughest",2,0,0,0,2
"10186","roughing",1,1,0,0,2
"10187","rousing",1,1,0,0,2
"10188","rowdies",1,1,0,0,2
"10189","rows",1,1,0,0,2
"10190","rue",1,0,0,1,2
"10191","ruffianly",1,1,0,0,2
"10192","rugged",1,1,0,0,2
"10193","rustled",1,1,0,0,2
"10194","rusty",1,1,0,0,2
"10195","rutherford",2,0,0,0,2
"10196","sacredly",2,0,0,0,2
"10197","saddening",1,1,0,0,2
"10198","saddles",1,1,0,0,2
"10199","sagacious",2,0,0,0,2
"10200","saidi",2,0,0,0,2
"10201","saidof",2,0,0,0,2
"10202","saidthat",2,0,0,0,2
"10203","saintly",0,2,0,0,2
"10204","sakkara",0,0,0,2,2
"10205","salutary",0,1,1,0,2
"10206","sanctifier",0,1,1,0,2
"10207","sapling",1,1,0,0,2
"10208","satan",1,1,0,0,2
"10209","savior",0,2,0,0,2
"10210","sawed",1,1,0,0,2
"10211","sawing",1,1,0,0,2
"10212","sawyer",1,1,0,0,2
"10213","scamp",1,1,0,0,2
"10214","scarcity",1,1,0,0,2
"10215","scatter",1,1,0,0,2
"10216","scenery",1,0,0,1,2
"10217","schooled",2,0,0,0,2
"10218","schurz",2,0,0,0,2
"10219","scoffed",1,1,0,0,2
"10220","scold",0,0,2,0,2
"10221","scoldings",1,1,0,0,2
"10222","scorching",0,2,0,0,2
"10223","scores",1,1,0,0,2
"10224","scorned",1,1,0,0,2
"10225","scornful",1,1,0,0,2
"10226","scornfully",1,1,0,0,2
"10227","scotland_",1,1,0,0,2
"10228","scott",2,0,0,0,2
"10229","scourged",0,2,0,0,2
"10230","scourging",0,0,2,0,2
"10231","scowl",1,1,0,0,2
"10232","screaming",1,0,0,1,2
"10233","screws",0,1,1,0,2
"10234","scriptural",1,1,0,0,2
"10235","scrupulously",1,1,0,0,2
"10236","scrutinizing",1,1,0,0,2
"10237","sculpture",0,0,0,2,2
"10238","scurf",0,1,1,0,2
"10239","sealing",1,1,0,0,2
"10240","seam",1,1,0,0,2
"10241","seared",1,1,0,0,2
"10242","second",0,0,0,2,2
"10243","secrecy",0,2,0,0,2
"10244","secresy",2,0,0,0,2
"10245","secreted",1,1,0,0,2
"10246","secretly",0,1,1,0,2
"10247","sectionsof",2,0,0,0,2
"10248","securities",2,0,0,0,2
"10249","seine",1,0,0,1,2
"10250","seizing",1,1,0,0,2
"10251","sella",2,0,0,0,2
"10252","senseof",2,0,0,0,2
"10253","sensibility",1,1,0,0,2
"10254","sensibly",1,1,0,0,2
"10255","sent",0,0,0,2,2
"10256","sentinel",0,1,1,0,2
"10257","separations",1,1,0,0,2
"10258","serene",1,1,0,0,2
"10259","seriesof",2,0,0,0,2
"10260","serious",0,0,0,2,2
"10261","sermons",1,1,0,0,2
"10262","serves",1,1,0,0,2
"10263","seth",1,1,0,0,2
"10264","settling",1,1,0,0,2
"10265","seveir",2,0,0,0,2
"10266","sevenyears",2,0,0,0,2
"10267","severalweeks",2,0,0,0,2
"10268","severance",1,1,0,0,2
"10269","severer",1,1,0,0,2
"10270","severity",0,1,1,0,2
"10271","sevier’s",0,2,0,0,2
"10272","sexes",1,0,1,0,2
"10273","shaded",1,1,0,0,2
"10274","shal",0,0,0,2,2
"10275","shapeless",1,1,0,0,2
"10276","shapen",1,1,0,0,2
"10277","sharpe",2,0,0,0,2
"10278","shaw",1,0,1,0,2
"10279","shd",0,0,0,2,2
"10280","shebrought",2,0,0,0,2
"10281","shedding",1,1,0,0,2
"10282","shehad",2,0,0,0,2
"10283","shelf",1,1,0,0,2
"10284","shell",1,1,0,0,2
"10285","shelling",1,1,0,0,2
"10286","shelterless",1,1,0,0,2
"10287","shielding",1,1,0,0,2
"10288","shifts",2,0,0,0,2
"10289","shingles",1,1,0,0,2
"10290","shipped",1,1,0,0,2
"10291","shirting",1,1,0,0,2
"10292","shockingly",1,1,0,0,2
"10293","shoreless",1,1,0,0,2
"10294","shorter",1,1,0,0,2
"10295","shose",1,1,0,0,2
"10296","shouldbecome",2,0,0,0,2
"10297","shouldered",1,0,1,0,2
"10298","shove",2,0,0,0,2
"10299","shovel",0,0,1,1,2
"10300","shoveled",1,1,0,0,2
"10301","shoves",2,0,0,0,2
"10302","shower",1,1,0,0,2
"10303","shrinking",0,1,1,0,2
"10304","sickening",0,2,0,0,2
"10305","sif",1,1,0,0,2
"10306","sighing",0,2,0,0,2
"10307","silencer",1,1,0,0,2
"10308","silk",1,1,0,0,2
"10309","silvery",0,1,1,0,2
"10310","similarity",1,1,0,0,2
"10311","since",0,0,0,2,2
"10312","singers",2,0,0,0,2
"10313","singleyear",2,0,0,0,2
"10314","singly",0,2,0,0,2
"10315","sinless",1,1,0,0,2
"10316","sir_",2,0,0,0,2
"10317","sisson",2,0,0,0,2
"10318","skies",1,1,0,0,2
"10319","skillful",1,0,0,1,2
"10320","skillfully",1,1,0,0,2
"10321","skim",1,1,0,0,2
"10322","skinners",1,1,0,0,2
"10323","skins",1,1,0,0,2
"10324","skirmishing",1,1,0,0,2
"10325","skyward",1,1,0,0,2
"10326","slab",1,1,0,0,2
"10327","slain",1,1,0,0,2
"10328","slammed",1,1,0,0,2
"10329","slavecould",2,0,0,0,2
"10330","slavemaster",0,2,0,0,2
"10331","slavers",0,2,0,0,2
"10332","slavery.i",2,0,0,0,2
"10333","slaveryand",2,0,0,0,2
"10334","slaveryin",2,0,0,0,2
"10335","slaverywas",2,0,0,0,2
"10336","slaves_",1,1,0,0,2
"10337","slaves.it",2,0,0,0,2
"10338","slavesas",2,0,0,0,2
"10339","slaveship",1,1,0,0,2
"10340","slaveswere",2,0,0,0,2
"10341","slavesystem",2,0,0,0,2
"10342","slavewho",2,0,0,0,2
"10343","sleek",0,0,2,0,2
"10344","sleighs",1,1,0,0,2
"10345","slices",1,1,0,0,2
"10346","slip",1,1,0,0,2
"10347","sloops",1,1,0,0,2
"10348","slovenly",1,1,0,0,2
"10349","sluggard",1,1,0,0,2
"10350","smeal",1,1,0,0,2
"10351","smith’s",0,1,1,0,2
"10352","smoother",1,1,0,0,2
"10353","smouldering",1,1,0,0,2
"10354","snares",1,1,0,0,2
"10355","sneaked",1,1,0,0,2
"10356","snows",2,0,0,0,2
"10357","snowy",1,0,0,1,2
"10358","snub",1,1,0,0,2
"10359","sobbed",1,1,0,0,2
"10360","sobs",1,1,0,0,2
"10361","soby",2,0,0,0,2
"10362","socket",1,1,0,0,2
"10363","sod",1,0,1,0,2
"10364","soever",1,1,0,0,2
"10365","sofar",2,0,0,0,2
"10366","softened",1,1,0,0,2
"10367","softer",1,1,0,0,2
"10368","soiling",0,2,0,0,2
"10369","sojourn",1,1,0,0,2
"10370","sol",1,1,0,0,2
"10371","solicitation",0,2,0,0,2
"10372","solicitous",0,2,0,0,2
"10373","solittle",2,0,0,0,2
"10374","solomon",2,0,0,0,2
"10375","somany",2,0,0,0,2
"10376","somuch",2,0,0,0,2
"10377","sonorous",1,1,0,0,2
"10378","soothe",1,1,0,0,2
"10379","soothes",1,1,0,0,2
"10380","sordid",1,1,0,0,2
"10381","sot",1,1,0,0,2
"10382","sounding",1,1,0,0,2
"10383","sourness",1,1,0,0,2
"10384","southernstates",2,0,0,0,2
"10385","spaceof",2,0,0,0,2
"10386","spade",1,0,0,1,2
"10387","span",1,0,0,1,2
"10388","specific",1,1,0,0,2
"10389","specimens",0,1,1,0,2
"10390","spiritof",2,0,0,0,2
"10391","spirituous",1,1,0,0,2
"10392","splendors",2,0,0,0,2
"10393","splinters",1,1,0,0,2
"10394","split",2,0,0,0,2
"10395","splitter",2,0,0,0,2
"10396","spoiled",1,0,1,0,2
"10397","spurned",1,1,0,0,2
"10398","squad",2,0,0,0,2
"10399","squirrels",1,1,0,0,2
"10400","stability",1,1,0,0,2
"10401","staid",0,0,2,0,2
"10402","stallo",0,0,0,2,2
"10403","stammering",1,1,0,0,2
"10404","stampede",2,0,0,0,2
"10405","staple",1,1,0,0,2
"10406","stare",1,0,1,0,2
"10407","starry",1,1,0,0,2
"10408","startles",1,1,0,0,2
"10409","states_",2,0,0,0,2
"10410","statesand",2,0,0,0,2
"10411","stayed",1,1,0,0,2
"10412","steadfast",2,0,0,0,2
"10413","steamship",2,0,0,0,2
"10414","steeps",0,0,0,2,2
"10415","steerage",1,1,0,0,2
"10416","steered",0,1,1,0,2
"10417","steering",1,1,0,0,2
"10418","stewards",1,1,0,0,2
"10419","stiffen",0,1,1,0,2
"10420","stilled",1,1,0,0,2
"10421","stimulate",1,0,1,0,2
"10422","stimulus",2,0,0,0,2
"10423","stinging",1,1,0,0,2
"10424","storks",0,1,1,0,2
"10425","stormed",1,1,0,0,2
"10426","stowe’s",1,1,0,0,2
"10427","straining",1,1,0,0,2
"10428","straits",0,1,0,1,2
"10429","strangelytold",2,0,0,0,2
"10430","stratagems",0,0,2,0,2
"10431","strategy",2,0,0,0,2
"10432","strengthening",2,0,0,0,2
"10433","stretching",0,2,0,0,2
"10434","strife",2,0,0,0,2
"10435","strikingly",1,1,0,0,2
"10436","stringency",1,1,0,0,2
"10437","strip",1,0,1,0,2
"10438","strive",1,1,0,0,2
"10439","strokes",1,1,0,0,2
"10440","struggling",0,1,0,1,2
"10441","stuck",0,2,0,0,2
"10442","students",2,0,0,0,2
"10443","studiedreserve",2,0,0,0,2
"10444","stuffed",1,0,1,0,2
"10445","stupor",0,1,1,0,2
"10446","stuttered",1,1,0,0,2
"10447","subdued",1,1,0,0,2
"10448","subjection",0,2,0,0,2
"10449","subjectof",2,0,0,0,2
"10450","sublimely",1,1,0,0,2
"10451","subscribe",0,1,1,0,2
"10452","subsiding",1,1,0,0,2
"10453","subsisted",1,1,0,0,2
"10454","subsisting",1,1,0,0,2
"10455","substance",2,0,0,0,2
"10456","substantially",2,0,0,0,2
"10457","subtle",1,1,0,0,2
"10458","subtlety",1,1,0,0,2
"10459","succeeds",0,2,0,0,2
"10460","succored",1,1,0,0,2
"10461","succulent",0,2,0,0,2
"10462","sucha",2,0,0,0,2
"10463","suez",0,0,0,2,2
"10464","sufferers",1,1,0,0,2
"10465","suffice",0,2,0,0,2
"10466","sufficiency",0,1,1,0,2
"10467","sulkeys",1,1,0,0,2
"10468","sulky",1,1,0,0,2
"10469","sullen",1,1,0,0,2
"10470","sullenness",1,1,0,0,2
"10471","summed",1,1,0,0,2
"10472","sumpon",1,1,0,0,2
"10473","sumpter",2,0,0,0,2
"10474","sundered",0,1,1,0,2
"10475","supercilious",1,1,0,0,2
"10476","superintended",1,1,0,0,2
"10477","superstitious",0,1,1,0,2
"10478","superstructure",2,0,0,0,2
"10479","supple",1,1,0,0,2
"10480","supporter",0,2,0,0,2
"10481","surmised",1,1,0,0,2
"10482","surmounted",0,1,0,1,2
"10483","surpassing",0,1,0,1,2
"10484","surprises",0,1,0,1,2
"10485","surveyed",0,1,0,1,2
"10486","susan",1,1,0,0,2
"10487","swaggering",1,1,0,0,2
"10488","swallowed",1,1,0,0,2
"10489","swamped",1,1,0,0,2
"10490","swearer",0,0,2,0,2
"10491","sweep",0,1,1,0,2
"10492","sweeter",2,0,0,0,2
"10493","sweetly",0,2,0,0,2
"10494","sweetness",0,2,0,0,2
"10495","swiftest",1,1,0,0,2
"10496","swimmingly",0,2,0,0,2
"10497","switch",0,1,1,0,2
"10498","swords",2,0,0,0,2
"10499","sworn",2,0,0,0,2
"10500","swung",1,1,0,0,2
"10501","symmetrical",2,0,0,0,2
"10502","sympathetic",2,0,0,0,2
"10503","synagogues",0,1,1,0,2
"10504","tables",1,1,0,0,2
"10505","tablets",0,0,0,2,2
"10506","tackle",2,0,0,0,2
"10507","tailed",1,1,0,0,2
"10508","tails",0,2,0,0,2
"10509","take",0,0,0,2,2
"10510","takea",2,0,0,0,2
"10511","takecare",2,0,0,0,2
"10512","takethe",2,0,0,0,2
"10513","talons",1,1,0,0,2
"10514","tamely",2,0,0,0,2
"10515","tampering",1,1,0,0,2
"10516","taney",2,0,0,0,2
"10517","tappan",2,0,0,0,2
"10518","tar",0,0,2,0,2
"10519","tardily",1,1,0,0,2
"10520","tardy",2,0,0,0,2
"10521","tarry",1,1,0,0,2
"10522","tattling",1,1,0,0,2
"10523","teas",1,1,0,0,2
"10524","telegram",2,0,0,0,2
"10525","temerity",1,1,0,0,2
"10526","temperanceconvention",2,0,0,0,2
"10527","tempered",0,2,0,0,2
"10528","tempers",1,0,1,0,2
"10529","temples",0,0,0,2,2
"10530","temporarily",1,1,0,0,2
"10531","tenderest",0,2,0,0,2
"10532","tenderly",1,1,0,0,2
"10533","tendrils",0,2,0,0,2
"10534","tenor",1,1,0,0,2
"10535","termagant",1,1,0,0,2
"10536","termof",2,0,0,0,2
"10537","terribly",2,0,0,0,2
"10538","terrify",0,1,1,0,2
"10539","territorial",2,0,0,0,2
"10540","terrors",0,2,0,0,2
"10541","testament",0,1,1,0,2
"10542","testaments",1,1,0,0,2
"10543","texas",2,0,0,0,2
"10544","thaddeus",2,0,0,0,2
"10545","thames",1,1,0,0,2
"10546","thanhe",2,0,0,0,2
"10547","thankful",1,0,0,1,2
"10548","thata",2,0,0,0,2
"10549","thatas",2,0,0,0,2
"10550","thateven",2,0,0,0,2
"10551","thatif",2,0,0,0,2
"10552","thatin",2,0,0,0,2
"10553","thatis",2,0,0,0,2
"10554","thatmade",2,0,0,0,2
"10555","thatshe",2,0,0,0,2
"10556","thatthis",2,0,0,0,2
"10557","thatthough",2,0,0,0,2
"10558","theablest",2,0,0,0,2
"10559","theabolitionists",2,0,0,0,2
"10560","theappearance",2,0,0,0,2
"10561","theargument",2,0,0,0,2
"10562","theattempt",2,0,0,0,2
"10563","theblack",2,0,0,0,2
"10564","theborders",2,0,0,0,2
"10565","theclaims",2,0,0,0,2
"10566","theconductor",2,0,0,0,2
"10567","theconvention",2,0,0,0,2
"10568","thecorn",2,0,0,0,2
"10569","thecourse",2,0,0,0,2
"10570","thecowardly",2,0,0,0,2
"10571","thedepositors",2,0,0,0,2
"10572","thedouble",2,0,0,0,2
"10573","theengland",2,0,0,0,2
"10574","theevening",2,0,0,0,2
"10575","thefact",2,0,0,0,2
"10576","thefar",2,0,0,0,2
"10577","thefield",2,0,0,0,2
"10578","theft",0,1,1,0,2
"10579","thegentleman",2,0,0,0,2
"10580","theground",2,0,0,0,2
"10581","thehands",2,0,0,0,2
"10582","theholidays",2,0,0,0,2
"10583","thehonor",2,0,0,0,2
"10584","theiradvice",2,0,0,0,2
"10585","theirmasters",2,0,0,0,2
"10586","thekey",2,0,0,0,2
"10587","thekitchen",2,0,0,0,2
"10588","thelash",2,0,0,0,2
"10589","thelatter",2,0,0,0,2
"10590","thelaw",2,0,0,0,2
"10591","thelight",2,0,0,0,2
"10592","thelittle",2,0,0,0,2
"10593","thelives",2,0,0,0,2
"10594","theman",2,0,0,0,2
"10595","themanagement",2,0,0,0,2
"10596","themanner",2,0,0,0,2
"10597","themat",2,0,0,0,2
"10598","themoment",2,0,0,0,2
"10599","themountains",2,0,0,0,2
"10600","themthe",2,0,0,0,2
"10601","thence",0,0,0,2,2
"10602","thenew",2,0,0,0,2
"10603","theopen",2,0,0,0,2
"10604","theopposite",2,0,0,0,2
"10605","theories",1,1,0,0,2
"10606","theperformance",2,0,0,0,2
"10607","thepotomac",2,0,0,0,2
"10608","thepower",2,0,0,0,2
"10609","thepresence",2,0,0,0,2
"10610","theprison",2,0,0,0,2
"10611","therapidity",2,0,0,0,2
"10612","thereabouts",1,1,0,0,2
"10613","thereader",2,0,0,0,2
"10614","thereal",2,0,0,0,2
"10615","thereassembled",2,0,0,0,2
"10616","therepublic",2,0,0,0,2
"10617","therest",2,0,0,0,2
"10618","therewith",1,1,0,0,2
"10619","theroad",2,0,0,0,2
"10620","theroot",2,0,0,0,2
"10621","theseexcellent",2,0,0,0,2
"10622","thesegentlemen",2,0,0,0,2
"10623","theservice",2,0,0,0,2
"10624","theship",2,0,0,0,2
"10625","thesimple",2,0,0,0,2
"10626","thesituation",2,0,0,0,2
"10627","theslaveholding",2,0,0,0,2
"10628","thesociety",2,0,0,0,2
"10629","thesoil",2,0,0,0,2
"10630","thespirit",2,0,0,0,2
"10631","thestate",2,0,0,0,2
"10632","thestern",2,0,0,0,2
"10633","thestreets",2,0,0,0,2
"10634","thestrongest",2,0,0,0,2
"10635","thetable",2,0,0,0,2
"10636","theterritory",2,0,0,0,2
"10637","thetown",2,0,0,0,2
"10638","thetroubles",2,0,0,0,2
"10639","thevarious",2,0,0,0,2
"10640","thevoice",2,0,0,0,2
"10641","thewharves",2,0,0,0,2
"10642","theybeen",2,0,0,0,2
"10643","theymight",2,0,0,0,2
"10644","theyshould",2,0,0,0,2
"10645","theywould",2,0,0,0,2
"10646","thickly",1,1,0,0,2
"10647","thickness",0,2,0,0,2
"10648","thine",0,0,2,0,2
"10649","thing",0,0,0,2,2
"10650","thirds",1,0,0,1,2
"10651","thirteenth",1,1,0,0,2
"10652","thisbank",2,0,0,0,2
"10653","thiscountry",2,0,0,0,2
"10654","thisgreat",2,0,0,0,2
"10655","thisrule",2,0,0,0,2
"10656","thistime",2,0,0,0,2
"10657","thomas_",1,1,0,0,2
"10658","thoroughfares",1,1,0,0,2
"10659","thoughthere",2,0,0,0,2
"10660","thoughtsand",2,0,0,0,2
"10661","thralldom",0,2,0,0,2
"10662","threeyears",2,0,0,0,2
"10663","thrice",1,1,0,0,2
"10664","throb",1,1,0,0,2
"10665","throughall",2,0,0,0,2
"10666","throughthe",2,0,0,0,2
"10667","thumping",1,1,0,0,2
"10668","thundered",0,2,0,0,2
"10669","tickets",2,0,0,0,2
"10670","tightly",1,1,0,0,2
"10671","tilgmans",1,1,0,0,2
"10672","tilling",2,0,0,0,2
"10673","tilton",1,0,0,1,2
"10674","timei",2,0,0,0,2
"10675","timeof",2,0,0,0,2
"10676","timethere",2,0,0,0,2
"10677","timewhen",2,0,0,0,2
"10678","tinged",2,0,0,0,2
"10679","tippling",1,1,0,0,2
"10680","toaccomplish",2,0,0,0,2
"10681","toamerica",2,0,0,0,2
"10682","toanswer",2,0,0,0,2
"10683","toascertain",2,0,0,0,2
"10684","toboth",2,0,0,0,2
"10685","tocanada",2,0,0,0,2
"10686","toe",0,0,0,2,2
"10687","tofight",2,0,0,0,2
"10688","tofind",2,0,0,0,2
"10689","tofreedom",2,0,0,0,2
"10690","togeneral",2,0,0,0,2
"10691","toget",2,0,0,0,2
"10692","tohim",2,0,0,0,2
"10693","toiled",0,2,0,0,2
"10694","tojustify",2,0,0,0,2
"10695","tokeep",2,0,0,0,2
"10696","tolly",1,1,0,0,2
"10697","tommy’s",1,1,0,0,2
"10698","tomrs",2,0,0,0,2
"10699","tookthe",2,0,0,0,2
"10700","tool",1,1,0,0,2
"10701","topermit",2,0,0,0,2
"10702","toprevent",2,0,0,0,2
"10703","topurchase",2,0,0,0,2
"10704","toput",2,0,0,0,2
"10705","torrent",2,0,0,0,2
"10706","toshow",2,0,0,0,2
"10707","toslaves",2,0,0,0,2
"10708","tosome",2,0,0,0,2
"10709","toss",1,1,0,0,2
"10710","tossed",2,0,0,0,2
"10711","tostand",2,0,0,0,2
"10712","toted",1,1,0,0,2
"10713","totheir",2,0,0,0,2
"10714","tothose",2,0,0,0,2
"10715","tough",1,1,0,0,2
"10716","toward",0,0,0,2,2
"10717","toyour",2,0,0,0,2
"10718","tracing",1,1,0,0,2
"10719","tract",1,1,0,0,2
"10720","tracts",1,1,0,0,2
"10721","trait",0,1,1,0,2
"10722","traitor",1,1,0,0,2
"10723","traitors",2,0,0,0,2
"10724","tramping",1,1,0,0,2
"10725","trample",1,1,0,0,2
"10726","trampling",1,0,1,0,2
"10727","tranquilizing",1,1,0,0,2
"10728","trans",2,0,0,0,2
"10729","transactions",1,1,0,0,2
"10730","transcendent",1,1,0,0,2
"10731","transfer",1,1,0,0,2
"10732","transferable",0,1,1,0,2
"10733","transitory",1,1,0,0,2
"10734","transparent",1,1,0,0,2
"10735","transpire",0,2,0,0,2
"10736","travelling",0,0,1,1,2
"10737","treacherously",0,1,0,1,2
"10738","treatment_",0,2,0,0,2
"10739","tributary",1,1,0,0,2
"10740","trick",1,1,0,0,2
"10741","trifled",2,0,0,0,2
"10742","triflers",2,0,0,0,2
"10743","triggers",1,1,0,0,2
"10744","trinkets",1,1,0,0,2
"10745","triumphs",1,1,0,0,2
"10746","trivial",1,1,0,0,2
"10747","troubling",1,1,0,0,2
"10748","trout",1,1,0,0,2
"10749","truce",1,1,0,0,2
"10750","truest",2,0,0,0,2
"10751","truethat",2,0,0,0,2
"10752","truthfully",1,1,0,0,2
"10753","tumultous",0,2,0,0,2
"10754","turk",1,1,0,0,2
"10755","turkey",1,1,0,0,2
"10756","turkeys",1,1,0,0,2
"10757","turnpikes",1,1,0,0,2
"10758","tutors",1,1,0,0,2
"10759","tweed",1,1,0,0,2
"10760","twelfth",1,0,1,0,2
"10761","twist",1,1,0,0,2
"10762","twomiles",2,0,0,0,2
"10763","twoyears",2,0,0,0,2
"10764","unaccountably",2,0,0,0,2
"10765","unaccustomed",0,1,1,0,2
"10766","unalloyed",1,1,0,0,2
"10767","unanimity",1,1,0,0,2
"10768","unanimous",0,0,2,0,2
"10769","unassisted",1,1,0,0,2
"10770","unauthorized",1,1,0,0,2
"10771","unbelief",1,1,0,0,2
"10772","unbounded",0,1,1,0,2
"10773","uncensured",0,1,1,0,2
"10774","unchain",2,0,0,0,2
"10775","unchaste",1,1,0,0,2
"10776","unconsciousness",2,0,0,0,2
"10777","uncontrollable",2,0,0,0,2
"10778","undeniable",1,1,0,0,2
"10779","under_",1,1,0,0,2
"10780","undercalculate",1,1,0,0,2
"10781","undergo",0,1,1,0,2
"10782","underhis",2,0,0,0,2
"10783","underrate",0,2,0,0,2
"10784","underrated",1,1,0,0,2
"10785","undeserving",1,1,0,0,2
"10786","undignified",1,1,0,0,2
"10787","undone",0,0,2,0,2
"10788","undue",2,0,0,0,2
"10789","uneasiness",0,2,0,0,2
"10790","unequaled",1,1,0,0,2
"10791","unexcited",0,2,0,0,2
"10792","unexplained",0,1,1,0,2
"10793","unfailing",0,2,0,0,2
"10794","unfairly",1,0,1,0,2
"10795","unfeeling",1,1,0,0,2
"10796","unfitted",2,0,0,0,2
"10797","unflagging",1,1,0,0,2
"10798","unflinching",2,0,0,0,2
"10799","unfrequent",0,2,0,0,2
"10800","unfulfilled",1,1,0,0,2
"10801","unharmed",2,0,0,0,2
"10802","unholy",0,2,0,0,2
"10803","uniformity",1,1,0,0,2
"10804","uniformly",0,2,0,0,2
"10805","union_",2,0,0,0,2
"10806","unit",1,1,0,0,2
"10807","unity",2,0,0,0,2
"10808","unjustly",1,1,0,0,2
"10809","unlooked",1,1,0,0,2
"10810","unlucky",1,1,0,0,2
"10811","unmanly",1,1,0,0,2
"10812","unmarried",1,1,0,0,2
"10813","unnecessarily",1,1,0,0,2
"10814","unperverted",1,1,0,0,2
"10815","unplaned",1,1,0,0,2
"10816","unpromising",1,1,0,0,2
"10817","unpunished",0,1,1,0,2
"10818","unresolved",1,1,0,0,2
"10819","unsatisfactory",1,1,0,0,2
"10820","unscriptural",0,1,1,0,2
"10821","unseared",1,1,0,0,2
"10822","unseemly",1,1,0,0,2
"10823","unsightly",1,1,0,0,2
"10824","unsoundness",1,1,0,0,2
"10825","unspeakable",2,0,0,0,2
"10826","unsuited",1,1,0,0,2
"10827","unthrifty",1,1,0,0,2
"10828","untili",2,0,0,0,2
"10829","untried",1,0,1,0,2
"10830","untrodden",0,1,1,0,2
"10831","untrue",1,0,1,0,2
"10832","unveil",1,0,0,1,2
"10833","unwhipped",0,1,1,0,2
"10834","unwonted",1,1,0,0,2
"10835","upa",2,0,0,0,2
"10836","upas",1,1,0,0,2
"10837","upbraided",1,1,0,0,2
"10838","upbraiding",1,1,0,0,2
"10839","upin",2,0,0,0,2
"10840","upona",2,0,0,0,2
"10841","uponme",2,0,0,0,2
"10842","uponmy",2,0,0,0,2
"10843","upright",1,1,0,0,2
"10844","uproar",2,0,0,0,2
"10845","upsetting",1,1,0,0,2
"10846","upstir",1,1,0,0,2
"10847","upto",2,0,0,0,2
"10848","upward",0,1,1,0,2
"10849","upwith",2,0,0,0,2
"10850","urgently",1,1,0,0,2
"10851","use",0,0,0,2,2
"10852","usedto",2,0,0,0,2
"10853","useof",2,0,0,0,2
"10854","uttermost",2,0,0,0,2
"10855","utters",0,1,0,1,2
"10856","vainly",1,1,0,0,2
"10857","validity",2,0,0,0,2
"10858","valueless",2,0,0,0,2
"10859","van",2,0,0,0,2
"10860","vantage",1,1,0,0,2
"10861","variable",1,1,0,0,2
"10862","variance",1,1,0,0,2
"10863","vastly",0,2,0,0,2
"10864","vehemence",2,0,0,0,2
"10865","vehicles",1,1,0,0,2
"10866","veil",0,2,0,0,2
"10867","veiled",0,0,0,2,2
"10868","velvet",1,1,0,0,2
"10869","venerate",1,1,0,0,2
"10870","venison",1,1,0,0,2
"10871","verdict",2,0,0,0,2
"10872","verse",0,2,0,0,2
"10873","version",0,2,0,0,2
"10874","verylittle",2,0,0,0,2
"10875","vestige",1,0,1,0,2
"10876","vesuvius",0,0,0,2,2
"10877","vexations",1,1,0,0,2
"10878","vexatious",1,1,0,0,2
"10879","vice_",0,2,0,0,2
"10880","vices",0,1,1,0,2
"10881","vicksburg",2,0,0,0,2
"10882","victor",2,0,0,0,2
"10883","victories",1,1,0,0,2
"10884","vieing",1,1,0,0,2
"10885","viewto",2,0,0,0,2
"10886","villa",0,0,0,2,2
"10887","villain",1,1,0,0,2
"10888","vine",1,1,0,0,2
"10889","violator",1,1,0,0,2
"10890","violenthands",2,0,0,0,2
"10891","violin",1,1,0,0,2
"10892","virginia’s",2,0,0,0,2
"10893","virtues",0,2,0,0,2
"10894","virus",1,1,0,0,2
"10895","visions",1,1,0,0,2
"10896","vitality",0,2,0,0,2
"10897","vocabulary",0,2,0,0,2
"10898","voluptuary",1,1,0,0,2
"10899","votaries",0,1,1,0,2
"10900","voyages",1,1,0,0,2
"10901","vultures",1,1,0,0,2
"10902","wafted",1,1,0,0,2
"10903","waged",2,0,0,0,2
"10904","wagner",2,0,0,0,2
"10905","wagoner",0,0,0,2,2
"10906","wail",0,2,0,0,2
"10907","wakefulness",0,1,1,0,2
"10908","waking",1,1,0,0,2
"10909","walnut",2,0,0,0,2
"10910","warbling",1,1,0,0,2
"10911","wardrobe",1,1,0,0,2
"10912","warehouses",0,1,1,0,2
"10913","warmest",1,1,0,0,2
"10914","wasalways",2,0,0,0,2
"10915","wasassailed",2,0,0,0,2
"10916","wascommitted",2,0,0,0,2
"10917","wasequal",2,0,0,0,2
"10918","wasfrequently",2,0,0,0,2
"10919","wasfully",2,0,0,0,2
"10920","wasimpossible",2,0,0,0,2
"10921","wasin",2,0,0,0,2
"10922","wasintroduced",2,0,0,0,2
"10923","wasmr",2,0,0,0,2
"10924","wasmuch",2,0,0,0,2
"10925","wasnever",2,0,0,0,2
"10926","wasour",2,0,0,0,2
"10927","wassomething",2,0,0,0,2
"10928","wasstrictly",2,0,0,0,2
"10929","wasting",1,1,0,0,2
"10930","waswilling",2,0,0,0,2
"10931","weakening",1,0,1,0,2
"10932","weapon",0,2,0,0,2
"10933","wearied",1,0,1,0,2
"10934","weavers",1,1,0,0,2
"10935","weaving",0,1,1,0,2
"10936","weep",1,1,0,0,2
"10937","weightier",0,0,2,0,2
"10938","weighty",1,1,0,0,2
"10939","weird",2,0,0,0,2
"10940","wentat",2,0,0,0,2
"10941","werein",2,0,0,0,2
"10942","werenow",2,0,0,0,2
"10943","werethe",2,0,0,0,2
"10944","wesaw",2,0,0,0,2
"10945","weshall",2,0,0,0,2
"10946","westerly",1,1,0,0,2
"10947","westminster",1,1,0,0,2
"10948","wetted",1,1,0,0,2
"10949","whatdo",2,0,0,0,2
"10950","whatever",0,0,0,2,2
"10951","whatto",2,0,0,0,2
"10952","whenin",2,0,0,0,2
"10953","whenthey",2,0,0,0,2
"10954","whenthis",2,0,0,0,2
"10955","wherefore",0,2,0,0,2
"10956","whereit",2,0,0,0,2
"10957","wherewith",0,2,0,0,2
"10958","whichat",2,0,0,0,2
"10959","whichcould",2,0,0,0,2
"10960","whichit",2,0,0,0,2
"10961","whichpromise",2,0,0,0,2
"10962","whichshould",2,0,0,0,2
"10963","whichthe",2,0,0,0,2
"10964","whichthey",2,0,0,0,2
"10965","whigs",2,0,0,0,2
"10966","whirl",0,1,1,0,2
"10967","whirled",1,1,0,0,2
"10968","whirling",0,1,0,1,2
"10969","whiskey",2,0,0,0,2
"10970","whistling",1,1,0,0,2
"10971","whiteness",0,1,0,1,2
"10972","whitewash",1,1,0,0,2
"10973","whohas",2,0,0,0,2
"10974","wholecountry",2,0,0,0,2
"10975","whomhe",2,0,0,0,2
"10976","whomi",2,0,0,0,2
"10977","wider",1,1,0,0,2
"10978","widespread",2,0,0,0,2
"10979","widest",0,0,2,0,2
"10980","widows",1,0,1,0,2
"10981","wife’s",0,1,1,0,2
"10982","wilberforce",2,0,0,0,2
"10983","wilk",0,1,1,0,2
"10984","willbe",2,0,0,0,2
"10985","willed",1,1,0,0,2
"10986","williams",2,0,0,0,2
"10987","willow",1,1,0,0,2
"10988","willows",1,1,0,0,2
"10989","wills",2,0,0,0,2
"10990","windmill",0,2,0,0,2
"10991","windowless",1,1,0,0,2
"10992","wines",1,1,0,0,2
"10993","wipe",1,0,1,0,2
"10994","wish",0,0,0,2,2
"10995","withhis",2,0,0,0,2
"10996","withoutany",2,0,0,0,2
"10997","withslaves",2,0,0,0,2
"10998","withsome",2,0,0,0,2
"10999","won’t_",1,1,0,0,2
"11000","wooing",1,1,0,0,2
"11001","wordsof",2,0,0,0,2
"11002","work_",1,1,0,0,2
"11003","working",0,0,0,2,2
"11004","workings",2,0,0,0,2
"11005","workshops",2,0,0,0,2
"11006","worldly",1,1,0,0,2
"11007","worried",1,1,0,0,2
"11008","worshiped",1,1,0,0,2
"11009","worshiper",1,1,0,0,2
"11010","worshippers",0,0,0,2,2
"11011","worsted",1,1,0,0,2
"11012","wouldemancipate",2,0,0,0,2
"11013","wouldemploy",2,0,0,0,2
"11014","wrapt",1,1,0,0,2
"11015","wreak",1,1,0,0,2
"11016","wrecked",1,1,0,0,2
"11017","wrench",1,1,0,0,2
"11018","wrested",0,2,0,0,2
"11019","wrestle",1,1,0,0,2
"11020","wrightson",1,1,0,0,2
"11021","wringing",1,1,0,0,2
"11022","writer",1,0,1,0,2
"11023","writers",1,1,0,0,2
"11024","wronged",1,1,0,0,2
"11025","xii",0,2,0,0,2
"11026","xiii",0,2,0,0,2
"11027","xiv",0,2,0,0,2
"11028","xix",0,2,0,0,2
"11029","xv",0,2,0,0,2
"11030","xvii",0,2,0,0,2
"11031","xx",0,2,0,0,2
"11032","xxi",0,2,0,0,2
"11033","xxii",0,2,0,0,2
"11034","xxiii",0,2,0,0,2
"11035","xxiv",0,2,0,0,2
"11036","xxv",0,2,0,0,2
"11037","yankee",0,1,0,1,2
"11038","yarn",1,1,0,0,2
"11039","yearling",1,1,0,0,2
"11040","yearsago",2,0,0,0,2
"11041","yelling",1,1,0,0,2
"11042","you_",1,1,0,0,2
"11043","youngchildren",2,0,0,0,2
"11044","youngman",2,0,0,0,2
"11045","鎑",2,0,0,0,2
"11046"," la",0,0,0,1,1
"11047"," ptly",0,0,0,1,1
"11048"," rue",0,0,0,1,1
"11049"," tuesday",0,0,0,1,1
"11050","_à",1,0,0,0,1
"11051","_a_",0,1,0,0,1
"11052","_abolition",0,0,1,0,1
"11053","_abolition_",0,0,1,0,1
"11054","_abolitionist",0,0,1,0,1
"11055","_abolitionists",0,1,0,0,1
"11056","_abolitionists_",1,0,0,0,1
"11057","_abroad_",0,1,0,0,1
"11058","_aggressive_",0,1,0,0,1
"11059","_allowances_",1,0,0,0,1
"11060","_always",0,0,1,0,1
"11061","_angel_",0,1,0,0,1
"11062","_answer_",0,1,0,0,1
"11063","_anxious_",1,0,0,0,1
"11064","_appearance_",0,1,0,0,1
"11065","_april_",0,0,1,0,1
"11066","_are",1,0,0,0,1
"11067","_aside_",1,0,0,0,1
"11068","_augustus",0,1,0,0,1
"11069","_bagged_",1,0,0,0,1
"11070","_bags_",1,0,0,0,1
"11071","_bailey_",0,0,1,0,1
"11072","_baltimore",0,1,0,0,1
"11073","_band",1,0,0,0,1
"11074","_be",1,0,0,0,1
"11075","_bible_",0,1,0,0,1
"11076","_bondage_",0,1,0,0,1
"11077","_born_",0,1,0,0,1
"11078","_box",0,1,0,0,1
"11079","_brandy_",0,1,0,0,1
"11080","_breaking_",1,0,0,0,1
"11081","_brevard’s",0,1,0,0,1
"11082","_bribe_",0,1,0,0,1
"11083","_british",0,1,0,0,1
"11084","_brute_",0,1,0,0,1
"11085","_but",0,0,1,0,1
"11086","_by",0,1,0,0,1
"11087","_candles_",1,0,0,0,1
"11088","_cannot",0,1,0,0,1
"11089","_capt",0,1,0,0,1
"11090","_caste_",0,1,0,0,1
"11091","_charles",0,0,1,0,1
"11092","_chattel_",0,1,0,0,1
"11093","_child_",0,1,0,0,1
"11094","_children_",0,1,0,0,1
"11095","_chronicle_",1,0,0,0,1
"11096","_colored_",0,1,0,0,1
"11097","_come",1,0,0,0,1
"11098","_could_",0,1,0,0,1
"11099","_cripple",0,1,0,0,1
"11100","_cue_",1,0,0,0,1
"11101","_daniel",0,0,1,0,1
"11102","_dare_",0,1,0,0,1
"11103","_darg_",0,0,1,0,1
"11104","_day_",0,1,0,0,1
"11105","_death",0,1,0,0,1
"11106","_degradation_",1,0,0,0,1
"11107","_demigod_",0,1,0,0,1
"11108","_desideratum",0,1,0,0,1
"11109","_desideratum_",0,1,0,0,1
"11110","_devil_",0,1,0,0,1
"11111","_did",1,0,0,0,1
"11112","_dissolve",1,0,0,0,1
"11113","_divination_",1,0,0,0,1
"11114","_doctors",0,1,0,0,1
"11115","_doctors_",1,0,0,0,1
"11116","_does_",0,1,0,0,1
"11117","_doubtful_",0,1,0,0,1
"11118","_douglass_",0,0,1,0,1
"11119","_dred",1,0,0,0,1
"11120","_editors_",1,0,0,0,1
"11121","_elevator_",1,0,0,0,1
"11122","_ell",0,0,1,0,1
"11123","_enemies_",0,1,0,0,1
"11124","_esther_",0,1,0,0,1
"11125","_etiquette_",0,1,0,0,1
"11126","_evangelist_",1,0,0,0,1
"11127","_even",0,1,0,0,1
"11128","_evening",1,0,0,0,1
"11129","_everything",0,1,0,0,1
"11130","_exceptions_",0,1,0,0,1
"11131","_executive",1,0,0,0,1
"11132","_faith_in",1,0,0,0,1
"11133","_fear_",0,1,0,0,1
"11134","_fellow",1,0,0,0,1
"11135","_fetiche_",0,1,0,0,1
"11136","_firstling_",0,1,0,0,1
"11137","_foggable_",0,1,0,0,1
"11138","_forever_",0,1,0,0,1
"11139","_forte_",0,0,1,0,1
"11140","_freedom’s",0,1,0,0,1
"11141","_freeman",0,1,0,0,1
"11142","_freemen_",1,0,0,0,1
"11143","_friendless_",0,1,0,0,1
"11144","_fugitive",1,0,0,0,1
"11145","_future_",0,1,0,0,1
"11146","_genius",0,1,0,0,1
"11147","_god",1,0,0,0,1
"11148","_god_",0,1,0,0,1
"11149","_gold",0,1,0,0,1
"11150","_gore",0,1,0,0,1
"11151","_got",0,1,0,0,1
"11152","_have",0,1,0,0,1
"11153","_he",0,1,0,0,1
"11154","_held",0,1,0,0,1
"11155","_hell_",0,1,0,0,1
"11156","_her_",0,1,0,0,1
"11157","_herald",1,0,0,0,1
"11158","_here_",1,0,0,0,1
"11159","_hickory",0,1,0,0,1
"11160","_hide_",0,0,1,0,1
"11161","_his_turn",1,0,0,0,1
"11162","_home",1,0,0,0,1
"11163","_home_",0,1,0,0,1
"11164","_honest_",0,1,0,0,1
"11165","_human_",0,1,0,0,1
"11166","_idols_",0,1,0,0,1
"11167","_if_it",1,0,0,0,1
"11168","_ignorance_",1,0,0,0,1
"11169","_imparted_",0,1,0,0,1
"11170","_impossible_",0,1,0,0,1
"11171","_in_",1,0,0,0,1
"11172","_inch",0,0,1,0,1
"11173","_indelible_",0,1,0,0,1
"11174","_independent_",1,0,0,0,1
"11175","_indirection_",0,1,0,0,1
"11176","_institution_",0,1,0,0,1
"11177","_intellectual_",0,1,0,0,1
"11178","_is_",0,1,0,0,1
"11179","_it",0,0,1,0,1
"11180","_itis",1,0,0,0,1
"11181","_jim",0,1,0,0,1
"11182","_johnson_",0,0,1,0,1
"11183","_july_",0,1,0,0,1
"11184","_keep",0,1,0,0,1
"11185","_kept_",0,1,0,0,1
"11186","_kill_",0,1,0,0,1
"11187","_kind",0,1,0,0,1
"11188","_kindness_",0,1,0,0,1
"11189","_knew_",0,1,0,0,1
"11190","_know_",1,0,0,0,1
"11191","_laughed",0,1,0,0,1
"11192","_lawyers_",1,0,0,0,1
"11193","_legree_",1,0,0,0,1
"11194","_letter",1,0,0,0,1
"11195","_liberator_came",1,0,0,0,1
"11196","_london",0,1,0,0,1
"11197","_long",0,1,0,0,1
"11198","_lord_",1,0,0,0,1
"11199","_loudly_",0,1,0,0,1
"11200","_loved_",0,1,0,0,1
"11201","_low_",0,1,0,0,1
"11202","_luck_",0,1,0,0,1
"11203","_made_",0,1,0,0,1
"11204","_man",0,1,0,0,1
"11205","_mange_",0,1,0,0,1
"11206","_marriage",0,1,0,0,1
"11207","_maryland_",0,1,0,0,1
"11208","_mass",0,0,1,0,1
"11209","_master’s",0,1,0,0,1
"11210","_med",0,1,0,0,1
"11211","_melee_",0,1,0,0,1
"11212","_mêlee_by",1,0,0,0,1
"11213","_men",0,1,0,0,1
"11214","_merchants_",1,0,0,0,1
"11215","_ministers_",1,0,0,0,1
"11216","_mixed",0,1,0,0,1
"11217","_months",0,1,0,0,1
"11218","_more_",0,1,0,0,1
"11219","_most",0,1,0,0,1
"11220","_mostly_",0,1,0,0,1
"11221","_mother_",0,1,0,0,1
"11222","_motherless_",0,1,0,0,1
"11223","_mr.dixon_",1,0,0,0,1
"11224","_mrs",1,0,0,0,1
"11225","_mush_",0,0,1,0,1
"11226","_narrate_",0,1,0,0,1
"11227","_narrate_wrongs",1,0,0,0,1
"11228","_narrative",0,0,1,0,1
"11229","_ne",1,0,0,0,1
"11230","_nearly_",0,1,0,0,1
"11231","_negro",0,1,0,0,1
"11232","_newera_",1,0,0,0,1
"11233","_next_",0,1,0,0,1
"11234","_nibbles_",0,1,0,0,1
"11235","_nom",1,0,0,0,1
"11236","_none_",0,1,0,0,1
"11237","_north_",0,1,0,0,1
"11238","_notes",0,1,0,0,1
"11239","_nothing_",0,1,0,0,1
"11240","_nothing_before",1,0,0,0,1
"11241","_notice",1,0,0,0,1
"11242","_nowhere_",0,1,0,0,1
"11243","_o",0,1,0,0,1
"11244","_obtained",0,0,1,0,1
"11245","_others_",0,1,0,0,1
"11246","_our_",0,1,0,0,1
"11247","_own_",0,1,0,0,1
"11248","_ox",1,0,0,0,1
"11249","_par",0,1,0,0,1
"11250","_pass",0,1,0,0,1
"11251","_pecked_",0,0,1,0,1
"11252","_perhaps_",0,1,0,0,1
"11253","_persons_",0,1,0,0,1
"11254","_pig_",0,1,0,0,1
"11255","_place_",0,1,0,0,1
"11256","_play_",0,1,0,0,1
"11257","_poorest_",0,1,0,0,1
"11258","_possible",0,1,0,0,1
"11259","_possible_for",1,0,0,0,1
"11260","_possibly_",0,1,0,0,1
"11261","_poverty_",1,0,0,0,1
"11262","_power_",1,0,0,0,1
"11263","_practical_",0,1,0,0,1
"11264","_precisely_",0,1,0,0,1
"11265","_prejudice",1,0,0,0,1
"11266","_probation_",0,1,0,0,1
"11267","_question_",0,1,0,0,1
"11268","_rage_",0,1,0,0,1
"11269","_really_",0,1,0,0,1
"11270","_really_against",1,0,0,0,1
"11271","_received_",0,1,0,0,1
"11272","_religion_",0,1,0,0,1
"11273","_religious_",0,0,1,0,1
"11274","_removal_",0,1,0,0,1
"11275","_rencontres_",0,1,0,0,1
"11276","_rev",1,0,0,0,1
"11277","_reverend_",0,1,0,0,1
"11278","_review_",1,0,0,0,1
"11279","_rich_",1,0,0,0,1
"11280","_righteous_",0,1,0,0,1
"11281","_root",0,0,1,0,1
"11282","_roots_",1,0,0,0,1
"11283","_rum_",0,1,0,0,1
"11284","_run",0,1,0,0,1
"11285","_salt",0,1,0,0,1
"11286","_sandy",1,0,0,0,1
"11287","_save",1,0,0,0,1
"11288","_scheme",0,1,0,0,1
"11289","_seemed_",0,1,0,0,1
"11290","_seemings_",1,0,0,0,1
"11291","_shame_",0,1,0,0,1
"11292","_sheep_",0,0,1,0,1
"11293","_shooting",0,0,1,0,1
"11294","_shot",1,0,0,0,1
"11295","_silent",0,1,0,0,1
"11296","_slave",0,1,0,0,1
"11297","_slaveholding",0,0,1,0,1
"11298","_so",0,1,0,0,1
"11299","_some_",0,1,0,0,1
"11300","_somebody’s_",0,1,0,0,1
"11301","_south_",1,0,0,0,1
"11302","_speech",0,1,0,0,1
"11303","_spoil_",0,0,1,0,1
"11304","_standard",0,1,0,0,1
"11305","_star_",1,0,0,0,1
"11306","_starve",0,1,0,0,1
"11307","_starved",0,1,0,0,1
"11308","_starved_",1,0,0,0,1
"11309","_still",0,1,0,0,1
"11310","_strongly_",0,1,0,0,1
"11311","_stuffed_",0,1,0,0,1
"11312","_system_",1,0,0,0,1
"11313","_tar_",0,0,1,0,1
"11314","_that’s_",1,0,0,0,1
"11315","_their",0,1,0,0,1
"11316","_thing_",0,1,0,0,1
"11317","_things_",0,1,0,0,1
"11318","_this",1,0,0,0,1
"11319","_those",1,0,0,0,1
"11320","_time_",0,1,0,0,1
"11321","_tomahawk_",0,1,0,0,1
"11322","_too_",0,1,0,0,1
"11323","_took_",0,1,0,0,1
"11324","_tribune_",1,0,0,0,1
"11325","_trust",1,0,0,0,1
"11326","_tub_",0,1,0,0,1
"11327","_tuck",0,1,0,0,1
"11328","_tuckahoe_",0,1,0,0,1
"11329","_tuition",0,1,0,0,1
"11330","_two",1,0,0,0,1
"11331","_types",0,1,0,0,1
"11332","_un_friends",1,0,0,0,1
"11333","_un_like",1,0,0,0,1
"11334","_underground",0,0,1,0,1
"11335","_unsaintly_",0,1,0,0,1
"11336","_upon",0,0,1,0,1
"11337","_upperground",0,0,1,0,1
"11338","_vale",0,1,0,0,1
"11339","_voice_",0,1,0,0,1
"11340","_wailing",0,1,0,0,1
"11341","_was_",1,0,0,0,1
"11342","_welcome_",0,0,1,0,1
"11343","_went_",1,0,0,0,1
"11344","_what_the",1,0,0,0,1
"11345","_where",1,0,0,0,1
"11346","_where_",0,1,0,0,1
"11347","_whipped",0,1,0,0,1
"11348","_whisky",0,1,0,0,1
"11349","_with",0,0,1,0,1
"11350","_woldfolk_",0,1,0,0,1
"11351","_woman_",0,1,0,0,1
"11352","_work",0,1,0,0,1
"11353","_work_",0,1,0,0,1
"11354","_world’s_",1,0,0,0,1
"11355","_worse_",0,1,0,0,1
"11356","_written",1,0,0,0,1
"11357","_wrong_",0,1,0,0,1
"11358","_years",0,1,0,0,1
"11359","_yell_",1,0,0,0,1
"11360","_yes",1,0,0,0,1
"11361","_youlong",1,0,0,0,1
"11362","_yours_",0,1,0,0,1
"11363","1,000",1,0,0,0,1
"11364","1,400men",1,0,0,0,1
"11365","100",1,0,0,0,1
"11366","11th",0,0,1,0,1
"11367","13",1,0,0,0,1
"11368","148",0,1,0,0,1
"11369","150",1,0,0,0,1
"11370","16th",1,0,0,0,1
"11371","1776",0,0,1,0,1
"11372","1789",1,0,0,0,1
"11373","1793",1,0,0,0,1
"11374","1825that",1,0,0,0,1
"11375","1827",0,1,0,0,1
"11376","1828",1,0,0,0,1
"11377","1830to",1,0,0,0,1
"11378","1847till",1,0,0,0,1
"11379","1856to",1,0,0,0,1
"11380","1865",1,0,0,0,1
"11381","1879",1,0,0,0,1
"11382","1880",1,0,0,0,1
"11383","1895",0,0,1,0,1
"11384","19",1,0,0,0,1
"11385","1929",0,0,1,0,1
"11386","1992",0,0,1,0,1
"11387","2,000",1,0,0,0,1
"11388","20",0,0,1,0,1
"11389","21",1,0,0,0,1
"11390","22",0,0,1,0,1
"11391","25",0,0,1,0,1
"11392","3,000",1,0,0,0,1
"11393","30th",1,0,0,0,1
"11394","31",0,0,1,0,1
"11395","317",0,1,0,0,1
"11396","31st",1,0,0,0,1
"11397","339",0,1,0,0,1
"11398","4,000",1,0,0,0,1
"11399","413",1,0,0,0,1
"11400","46",0,1,0,0,1
"11401","50",1,0,0,0,1
"11402","52",0,1,0,0,1
"11403","54",0,1,0,0,1
"11404","54th’s",1,0,0,0,1
"11405","56",0,1,0,0,1
"11406","58",1,0,0,0,1
"11407","59",1,0,0,0,1
"11408","5colored",1,0,0,0,1
"11409","700",1,0,0,0,1
"11410","75,000",1,0,0,0,1
"11411","7o’clock",1,0,0,0,1
"11412","8,000,000",1,0,0,0,1
"11413","80per",1,0,0,0,1
"11414","a_bad_",1,0,0,0,1
"11415","a_future_",1,0,0,0,1
"11416","a.brownson",1,0,0,0,1
"11417","a.collins",1,0,0,0,1
"11418","a.douglas",1,0,0,0,1
"11419","abasement",1,0,0,0,1
"11420","abating",1,0,0,0,1
"11421","abbreviated",1,0,0,0,1
"11422","abbreviation",1,0,0,0,1
"11423","abe",1,0,0,0,1
"11424","abel’s",1,0,0,0,1
"11425","abetting",1,0,0,0,1
"11426","abettors",0,0,1,0,1
"11427","abhorring",0,1,0,0,1
"11428","abig",1,0,0,0,1
"11429","abilityto",1,0,0,0,1
"11430","abjectlysupplicating",1,0,0,0,1
"11431","ablanket",1,0,0,0,1
"11432","able’s",0,1,0,0,1
"11433","ableand",1,0,0,0,1
"11434","abler",0,1,0,0,1
"11435","ablution",0,1,0,0,1
"11436","aboard",0,1,0,0,1
"11437","abodes",0,1,0,0,1
"11438","abody",1,0,0,0,1
"11439","abolishedslavery",1,0,0,0,1
"11440","abolishthe",1,0,0,0,1
"11441","abolitionist.for",1,0,0,0,1
"11442","abolitionistin",1,0,0,0,1
"11443","abolitionistsbefore",1,0,0,0,1
"11444","abolitionst",0,1,0,0,1
"11445","abomination",1,0,0,0,1
"11446","abondage",1,0,0,0,1
"11447","abone",0,0,0,1,1
"11448","abook",1,0,0,0,1
"11449","abounded",0,0,1,0,1
"11450","abounds",0,0,0,1,1
"11451","about.but",1,0,0,0,1
"11452","aboutas",1,0,0,0,1
"11453","aboutfrom",1,0,0,0,1
"11454","aboutit",1,0,0,0,1
"11455","aboutslavery",1,0,0,0,1
"11456","aboutto",1,0,0,0,1
"11457","abrahamgarfield",1,0,0,0,1
"11458","abrahamlincoln.then",1,0,0,0,1
"11459","abrahamrodman",1,0,0,0,1
"11460","abram",1,0,0,0,1
"11461","abreast",1,0,0,0,1
"11462","abrick",1,0,0,0,1
"11463","abritish",1,0,0,0,1
"11464","abroad.eminent",1,0,0,0,1
"11465","abroad.while",1,0,0,0,1
"11466","abroadin",1,0,0,0,1
"11467","abruptly",0,0,0,1,1
"11468","absenceof",1,0,0,0,1
"11469","absenting",0,1,0,0,1
"11470","abstract",0,1,0,0,1
"11471","absurdity",1,0,0,0,1
"11472","absurdly",1,0,0,0,1
"11473","abundantlyable",1,0,0,0,1
"11474","abuseof",1,0,0,0,1
"11475","acareful",1,0,0,0,1
"11476","acceded",1,0,0,0,1
"11477","accelerated",0,1,0,0,1
"11478","accent",1,0,0,0,1
"11479","accents",1,0,0,0,1
"11480","acceptanceof",1,0,0,0,1
"11481","acceptingcontributions",1,0,0,0,1
"11482","accidentalslaveholder",1,0,0,0,1
"11483","acclimation",0,1,0,0,1
"11484","accomdation",0,0,0,1,1
"11485","accommodate",0,1,0,0,1
"11486","accommodating",0,1,0,0,1
"11487","accomodation",0,0,0,1,1
"11488","accompanygreen",1,0,0,0,1
"11489","accompanyingher",1,0,0,0,1
"11490","accomplice",1,0,0,0,1
"11491","accomplishes",0,1,0,0,1
"11492","accomplishthis",1,0,0,0,1
"11493","accomplishtwo",1,0,0,0,1
"11494","accorded",1,0,0,0,1
"11495","accords",0,1,0,0,1
"11496","accordwith",1,0,0,0,1
"11497","accountablebeings",1,0,0,0,1
"11498","accoustic",0,0,0,1,1
"11499","accredited",1,0,0,0,1
"11500","accrue",1,0,0,0,1
"11501","accumulate",1,0,0,0,1
"11502","accusationagainst",1,0,0,0,1
"11503","accuse",0,1,0,0,1
"11504","accusing",0,1,0,0,1
"11505","accustomedfrom",1,0,0,0,1
"11506","accustomedto",1,0,0,0,1
"11507","achieved",1,0,0,0,1
"11508","achristian",1,0,0,0,1
"11509","acircumstance",1,0,0,0,1
"11510","acknowledged",1,0,0,0,1
"11511","acknowledgedleader",1,0,0,0,1
"11512","acknowledgingthe",1,0,0,0,1
"11513","acknowledgment",0,1,0,0,1
"11514","acknowledgments",1,0,0,0,1
"11515","aclear",1,0,0,0,1
"11516","aclose",1,0,0,0,1
"11517","acompany",1,0,0,0,1
"11518","acondition",1,0,0,0,1
"11519","aconflagration.st",1,0,0,0,1
"11520","aconsciousness",1,0,0,0,1
"11521","aconstitution",1,0,0,0,1
"11522","acool",1,0,0,0,1
"11523","acordial",1,0,0,0,1
"11524","acorss",0,0,0,1,1
"11525","acountry",1,0,0,0,1
"11526","acourse",1,0,0,0,1
"11527","acquiring",1,0,0,0,1
"11528","acquisition",0,1,0,0,1
"11529","acquisition.if",1,0,0,0,1
"11530","acrack",1,0,0,0,1
"11531","acre",1,0,0,0,1
"11532","acropolis",0,0,0,1,1
"11533","across",0,0,0,1,1
"11534","act.seated",1,0,0,0,1
"11535","actedin",1,0,0,0,1
"11536","action.his",1,0,0,0,1
"11537","actively",1,0,0,0,1
"11538","actof",1,0,0,0,1
"11539","acumen",0,1,0,0,1
"11540","acutely",0,1,0,0,1
"11541","ada",0,0,0,1,1
"11542","adam",1,0,0,0,1
"11543","adaptation",1,0,0,0,1
"11544","addanother",1,0,0,0,1
"11545","addicted",0,0,1,0,1
"11546","additionto",1,0,0,0,1
"11547","addressedan",1,0,0,0,1
"11548","addressedas",1,0,0,0,1
"11549","addressesmade",1,0,0,0,1
"11550","addressesnot",1,0,0,0,1
"11551","addresshim",1,0,0,0,1
"11552","addressit",1,0,0,0,1
"11553","addressto",1,0,0,0,1
"11554","addresswhich",1,0,0,0,1
"11555","adduce",1,0,0,0,1
"11556","adecade",1,0,0,0,1
"11557","adeclaration",1,0,0,0,1
"11558","adelegate",1,0,0,0,1
"11559","adelicate",1,0,0,0,1
"11560","adelphic",0,0,0,1,1
"11561","adeptness",1,0,0,0,1
"11562","adequately",0,1,0,0,1
"11563","adherents",0,1,0,0,1
"11564","adhesion",1,0,0,0,1
"11565","adifferent",1,0,0,0,1
"11566","adirondacks",1,0,0,0,1
"11567","adistinguished",1,0,0,0,1
"11568","adjourned",1,0,0,0,1
"11569","adjudge",1,0,0,0,1
"11570","adjusted",0,1,0,0,1
"11571","adjustment",1,0,0,0,1
"11572","administering",0,1,0,0,1
"11573","admiration.when",1,0,0,0,1
"11574","admire",0,1,0,0,1
"11575","admirers",1,0,0,0,1
"11576","admitmy",1,0,0,0,1
"11577","admits",0,1,0,0,1
"11578","admittedardor",1,0,0,0,1
"11579","admittedon",1,0,0,0,1
"11580","admonition",0,1,0,0,1
"11581","admonitions",0,1,0,0,1
"11582","adomain",1,0,0,0,1
"11583","adopted.owing",1,0,0,0,1
"11584","adoptedcitizens",1,0,0,0,1
"11585","adoptedin",1,0,0,0,1
"11586","adoptthe",1,0,0,0,1
"11587","adore",0,0,0,1,1
"11588","adorning",0,1,0,0,1
"11589","adornment",0,1,0,0,1
"11590","adorns",1,0,0,0,1
"11591","adozen",1,0,0,0,1
"11592","adraft",1,0,0,0,1
"11593","adrove",1,0,0,0,1
"11594","adult",0,1,0,0,1
"11595","adulterer",0,0,1,0,1
"11596","advance_",0,1,0,0,1
"11597","advanceof",1,0,0,0,1
"11598","advantageof",1,0,0,0,1
"11599","advantageover",1,0,0,0,1
"11600","advantges",0,1,0,0,1
"11601","advent",0,1,0,0,1
"11602","adventurer",1,0,0,0,1
"11603","adversely",1,0,0,0,1
"11604","advertisement",0,1,0,0,1
"11605","advertising",0,1,0,0,1
"11606","advicevery",1,0,0,0,1
"11607","advise",1,0,0,0,1
"11608","advisers",1,0,0,0,1
"11609","advising",0,1,0,0,1
"11610","advisor",0,1,0,0,1
"11611","advocatedthem",1,0,0,0,1
"11612","advocateof",1,0,0,0,1
"11613","advocatesof",1,0,0,0,1
"11614","advocating",1,0,0,0,1
"11615","afailure",1,0,0,0,1
"11616","afather",1,0,0,0,1
"11617","afavorite",1,0,0,0,1
"11618","affable",1,0,0,0,1
"11619","affairs.this",1,0,0,0,1
"11620","affectation",1,0,0,0,1
"11621","affectedby",1,0,0,0,1
"11622","affection.amanda",1,0,0,0,1
"11623","affidavits",1,0,0,0,1
"11624","affirmative",0,1,0,0,1
"11625","affirmatively",0,1,0,0,1
"11626","afflict",1,0,0,0,1
"11627","affliction",0,1,0,0,1
"11628","affluence",0,1,0,0,1
"11629","affording",0,1,0,0,1
"11630","affordinga",1,0,0,0,1
"11631","affright",1,0,0,0,1
"11632","affrighted",0,1,0,0,1
"11633","afixed",1,0,0,0,1
"11634","afloat",0,0,0,1,1
"11635","aforeign",1,0,0,0,1
"11636","aforethought",0,1,0,0,1
"11637","afreeman",1,0,0,0,1
"11638","africa.there",1,0,0,0,1
"11639","africa.this",1,0,0,0,1
"11640","african.among",1,0,0,0,1
"11641","africanize",1,0,0,0,1
"11642","after1840",1,0,0,0,1
"11643","aftera",1,0,0,0,1
"11644","afterall",1,0,0,0,1
"11645","aftercol",1,0,0,0,1
"11646","afterleaving",1,0,0,0,1
"11647","afternight",1,0,0,0,1
"11648","afternoons",0,0,1,0,1
"11649","afterpamphlet",1,0,0,0,1
"11650","afterthis",1,0,0,0,1
"11651","afugitive",1,0,0,0,1
"11652","afurious",1,0,0,0,1
"11653","again.while",1,0,0,0,1
"11654","againcalled",1,0,0,0,1
"11655","againcongratulate",1,0,0,0,1
"11656","againon",1,0,0,0,1
"11657","againsta",1,0,0,0,1
"11658","againstannexation",1,0,0,0,1
"11659","againstevery",1,0,0,0,1
"11660","againstgod",1,0,0,0,1
"11661","againsthim",1,0,0,0,1
"11662","againsthuman",1,0,0,0,1
"11663","againstit",1,0,0,0,1
"11664","againstjohn",1,0,0,0,1
"11665","againstmy",1,0,0,0,1
"11666","againstone",1,0,0,0,1
"11667","againstthat",1,0,0,0,1
"11668","againstthe",1,0,0,0,1
"11669","againstus",1,0,0,0,1
"11670","againstwould",1,0,0,0,1
"11671","againto",1,0,0,0,1
"11672","againwithin",1,0,0,0,1
"11673","agardener",1,0,0,0,1
"11674","ageneral",1,0,0,0,1
"11675","agentleman",1,0,0,0,1
"11676","agentshad",1,0,0,0,1
"11677","agentsin",1,0,0,0,1
"11678","ages.there",1,0,0,0,1
"11679","agesof",1,0,0,0,1
"11680","aggo",0,0,0,1,1
"11681","aggrandizement",1,0,0,0,1
"11682","aggravated",0,0,1,0,1
"11683","aggravations",0,0,1,0,1
"11684","aggressionsettled",1,0,0,0,1
"11685","agitatedby",1,0,0,0,1
"11686","agitating",0,0,1,0,1
"11687","agitationonly",1,0,0,0,1
"11688","agitator",1,0,0,0,1
"11689","agitators",1,0,0,0,1
"11690","aglance",1,0,0,0,1
"11691","aglorious",1,0,0,0,1
"11692","ago.the",1,0,0,0,1
"11693","agonizingprayers",1,0,0,0,1
"11694","agovernment",1,0,0,0,1
"11695","agreat",1,0,0,0,1
"11696","agreedto",1,0,0,0,1
"11697","agreeing",0,0,0,1,1
"11698","agricultural",0,1,0,0,1
"11699","agriculture",1,0,0,0,1
"11700","ahalf",1,0,0,0,1
"11701","ahand",1,0,0,0,1
"11702","ahealth",1,0,0,0,1
"11703","ahell",1,0,0,0,1
"11704","ahelpless",1,0,0,0,1
"11705","ahigh",1,0,0,0,1
"11706","ahundred",1,0,0,0,1
"11707","aid.of",1,0,0,0,1
"11708","aid.strangely",1,0,0,0,1
"11709","aidedin",1,0,0,0,1
"11710","aidrendered",1,0,0,0,1
"11711","aims.in",1,0,0,0,1
"11712","aimsof",1,0,0,0,1
"11713","airat",1,0,0,0,1
"11714","airwhich",1,0,0,0,1
"11715","airy",0,1,0,0,1
"11716","aisles",0,1,0,0,1
"11717","ajury",1,0,0,0,1
"11718","aknockdown",1,0,0,0,1
"11719","alabastercravat",1,0,0,0,1
"11720","alamb",1,0,0,0,1
"11721","alarge",1,0,0,0,1
"11722","alarming",0,1,0,0,1
"11723","aldridge",0,1,0,0,1
"11724","alecture",1,0,0,0,1
"11725","alesson",1,0,0,0,1
"11726","alex",0,0,0,1,1
"11727","alexanderdunlop",1,0,0,0,1
"11728","alexandria",0,0,0,1,1
"11729","alfestume",0,0,0,1,1
"11730","ali",0,1,0,0,1
"11731","alighted",0,1,0,0,1
"11732","alistener",1,0,0,0,1
"11733","all.at",1,0,0,0,1
"11734","all.for",1,0,0,0,1
"11735","all.held",1,0,0,0,1
"11736","all.i",1,0,0,0,1
"11737","all.taking",1,0,0,0,1
"11738","all’s",1,0,0,0,1
"11739","allan",1,0,0,0,1
"11740","allappalled",1,0,0,0,1
"11741","allartificial",1,0,0,0,1
"11742","allas",1,0,0,0,1
"11743","allay",1,0,0,0,1
"11744","allayed",1,0,0,0,1
"11745","allblack",1,0,0,0,1
"11746","allborrowed",1,0,0,0,1
"11747","allchoice",1,0,0,0,1
"11748","allclimes",1,0,0,0,1
"11749","allcountries.take",1,0,0,0,1
"11750","allday",1,0,0,0,1
"11751","alldirections",1,0,0,0,1
"11752","alldistinctions",1,0,0,0,1
"11753","alleghanies",1,0,0,0,1
"11754","allen",0,0,0,1,1
"11755","alleyes",1,0,0,0,1
"11756","allhis",1,0,0,0,1
"11757","allhope",1,0,0,0,1
"11758","alliceana",1,0,0,0,1
"11759","allied",0,0,1,0,1
"11760","allin",1,0,0,0,1
"11761","allits",1,0,0,0,1
"11762","allkept",1,0,0,0,1
"11763","allmanner",1,0,0,0,1
"11764","allmen",1,0,0,0,1
"11765","allone",1,0,0,0,1
"11766","allother",1,0,0,0,1
"11767","allotments",0,1,0,0,1
"11768","allowable",1,0,0,0,1
"11769","allowanced",0,0,1,0,1
"11770","allowedhimself",1,0,0,0,1
"11771","allowedit",1,0,0,0,1
"11772","allowhimself",1,0,0,0,1
"11773","allowhis",1,0,0,0,1
"11774","allowniggers",1,0,0,0,1
"11775","allowthem",1,0,0,0,1
"11776","alloy",1,0,0,0,1
"11777","allpersons",1,0,0,0,1
"11778","allplaces",1,0,0,0,1
"11779","allsemblance",1,0,0,0,1
"11780","allslavery",1,0,0,0,1
"11781","allsorts",1,0,0,0,1
"11782","allsubjected",1,0,0,0,1
"11783","allthese",1,0,0,0,1
"11784","allthis",1,0,0,0,1
"11785","allthree",1,0,0,0,1
"11786","alltook",1,0,0,0,1
"11787","allude",0,1,0,0,1
"11788","alluding",0,1,0,0,1
"11789","alludingto",1,0,0,0,1
"11790","allured",0,1,0,0,1
"11791","allvoices",1,0,0,0,1
"11792","allwent",1,0,0,0,1
"11793","allwithout",1,0,0,0,1
"11794","almostheart",1,0,0,0,1
"11795","almostprovidentially",1,0,0,0,1
"11796","almostsure",1,0,0,0,1
"11797","aloft",0,1,0,0,1
"11798","alone",0,0,0,1,1
"11799","alone.now",1,0,0,0,1
"11800","alonewithout",1,0,0,0,1
"11801","alongbehind",1,0,0,0,1
"11802","aloof",0,1,0,0,1
"11803","alpheus",1,0,0,0,1
"11804","alphonsojanes",1,0,0,0,1
"11805","alps",0,0,0,1,1
"11806","alreadybeen",1,0,0,0,1
"11807","alreadyby",1,0,0,0,1
"11808","alreadycome",1,0,0,0,1
"11809","alreadydescribed",1,0,0,0,1
"11810","alreadynarrated",1,0,0,0,1
"11811","also.this",1,0,0,0,1
"11812","alsodid",1,0,0,0,1
"11813","alsofrom",1,0,0,0,1
"11814","alsothe",1,0,0,0,1
"11815","altantic",0,0,0,1,1
"11816","altarfenced",1,0,0,0,1
"11817","alter",1,0,0,0,1
"11818","altering",1,0,0,0,1
"11819","alternatives",1,0,0,0,1
"11820","alters",0,0,0,1,1
"11821","althoughthis",1,0,0,0,1
"11822","altogethera",1,0,0,0,1
"11823","altogethercreditable",1,0,0,0,1
"11824","altogetherdisclaim",1,0,0,0,1
"11825","altogethergroundless",1,0,0,0,1
"11826","alvin",1,0,0,0,1
"11827","always",0,0,0,1,1
"11828","alwaysfeel",1,0,0,0,1
"11829","alwayshad",1,0,0,0,1
"11830","alwayshalf",1,0,0,0,1
"11831","alwaysopen",1,0,0,0,1
"11832","alwaystoo",1,0,0,0,1
"11833","alwaysunsuccessful",1,0,0,0,1
"11834","amagistrate",1,0,0,0,1
"11835","amagnificent",1,0,0,0,1
"11836","amalmost",1,0,0,0,1
"11837","amanda’s",1,0,0,0,1
"11838","amandaauld",1,0,0,0,1
"11839","amaster",1,0,0,0,1
"11840","amaze",1,0,0,0,1
"11841","amazedwith",1,0,0,0,1
"11842","ambiguous",0,1,0,0,1
"11843","amdigressing.after",1,0,0,0,1
"11844","ameasure",1,0,0,0,1
"11845","ameeting",1,0,0,0,1
"11846","ameliorate",0,1,0,0,1
"11847","amelioration",1,0,0,0,1
"11848","amend",1,0,0,0,1
"11849","amendmentto",1,0,0,0,1
"11850","ameriacn",0,1,0,0,1
"11851","america_",0,1,0,0,1
"11852","america.messrs",1,0,0,0,1
"11853","america’s",1,0,0,0,1
"11854","americancitizens",1,0,0,0,1
"11855","americanheart",1,0,0,0,1
"11856","americanhouse",1,0,0,0,1
"11857","americanpassengers",1,0,0,0,1
"11858","americanpeople",1,0,0,0,1
"11859","americansenate",1,0,0,0,1
"11860","americanslavery",1,0,0,0,1
"11861","amglad",1,0,0,0,1
"11862","amhappy",1,0,0,0,1
"11863","amiablequalities",1,0,0,0,1
"11864","amiablethan",1,0,0,0,1
"11865","amiserable",1,0,0,0,1
"11866","ammonite",0,1,0,0,1
"11867","amno",1,0,0,0,1
"11868","amongfriends",1,0,0,0,1
"11869","amongnew",1,0,0,0,1
"11870","amongourselves",1,0,0,0,1
"11871","amongthem",1,0,0,0,1
"11872","amongus",1,0,0,0,1
"11873","amorancy",1,0,0,0,1
"11874","amore",1,0,0,0,1
"11875","amos",1,0,0,0,1
"11876","amother’s",1,0,0,0,1
"11877","amphetheatre ",0,0,0,1,1
"11878","amplify",0,1,0,0,1
"11879","amputation",1,0,0,0,1
"11880","amquite",1,0,0,0,1
"11881","amremoved",1,0,0,0,1
"11882","amsick",1,0,0,0,1
"11883","amstrengthened",1,0,0,0,1
"11884","amsure",1,0,0,0,1
"11885","amultitude",1,0,0,0,1
"11886","amused",0,1,0,0,1
"11887","amusements",1,0,0,0,1
"11888","amypost",1,0,0,0,1
"11889","anabolition",1,0,0,0,1
"11890","anabolitionist",1,0,0,0,1
"11891","anachronisms",1,0,0,0,1
"11892","anaddress",1,0,0,0,1
"11893","analarming",1,0,0,0,1
"11894","anall",1,0,0,0,1
"11895","analogous",1,0,0,0,1
"11896","analogy",0,1,0,0,1
"11897","analysis",0,1,0,0,1
"11898","anational",1,0,0,0,1
"11899","anattempt",1,0,0,0,1
"11900","anaudience",1,0,0,0,1
"11901","ancestor",0,1,0,0,1
"11902","ancestors",1,0,0,0,1
"11903","and55th",1,0,0,0,1
"11904","andability",1,0,0,0,1
"11905","andadmiration.late",1,0,0,0,1
"11906","andadopted",1,0,0,0,1
"11907","andadoption",1,0,0,0,1
"11908","andaffectionate",1,0,0,0,1
"11909","andaggressive",1,0,0,0,1
"11910","andalabama",1,0,0,0,1
"11911","andalso",1,0,0,0,1
"11912","andamalgamation",1,0,0,0,1
"11913","andamongst",1,0,0,0,1
"11914","andappalling",1,0,0,0,1
"11915","andappliances",1,0,0,0,1
"11916","andappointed",1,0,0,0,1
"11917","andapprehension",1,0,0,0,1
"11918","andarmed",1,0,0,0,1
"11919","andaround",1,0,0,0,1
"11920","andascertain",1,0,0,0,1
"11921","andasked",1,0,0,0,1
"11922","andat",1,0,0,0,1
"11923","andbayonet",1,0,0,0,1
"11924","andbe",1,0,0,0,1
"11925","andbeauty.the",1,0,0,0,1
"11926","andbecause",1,0,0,0,1
"11927","andbelieved",1,0,0,0,1
"11928","andbeneficent",1,0,0,0,1
"11929","andbest",1,0,0,0,1
"11930","andbetter",1,0,0,0,1
"11931","andbloodshed",1,0,0,0,1
"11932","andblowing",1,0,0,0,1
"11933","andbound",1,0,0,0,1
"11934","andbrandies",1,0,0,0,1
"11935","andbrave",1,0,0,0,1
"11936","andbreathing",1,0,0,0,1
"11937","andbrother",1,0,0,0,1
"11938","andbrought",1,0,0,0,1
"11939","andbruises",1,0,0,0,1
"11940","andbrutal",1,0,0,0,1
"11941","andburned",1,0,0,0,1
"11942","andbutter",1,0,0,0,1
"11943","andcapricious",1,0,0,0,1
"11944","andcaused",1,0,0,0,1
"11945","andcelebrate",1,0,0,0,1
"11946","andcentral",1,0,0,0,1
"11947","andchronicle_",1,0,0,0,1
"11948","andcircumstances",1,0,0,0,1
"11949","andcivilization",1,0,0,0,1
"11950","andclear",1,0,0,0,1
"11951","andclothe",1,0,0,0,1
"11952","andco",1,0,0,0,1
"11953","andcold",1,0,0,0,1
"11954","andcolor",1,0,0,0,1
"11955","andcomforts",1,0,0,0,1
"11956","andcompetent",1,0,0,0,1
"11957","andcompletely",1,0,0,0,1
"11958","andconduct",1,0,0,0,1
"11959","andconductor",1,0,0,0,1
"11960","andconsider",1,0,0,0,1
"11961","andconversation",1,0,0,0,1
"11962","andcoppering",1,0,0,0,1
"11963","andcordially",1,0,0,0,1
"11964","andcreated",1,0,0,0,1
"11965","andcredit",1,0,0,0,1
"11966","anddaring",1,0,0,0,1
"11967","anddates",1,0,0,0,1
"11968","andday",1,0,0,0,1
"11969","anddesire",1,0,0,0,1
"11970","anddesperate",1,0,0,0,1
"11971","anddespite",1,0,0,0,1
"11972","anddestroy",1,0,0,0,1
"11973","anddestroying",1,0,0,0,1
"11974","anddestructive",1,0,0,0,1
"11975","anddeveloping",1,0,0,0,1
"11976","anddevising",1,0,0,0,1
"11977","anddid",1,0,0,0,1
"11978","anddignity",1,0,0,0,1
"11979","anddiscreditable",1,0,0,0,1
"11980","anddisparagement",1,0,0,0,1
"11981","anddistinctive",1,0,0,0,1
"11982","anddivided",1,0,0,0,1
"11983","anddo",1,0,0,0,1
"11984","anddried",1,0,0,0,1
"11985","andearnest",1,0,0,0,1
"11986","andeconomy",1,0,0,0,1
"11987","andeffectively",1,0,0,0,1
"11988","andelegantly",1,0,0,0,1
"11989","andeloquent",1,0,0,0,1
"11990","andelsewhere",1,0,0,0,1
"11991","andembarrassment",1,0,0,0,1
"11992","andempty",1,0,0,0,1
"11993","andencountered",1,0,0,0,1
"11994","andended",1,0,0,0,1
"11995","andending",1,0,0,0,1
"11996","andenjoying",1,0,0,0,1
"11997","andenough",1,0,0,0,1
"11998","andequality",1,0,0,0,1
"11999","andersonkindly",1,0,0,0,1
"12000","andersonville",1,0,0,0,1
"12001","andevergreens",1,0,0,0,1
"12002","andevery",1,0,0,0,1
"12003","andexacting",1,0,0,0,1
"12004","andexceeding",1,0,0,0,1
"12005","andexemplary",1,0,0,0,1
"12006","andexperience",1,0,0,0,1
"12007","andexperienced",1,0,0,0,1
"12008","andfear",1,0,0,0,1
"12009","andfeelings",1,0,0,0,1
"12010","andfifteenth",1,0,0,0,1
"12011","andfills",1,0,0,0,1
"12012","andfitting",1,0,0,0,1
"12013","andfought",1,0,0,0,1
"12014","andfretful",1,0,0,0,1
"12015","andfriendless",1,0,0,0,1
"12016","andfurnished",1,0,0,0,1
"12017","andgeese",1,0,0,0,1
"12018","andgenerosity",1,0,0,0,1
"12019","andgenerous",1,0,0,0,1
"12020","andgiven",1,0,0,0,1
"12021","andgrandeur",1,0,0,0,1
"12022","andgreatest",1,0,0,0,1
"12023","andgrief",1,0,0,0,1
"12024","andhated",1,0,0,0,1
"12025","andhateful",1,0,0,0,1
"12026","andhe",1,0,0,0,1
"12027","andheart",1,0,0,0,1
"12028","andhelped",1,0,0,0,1
"12029","andhence",1,0,0,0,1
"12030","andhere",1,0,0,0,1
"12031","andheroic",1,0,0,0,1
"12032","andhis",1,0,0,0,1
"12033","andhope",1,0,0,0,1
"12034","andhow",1,0,0,0,1
"12035","andhumane.it",1,0,0,0,1
"12036","andhumanity",1,0,0,0,1
"12037","andhurled",1,0,0,0,1
"12038","andif",1,0,0,0,1
"12039","andillustrative",1,0,0,0,1
"12040","andimparted",1,0,0,0,1
"12041","andimpatient",1,0,0,0,1
"12042","andimportant",1,0,0,0,1
"12043","andimprisonment",1,0,0,0,1
"12044","andinalienable",1,0,0,0,1
"12045","andinciting",1,0,0,0,1
"12046","andinconvenient",1,0,0,0,1
"12047","andinfluential",1,0,0,0,1
"12048","andink",1,0,0,0,1
"12049","andinspired",1,0,0,0,1
"12050","andireland",1,0,0,0,1
"12051","andjudging",1,0,0,0,1
"12052","andkill",1,0,0,0,1
"12053","andlabors",1,0,0,0,1
"12054","andlaid",1,0,0,0,1
"12055","andlanguor",1,0,0,0,1
"12056","andlargely",1,0,0,0,1
"12057","andlash",1,0,0,0,1
"12058","andlate",1,0,0,0,1
"12059","andlectured",1,0,0,0,1
"12060","andlooking",1,0,0,0,1
"12061","andlucretia.the",1,0,0,0,1
"12062","andmade",1,0,0,0,1
"12063","andmake",1,0,0,0,1
"12064","andmanner",1,0,0,0,1
"12065","andmary",1,0,0,0,1
"12066","andmaterially",1,0,0,0,1
"12067","andmatured",1,0,0,0,1
"12068","andmean",1,0,0,0,1
"12069","andmeet",1,0,0,0,1
"12070","andmight",1,0,0,0,1
"12071","andmill",1,0,0,0,1
"12072","andmisbehaving",1,0,0,0,1
"12073","andmistress",1,0,0,0,1
"12074","andmoney",1,0,0,0,1
"12075","andmorals",1,0,0,0,1
"12076","andmore",1,0,0,0,1
"12077","andmournful",1,0,0,0,1
"12078","andmoved",1,0,0,0,1
"12079","andmr",1,0,0,0,1
"12080","andmrs",1,0,0,0,1
"12081","andmuch",1,0,0,0,1
"12082","andmurray",1,0,0,0,1
"12083","andmuscular",1,0,0,0,1
"12084","andmyself.he",1,0,0,0,1
"12085","andmyself.i",1,0,0,0,1
"12086","andnecessary",1,0,0,0,1
"12087","andno",1,0,0,0,1
"12088","andnoisy",1,0,0,0,1
"12089","andnow",1,0,0,0,1
"12090","andobtained",1,0,0,0,1
"12091","andobtaining",1,0,0,0,1
"12092","andoccupied",1,0,0,0,1
"12093","andoffered",1,0,0,0,1
"12094","andonly",1,0,0,0,1
"12095","andoratory",1,0,0,0,1
"12096","andother",1,0,0,0,1
"12097","andothers",1,0,0,0,1
"12098","andourselves",1,0,0,0,1
"12099","andover.i",1,0,0,0,1
"12100","andpea",1,0,0,0,1
"12101","andpears",1,0,0,0,1
"12102","andperemptory",1,0,0,0,1
"12103","andperhaps",1,0,0,0,1
"12104","andperished",1,0,0,0,1
"12105","andperpetuate",1,0,0,0,1
"12106","andpersecuted.methodists",1,0,0,0,1
"12107","andpersecuting",1,0,0,0,1
"12108","andpersuading",1,0,0,0,1
"12109","andpersuasive",1,0,0,0,1
"12110","andphilanthropic",1,0,0,0,1
"12111","andphysical",1,0,0,0,1
"12112","andplans",1,0,0,0,1
"12113","andplenty",1,0,0,0,1
"12114","andpointed",1,0,0,0,1
"12115","andpossessed",1,0,0,0,1
"12116","andpossibly",1,0,0,0,1
"12117","andpounded",1,0,0,0,1
"12118","andpowerful",1,0,0,0,1
"12119","andpracticed",1,0,0,0,1
"12120","andprayers",1,0,0,0,1
"12121","andprepared",1,0,0,0,1
"12122","andprimitive",1,0,0,0,1
"12123","andprofit",1,0,0,0,1
"12124","andpropriety",1,0,0,0,1
"12125","andproscriptive",1,0,0,0,1
"12126","andproviding",1,0,0,0,1
"12127","andpurpose.up",1,0,0,0,1
"12128","andpurposes",1,0,0,0,1
"12129","andquality",1,0,0,0,1
"12130","andraising",1,0,0,0,1
"12131","andre",0,0,0,1,1
"12132","andreaction",1,0,0,0,1
"12133","andreadily",1,0,0,0,1
"12134","andreasonably",1,0,0,0,1
"12135","andrebuke",1,0,0,0,1
"12136","andreciprocated",1,0,0,0,1
"12137","andrelated",1,0,0,0,1
"12138","andreligious",1,0,0,0,1
"12139","andremember",1,0,0,0,1
"12140","andrent",1,0,0,0,1
"12141","andrespect",1,0,0,0,1
"12142","andrespectability",1,0,0,0,1
"12143","andrevolting",1,0,0,0,1
"12144","andrew’s",1,0,0,0,1
"12145","andrewjohnson",1,0,0,0,1
"12146","andrichard",1,0,0,0,1
"12147","andsaid",1,0,0,0,1
"12148","andsatisfaction",1,0,0,0,1
"12149","andsatisfactory",1,0,0,0,1
"12150","andsaved",1,0,0,0,1
"12151","andsaw",1,0,0,0,1
"12152","andscoured",1,0,0,0,1
"12153","andsecurely",1,0,0,0,1
"12154","andseeking",1,0,0,0,1
"12155","andsent",1,0,0,0,1
"12156","andsentiments",1,0,0,0,1
"12157","andseparate",1,0,0,0,1
"12158","andseverely",1,0,0,0,1
"12159","andshelter",1,0,0,0,1
"12160","andshield",1,0,0,0,1
"12161","andshocking",1,0,0,0,1
"12162","andskillful",1,0,0,0,1
"12163","andslave",1,0,0,0,1
"12164","andslavery",1,0,0,0,1
"12165","andslaves",1,0,0,0,1
"12166","andsleeping",1,0,0,0,1
"12167","andso",1,0,0,0,1
"12168","andsome",1,0,0,0,1
"12169","andsometimes",1,0,0,0,1
"12170","andsouls",1,0,0,0,1
"12171","andsouthern",1,0,0,0,1
"12172","andspiritual",1,0,0,0,1
"12173","andspoke",1,0,0,0,1
"12174","andstaggered",1,0,0,0,1
"12175","andstarboard",1,0,0,0,1
"12176","andstarvation",1,0,0,0,1
"12177","andstation",1,0,0,0,1
"12178","andstonington",1,0,0,0,1
"12179","andstraight",1,0,0,0,1
"12180","andstrength",1,0,0,0,1
"12181","andstruts",1,0,0,0,1
"12182","andsuccessful",1,0,0,0,1
"12183","andsudden",1,0,0,0,1
"12184","andsuffered",1,0,0,0,1
"12185","andsummer’s",1,0,0,0,1
"12186","andsumner",1,0,0,0,1
"12187","andsupposed",1,0,0,0,1
"12188","andsuppressed",1,0,0,0,1
"12189","andsurpass",1,0,0,0,1
"12190","andsurrendered",1,0,0,0,1
"12191","andswearing",1,0,0,0,1
"12192","andtears",1,0,0,0,1
"12193","andtendered",1,0,0,0,1
"12194","andtheir",1,0,0,0,1
"12195","andthen",1,0,0,0,1
"12196","andtheoretical",1,0,0,0,1
"12197","andthey",1,0,0,0,1
"12198","andthinking",1,0,0,0,1
"12199","andthompson",1,0,0,0,1
"12200","andthus",1,0,0,0,1
"12201","andtie",1,0,0,0,1
"12202","andtold",1,0,0,0,1
"12203","andtorn",1,0,0,0,1
"12204","andtraveled",1,0,0,0,1
"12205","andtreacherous",1,0,0,0,1
"12206","andtrust",1,0,0,0,1
"12207","andtruth",1,0,0,0,1
"12208","andtumble",1,0,0,0,1
"12209","anduniformly",1,0,0,0,1
"12210","andunreasonable",1,0,0,0,1
"12211","andunsubstantial",1,0,0,0,1
"12212","andunwavering",1,0,0,0,1
"12213","anduseless",1,0,0,0,1
"12214","andvirginia",1,0,0,0,1
"12215","andwar",1,0,0,0,1
"12216","andwatch",1,0,0,0,1
"12217","andwater",1,0,0,0,1
"12218","andwearisome",1,0,0,0,1
"12219","andwelfare",1,0,0,0,1
"12220","andwell",1,0,0,0,1
"12221","andwent",1,0,0,0,1
"12222","andwere",1,0,0,0,1
"12223","andwhenever",1,0,0,0,1
"12224","andwhile",1,0,0,0,1
"12225","andwhip",1,0,0,0,1
"12226","andwhite",1,0,0,0,1
"12227","andwhose",1,0,0,0,1
"12228","andwicked",1,0,0,0,1
"12229","andwickedness",1,0,0,0,1
"12230","andwithout",1,0,0,0,1
"12231","andwolfish",1,0,0,0,1
"12232","andwon",1,0,0,0,1
"12233","andwould",1,0,0,0,1
"12234","andwrong.until",1,0,0,0,1
"12235","andy",1,0,0,0,1
"12236","andyours",1,0,0,0,1
"12237","anecdote",0,0,1,0,1
"12238","aneminence",1,0,0,0,1
"12239","anend",1,0,0,0,1
"12240","anenglishman",1,0,0,0,1
"12241","anenlightened",1,0,0,0,1
"12242","anexample",1,0,0,0,1
"12243","angelic",0,0,1,0,1
"12244","angelo",0,0,0,1,1
"12245","anguish.i",1,0,0,0,1
"12246","anhonorable",1,0,0,0,1
"12247","anigger",1,0,0,0,1
"12248","animalhad",1,0,0,0,1
"12249","anindian",1,0,0,0,1
"12250","aninfluential",1,0,0,0,1
"12251","aninnovation",1,0,0,0,1
"12252","aninstinctive",1,0,0,0,1
"12253","anintelligent",1,0,0,0,1
"12254","anise",0,0,1,0,1
"12255","ankles",1,0,0,0,1
"12256","annerversary",0,0,0,1,1
"12257","annie",1,0,0,0,1
"12258","annoucement",0,0,0,1,1
"12259","announcingmyself",1,0,0,0,1
"12260","annoying",0,1,0,0,1
"12261","annual",1,0,0,0,1
"12262","annum",0,1,0,0,1
"12263","anoble",1,0,0,0,1
"12264","anoffense",1,0,0,0,1
"12265","anold",1,0,0,0,1
"12266","anomalous",0,0,1,0,1
"12267","anon",0,1,0,0,1
"12268","anontoo",1,0,0,0,1
"12269","anopposite",1,0,0,0,1
"12270","anordinary",1,0,0,0,1
"12271","another.nature",1,0,0,0,1
"12272","another.the",1,0,0,0,1
"12273","another’s",0,1,0,0,1
"12274","anotherand",1,0,0,0,1
"12275","anotherstriking",1,0,0,0,1
"12276","anotherto",1,0,0,0,1
"12277","anotherwas",1,0,0,0,1
"12278","anoverseer",1,0,0,0,1
"12279","anox.night",1,0,0,0,1
"12280","answer.i",1,0,0,0,1
"12281","answeri",1,0,0,0,1
"12282","ant’ney",0,1,0,0,1
"12283","antagonism",1,0,0,0,1
"12284","antagonized",1,0,0,0,1
"12285","anterior",0,1,0,0,1
"12286","anthems",0,1,0,0,1
"12287","anthemsof",1,0,0,0,1
"12288","anticipated",0,1,0,0,1
"12289","anticipating",1,0,0,0,1
"12290","antiquity",0,0,0,1,1
"12291","antoinette",1,0,0,0,1
"12292","anupper",1,0,0,0,1
"12293","anxiousi",1,0,0,0,1
"12294","anybody",0,0,0,1,1
"12295","anybody.i",1,0,0,0,1
"12296","anybodyhas",1,0,0,0,1
"12297","anycolor",1,0,0,0,1
"12298","anycolored",1,0,0,0,1
"12299","anycommission",1,0,0,0,1
"12300","anyconsiderable",1,0,0,0,1
"12301","anyconversation",1,0,0,0,1
"12302","anyextent",1,0,0,0,1
"12303","anyimpropriety",1,0,0,0,1
"12304","anyinstances",1,0,0,0,1
"12305","anyknowledge",1,0,0,0,1
"12306","anylonger",1,0,0,0,1
"12307","anyof",1,0,0,0,1
"12308","anyone",0,0,0,1,1
"12309","anyport",1,0,0,0,1
"12310","anyright",1,0,0,0,1
"12311","anysense",1,0,0,0,1
"12312","anysubject",1,0,0,0,1
"12313","anything",0,0,0,1,1
"12314","anything.on",1,0,0,0,1
"12315","anythingmore",1,0,0,0,1
"12316","anythingwhich",1,0,0,0,1
"12317","anythingwithout",1,0,0,0,1
"12318","anywhere",0,0,0,1,1
"12319","anywhite",1,0,0,0,1
"12320","anywho",1,0,0,0,1
"12321","apainful",1,0,0,0,1
"12322","apartfrom",1,0,0,0,1
"12323","aparty",1,0,0,0,1
"12324","apassport",1,0,0,0,1
"12325","apathy",1,0,0,0,1
"12326","apatriot",1,0,0,0,1
"12327","apeople",1,0,0,0,1
"12328","aphorism",0,1,0,0,1
"12329","apious",1,0,0,0,1
"12330","apistol",1,0,0,0,1
"12331","aplin",1,0,0,0,1
"12332","apoint",1,0,0,0,1
"12333","apologized",1,0,0,0,1
"12334","apologizing",0,0,1,0,1
"12335","aposition",1,0,0,0,1
"12336","apostates",0,1,0,0,1
"12337","apostateswas",1,0,0,0,1
"12338","apostle",0,0,0,1,1
"12339","apostles_",1,0,0,0,1
"12340","apostrophizing",0,0,1,0,1
"12341","apound",1,0,0,0,1
"12342","apoverty",1,0,0,0,1
"12343","apower",1,0,0,0,1
"12344","apparent.the",1,0,0,0,1
"12345","apparentlyreached",1,0,0,0,1
"12346","apparentlyvigorous",1,0,0,0,1
"12347","apparentunconsciousness",1,0,0,0,1
"12348","appealsand",1,0,0,0,1
"12349","appealsof",1,0,0,0,1
"12350","appear",0,0,0,1,1
"12351","appearancealtogether",1,0,0,0,1
"12352","appearances",0,1,0,0,1
"12353","appearedmore",1,0,0,0,1
"12354","appease",1,0,0,0,1
"12355","append",0,0,1,0,1
"12356","apperences",0,0,0,1,1
"12357","appertained",1,0,0,0,1
"12358","applaudingthe",1,0,0,0,1
"12359","applause.it",1,0,0,0,1
"12360","applausefrom",1,0,0,0,1
"12361","apples",1,0,0,0,1
"12362","applicants",0,1,0,0,1
"12363","appliedto",1,0,0,0,1
"12364","applies",0,0,1,0,1
"12365","applins",1,0,0,0,1
"12366","appointed.i",1,0,0,0,1
"12367","appointmentby",1,0,0,0,1
"12368","appointmentto",1,0,0,0,1
"12369","apportionment",1,0,0,0,1
"12370","appraised",0,1,0,0,1
"12371","appreciable",0,1,0,0,1
"12372","appreciateand",1,0,0,0,1
"12373","apprehendedcrash",1,0,0,0,1
"12374","apprehendedevil",1,0,0,0,1
"12375","apprehending",1,0,0,0,1
"12376","apprehensions",1,0,0,0,1
"12377","apprehensionwas",1,0,0,0,1
"12378","apprised",0,1,0,0,1
"12379","approachthem",1,0,0,0,1
"12380","appropriate",0,0,0,1,1
"12381","appropriated",1,0,0,0,1
"12382","appropriatefield",1,0,0,0,1
"12383","approving",1,0,0,0,1
"12384","apresent",1,0,0,0,1
"12385","apresentiment",1,0,0,0,1
"12386","april_",0,0,1,0,1
"12387","april14th",1,0,0,0,1
"12388","apromise",1,0,0,0,1
"12389","apron",0,1,0,0,1
"12390","aprospect",1,0,0,0,1
"12391","aproverb",1,0,0,0,1
"12392","aptly",0,1,0,0,1
"12393","apunishment",1,0,0,0,1
"12394","aqq",0,0,0,1,1
"12395","aquarter",1,0,0,0,1
"12396","arab",0,0,0,1,1
"12397","arabec",0,0,0,1,1
"12398","arabia",0,1,0,0,1
"12399","arabic",0,0,1,0,1
"12400","arangement",1,0,0,0,1
"12401","arbiter",1,0,0,0,1
"12402","arcades",0,0,0,1,1
"12403","archaeologist",1,0,0,0,1
"12404","architect",1,0,0,0,1
"12405","are_",1,0,0,0,1
"12406","areapoges",0,0,0,1,1
"12407","areasonable",1,0,0,0,1
"12408","areexceptions",1,0,0,0,1
"12409","arefull",1,0,0,0,1
"12410","arehooted",1,0,0,0,1
"12411","areimpartial",1,0,0,0,1
"12412","arematters",1,0,0,0,1
"12413","arenaof",1,0,0,0,1
"12414","arepresentation",1,0,0,0,1
"12415","arepresentative",1,0,0,0,1
"12416","arepublican",1,0,0,0,1
"12417","aretations",0,0,0,1,1
"12418","aretoo",1,0,0,0,1
"12419","areungrateful",1,0,0,0,1
"12420","arguethe",1,0,0,0,1
"12421","argument.it",1,0,0,0,1
"12422","argumentation",0,1,0,0,1
"12423","argumentsto",1,0,0,0,1
"12424","arh",0,0,0,1,1
"12425","arida",0,1,0,0,1
"12426","arise.he",1,0,0,0,1
"12427","arisento",1,0,0,0,1
"12428","arisesbetween",1,0,0,0,1
"12429","aristocratically",1,0,0,0,1
"12430","ark",0,0,1,0,1
"12431","armchair",1,0,0,0,1
"12432","armedbully",1,0,0,0,1
"12433","armedmen",1,0,0,0,1
"12434","armedwith",1,0,0,0,1
"12435","armless",1,0,0,0,1
"12436","army.in",1,0,0,0,1
"12437","arno",0,0,0,1,1
"12438","arnold",1,0,0,0,1
"12439","arnolds",1,0,0,0,1
"12440","aroudessmont",0,0,0,1,1
"12441","arough",1,0,0,0,1
"12442","aroundher",1,0,0,0,1
"12443","aroundme",1,0,0,0,1
"12444","aroundus.chapter",1,0,0,0,1
"12445","arouse",1,0,0,0,1
"12446","arrange",1,0,0,0,1
"12447","arrangedand",1,0,0,0,1
"12448","arrangedthat",1,0,0,0,1
"12449","arrangedwith",1,0,0,0,1
"12450","arrangement.i",1,0,0,0,1
"12451","arranging",0,1,0,0,1
"12452","arrestall",1,0,0,0,1
"12453","arrestand",1,0,0,0,1
"12454","arrested.had",1,0,0,0,1
"12455","arrests",1,0,0,0,1
"12456","arrivalin",1,0,0,0,1
"12457","arrive",1,0,0,0,1
"12458","arroganceand",1,0,0,0,1
"12459","arrogant",0,1,0,0,1
"12460","arrogt",0,0,0,1,1
"12461","arsenic",1,0,0,0,1
"12462","artfullydeceived",1,0,0,0,1
"12463","arther",0,0,0,1,1
"12464","artificers",0,0,0,1,1
"12465","artificialadornment",1,0,0,0,1
"12466","artificies",0,0,0,1,1
"12467","artless",1,0,0,0,1
"12468","artof",1,0,0,0,1
"12469","arush",1,0,0,0,1
"12470","asair",1,0,0,0,1
"12471","asalready",1,0,0,0,1
"12472","asany",1,0,0,0,1
"12473","asare",1,0,0,0,1
"12474","asbest",1,0,0,0,1
"12475","asbill",1,0,0,0,1
"12476","asblows",1,0,0,0,1
"12477","ascendancy",1,0,0,0,1
"12478","ascendency",1,0,0,0,1
"12479","ascent",0,0,0,1,1
"12480","ascertainthe",1,0,0,0,1
"12481","aschattels",1,0,0,0,1
"12482","ascholar",1,0,0,0,1
"12483","asconscience",1,0,0,0,1
"12484","ascream",1,0,0,0,1
"12485","aseat",1,0,0,0,1
"12486","asecurity",1,0,0,0,1
"12487","asense",1,0,0,0,1
"12488","asentinel",1,0,0,0,1
"12489","aset",1,0,0,0,1
"12490","asever",1,0,0,0,1
"12491","asexpress",1,0,0,0,1
"12492","asfor",1,0,0,0,1
"12493","asfortune",1,0,0,0,1
"12494","asgroundless",1,0,0,0,1
"12495","ashers",1,0,0,0,1
"12496","ashilling",1,0,0,0,1
"12497","ashis",1,0,0,0,1
"12498","ashort",1,0,0,0,1
"12499","asidefrom",1,0,0,0,1
"12500","asimpudence",1,0,0,0,1
"12501","asinstigators",1,0,0,0,1
"12502","asits",1,0,0,0,1
"12503","asituation",1,0,0,0,1
"12504","asked",0,0,0,1,1
"12505","asked.every",1,0,0,0,1
"12506","askedhim",1,0,0,0,1
"12507","askedin",1,0,0,0,1
"12508","askedpermission",1,0,0,0,1
"12509","askedthemselves",1,0,0,0,1
"12510","askedwhat",1,0,0,0,1
"12511","aslaveholder",1,0,0,0,1
"12512","aslender",1,0,0,0,1
"12513","aslittle",1,0,0,0,1
"12514","asmall",1,0,0,0,1
"12515","asmany",1,0,0,0,1
"12516","asmy",1,0,0,0,1
"12517","asnearly",1,0,0,0,1
"12518","asnone",1,0,0,0,1
"12519","asoccasion",1,0,0,0,1
"12520","asoft",1,0,0,0,1
"12521","ason",1,0,0,0,1
"12522","asore",1,0,0,0,1
"12523","asort",1,0,0,0,1
"12524","asour",1,0,0,0,1
"12525","asouthern",1,0,0,0,1
"12526","aspectof",1,0,0,0,1
"12527","aspiration",1,0,0,0,1
"12528","aspired",0,1,0,0,1
"12529","aspiring",1,0,0,0,1
"12530","aspirit",1,0,0,0,1
"12531","aspresident",1,0,0,0,1
"12532","aspy",1,0,0,0,1
"12533","asreal",1,0,0,0,1
"12534","assail",0,1,0,0,1
"12535","assailedby",1,0,0,0,1
"12536","assailingparty",1,0,0,0,1
"12537","assalts",0,1,0,0,1
"12538","assassin’s",1,0,0,0,1
"12539","assassinated",1,0,0,0,1
"12540","assassinin",1,0,0,0,1
"12541","assasssination",0,0,0,1,1
"12542","assaultwe",1,0,0,0,1
"12543","asseen",1,0,0,0,1
"12544","asserted.the",1,0,0,0,1
"12545","assertingits",1,0,0,0,1
"12546","assertionthat",1,0,0,0,1
"12547","asshe",1,0,0,0,1
"12548","assistantsecretary",1,0,0,0,1
"12549","assisted.murder",1,0,0,0,1
"12550","assisthim",1,0,0,0,1
"12551","assistingthem",1,0,0,0,1
"12552","associationwith",1,0,0,0,1
"12553","assoon",1,0,0,0,1
"12554","assteel",1,0,0,0,1
"12555","assumedfor",1,0,0,0,1
"12556","assumptions",0,1,0,0,1
"12557","astart",1,0,0,0,1
"12558","astep",1,0,0,0,1
"12559","astepmother",1,0,0,0,1
"12560","asthere",1,0,0,0,1
"12561","asthis",1,0,0,0,1
"12562","astonised",0,0,0,1,1
"12563","astonish",0,0,1,0,1
"12564","astonishedmyself",1,0,0,0,1
"12565","astorm",1,0,0,0,1
"12566","astounding",1,0,0,0,1
"12567","astrange",1,0,0,0,1
"12568","astranger",1,0,0,0,1
"12569","astute",1,0,0,0,1
"12570","asuccessful",1,0,0,0,1
"12571","asufficient",1,0,0,0,1
"12572","asumbrageous",1,0,0,0,1
"12573","asuncle",1,0,0,0,1
"12574","asunderand",1,0,0,0,1
"12575","asunpopular",1,0,0,0,1
"12576","asurprise",1,0,0,0,1
"12577","asvinegar",1,0,0,0,1
"12578","aswas",1,0,0,0,1
"12579","aswe",1,0,0,0,1
"12580","aswhen",1,0,0,0,1
"12581","aswilliam",1,0,0,0,1
"12582","asyou",1,0,0,0,1
"12583","at_",0,1,0,0,1
"12584","atall",1,0,0,0,1
"12585","atall.we",1,0,0,0,1
"12586","atan",1,0,0,0,1
"12587","atcannon",1,0,0,0,1
"12588","atchambersburg",1,0,0,0,1
"12589","atcollation",1,0,0,0,1
"12590","ate",0,0,1,0,1
"12591","aterritory",1,0,0,0,1
"12592","atestimonial",1,0,0,0,1
"12593","atharper’s",1,0,0,0,1
"12594","athenians",0,0,0,1,1
"12595","athens",0,0,0,1,1
"12596","athis",1,0,0,0,1
"12597","athome",1,0,0,0,1
"12598","athreat",1,0,0,0,1
"12599","athunderbolt",1,0,0,0,1
"12600","atit",1,0,0,0,1
"12601","atits",1,0,0,0,1
"12602","atlarge",1,0,0,0,1
"12603","atlast",1,0,0,0,1
"12604","atmeeting",1,0,0,0,1
"12605","atmidnight",1,0,0,0,1
"12606","atmosphereof",1,0,0,0,1
"12607","atmospherewondrously",1,0,0,0,1
"12608","atmy",1,0,0,0,1
"12609","atnewport",1,0,0,0,1
"12610","atoberlin",1,0,0,0,1
"12611","atonement",0,1,0,0,1
"12612","atpeace",1,0,0,0,1
"12613","atpendleton",1,0,0,0,1
"12614","atraitor",1,0,0,0,1
"12615","atremendous",1,0,0,0,1
"12616","atrip",1,0,0,0,1
"12617","atriumph",1,0,0,0,1
"12618","atrochester",1,0,0,0,1
"12619","atrocities",0,1,0,0,1
"12620","atroubled",1,0,0,0,1
"12621","atrue",1,0,0,0,1
"12622","atrumpet",1,0,0,0,1
"12623","atst",1,0,0,0,1
"12624","attached_",1,0,0,0,1
"12625","attaching",0,0,1,0,1
"12626","attachmentwas",1,0,0,0,1
"12627","attacksmade",1,0,0,0,1
"12628","attainment",0,1,0,0,1
"12629","attemptedassassination",1,0,0,0,1
"12630","attemptedopenly",1,0,0,0,1
"12631","attendedthe",1,0,0,0,1
"12632","attendpresident",1,0,0,0,1
"12633","attendthe",1,0,0,0,1
"12634","attention_",0,1,0,0,1
"12635","attentive",0,0,1,0,1
"12636","attesting",0,0,0,1,1
"12637","attests",1,0,0,0,1
"12638","attica",0,0,0,1,1
"12639","attorney",1,0,0,0,1
"12640","attractedattention",1,0,0,0,1
"12641","attractedme",1,0,0,0,1
"12642","attracting",0,1,0,0,1
"12643","attracts",0,0,0,1,1
"12644","attributes",1,0,0,0,1
"12645","attributeswhich",1,0,0,0,1
"12646","atvariance",1,0,0,0,1
"12647","atwages",1,0,0,0,1
"12648","atwashington",1,0,0,0,1
"12649","atweymouth",1,0,0,0,1
"12650","atwork.but",1,0,0,0,1
"12651","au",1,0,0,0,1
"12652","audacity",0,1,0,0,1
"12653","audience.i",1,0,0,0,1
"12654","audience.the",1,0,0,0,1
"12655","audiencesimultaneously",1,0,0,0,1
"12656","augmented",0,0,1,0,1
"12657","augusthas",1,0,0,0,1
"12658","augustuswashington",1,0,0,0,1
"12659","auld_",0,1,0,0,1
"12660","auld.nevertheless",1,0,0,0,1
"12661","auld.why",1,0,0,0,1
"12662","auld’sship",1,0,0,0,1
"12663","auldhad",1,0,0,0,1
"12664","aulds",0,1,0,0,1
"12665","auldwas",1,0,0,0,1
"12666","aunion",1,0,0,0,1
"12667","auspicious",1,0,0,0,1
"12668","authentic",0,0,1,0,1
"12669","authorityof",1,0,0,0,1
"12670","authorizedto",1,0,0,0,1
"12671","authorof",1,0,0,0,1
"12672","autobiographical",0,0,1,0,1
"12673","autobiographies",0,1,0,0,1
"12674","availedmyself",1,0,0,0,1
"12675","avalanche",1,0,0,0,1
"12676","avalanches",0,0,0,1,1
"12677","ave",1,0,0,0,1
"12678","avenged",0,0,1,0,1
"12679","avenging",0,1,0,0,1
"12680","aversion.the",1,0,0,0,1
"12681","avert",0,1,0,0,1
"12682","averted",1,0,0,0,1
"12683","avertpunishment",1,0,0,0,1
"12684","avignon ",0,0,0,1,1
"12685","avision",1,0,0,0,1
"12686","avocations",1,0,0,0,1
"12687","avoidbattle",1,0,0,0,1
"12688","avow",0,1,0,0,1
"12689","avowals",0,1,0,0,1
"12690","awaitedtheir",1,0,0,0,1
"12691","awaitthe",1,0,0,0,1
"12692","awakenedby",1,0,0,0,1
"12693","awakenedthe",1,0,0,0,1
"12694","awareof",1,0,0,0,1
"12695","away.in",1,0,0,0,1
"12696","awayand",1,0,0,0,1
"12697","awaytheir",1,0,0,0,1
"12698","awayto",1,0,0,0,1
"12699","awaywith",1,0,0,0,1
"12700","awed",0,0,0,1,1
"12701","awestruck",1,0,0,0,1
"12702","awhite",1,0,0,0,1
"12703","awise",1,0,0,0,1
"12704","awkwardposition",1,0,0,0,1
"12705","awoke",0,1,0,0,1
"12706","aworthy",1,0,0,0,1
"12707","awrong",1,0,0,0,1
"12708","ay",0,0,1,0,1
"12709","b.hayes",1,0,0,0,1
"12710","b’leve",1,0,0,0,1
"12711","baa",0,0,1,0,1
"12712","babe ",0,0,0,1,1
"12713","babes",0,0,1,0,1
"12714","babies",1,0,0,0,1
"12715","babylon",0,1,0,0,1
"12716","bachule",0,0,0,1,1
"12717","backedwoman",1,0,0,0,1
"12718","backin",1,0,0,0,1
"12719","backs",0,0,0,1,1
"12720","backs.everybody",1,0,0,0,1
"12721","backsupon",1,0,0,0,1
"12722","backthe",1,0,0,0,1
"12723","backto",1,0,0,0,1
"12724","backupon",1,0,0,0,1
"12725","backwere",1,0,0,0,1
"12726","bad_",1,0,0,0,1
"12727","badfaith",1,0,0,0,1
"12728","badlyas",1,0,0,0,1
"12729","badman",1,0,0,0,1
"12730","badsheep",1,0,0,0,1
"12731","bagin",1,0,0,0,1
"12732","bahabiyeh",0,0,0,1,1
"12733","bail",1,0,0,0,1
"12734","bailey_",0,1,0,0,1
"12735","bailey.between",1,0,0,0,1
"12736","bailiffs",1,0,0,0,1
"12737","baims",0,0,0,1,1
"12738","bales",1,0,0,0,1
"12739","balitmore",0,1,0,0,1
"12740","ball’s",1,0,0,0,1
"12741","balloon",0,1,0,0,1
"12742","ballots",1,0,0,0,1
"12743","baltimore_american_",1,0,0,0,1
"12744","baltimore.after",1,0,0,0,1
"12745","baltimore.how",1,0,0,0,1
"12746","baltimore.my",1,0,0,0,1
"12747","baltimore.no",1,0,0,0,1
"12748","baltimore.on",1,0,0,0,1
"12749","baltimore.the",1,0,0,0,1
"12750","baltimoreand",1,0,0,0,1
"12751","balustrades",0,1,0,0,1
"12752","ban",1,0,0,0,1
"12753","bandaged",1,0,0,0,1
"12754","bandana",0,1,0,0,1
"12755","banded",1,0,0,0,1
"12756","bang",0,1,0,0,1
"12757","baniau",0,0,0,1,1
"12758","bankand",1,0,0,0,1
"12759","bankbill",0,1,0,0,1
"12760","banking",1,0,0,0,1
"12761","bankten",1,0,0,0,1
"12762","banner_",0,1,0,0,1
"12763","baptistry",0,0,0,1,1
"12764","baptists",1,0,0,0,1
"12765","baptized",1,0,0,0,1
"12766","barbarism.the",1,0,0,0,1
"12767","barbarityof",1,0,0,0,1
"12768","barbaroustreatment",1,0,0,0,1
"12769","barbeoeina",0,0,0,1,1
"12770","barber",1,0,0,0,1
"12771","barber’s",1,0,0,0,1
"12772","barbers",1,0,0,0,1
"12773","barclay",1,0,0,0,1
"12774","bareheaded",0,0,1,0,1
"12775","barelegged",0,0,0,1,1
"12776","bargain.the",1,0,0,0,1
"12777","bargainwith",1,0,0,0,1
"12778","barnburners",1,0,0,0,1
"12779","barneywas",1,0,0,0,1
"12780","baromitre",0,0,0,1,1
"12781","barred",1,0,0,0,1
"12782","barrenness",0,1,0,0,1
"12783","barricades",1,0,0,0,1
"12784","barriers",1,0,0,0,1
"12785","barrister",1,0,0,0,1
"12786","basedupon",1,0,0,0,1
"12787","bashan",0,0,1,0,1
"12788","basin",0,1,0,0,1
"12789","basisthan",1,0,0,0,1
"12790","bast",0,0,0,1,1
"12791","batavia",1,0,0,0,1
"12792","bath",0,0,0,1,1
"12793","bats",1,0,0,0,1
"12794","batteries",1,0,0,0,1
"12795","battering",1,0,0,0,1
"12796","battleground",1,0,0,0,1
"12797","battleupon",1,0,0,0,1
"12798","battling",1,0,0,0,1
"12799","bauble",1,0,0,0,1
"12800","bayanet",0,0,0,1,1
"12801","bayonet",1,0,0,0,1
"12802","bazar",0,0,0,1,1
"12803","bazars",0,0,0,1,1
"12804","beable",1,0,0,0,1
"12805","beaccepted",1,0,0,0,1
"12806","beallowed",1,0,0,0,1
"12807","beaman",1,0,0,0,1
"12808","beappropriated",1,0,0,0,1
"12809","beard",1,0,0,0,1
"12810","bearerat",1,0,0,0,1
"12811","bearhis",1,0,0,0,1
"12812","bearingmarking",1,0,0,0,1
"12813","bearings",1,0,0,0,1
"12814","bearth",0,0,0,1,1
"12815","beas",1,0,0,0,1
"12816","beastsof",1,0,0,0,1
"12817","beating_",0,1,0,0,1
"12818","beatme",1,0,0,0,1
"12819","beats",0,1,0,0,1
"12820","beautefuely",0,0,0,1,1
"12821","beauteful",0,0,0,1,1
"12822","beautefully",0,0,0,1,1
"12823","beautifful",0,0,0,1,1
"12824","beautifuldelaware",1,0,0,0,1
"12825","beautifullawn",1,0,0,0,1
"12826","beauvan",0,0,0,1,1
"12827","bebroken",1,0,0,0,1
"12828","bebrought",1,0,0,0,1
"12829","beburned_",1,0,0,0,1
"12830","becameacquainted",1,0,0,0,1
"12831","becameaverse",1,0,0,0,1
"12832","becameboth",1,0,0,0,1
"12833","becameconvinced",1,0,0,0,1
"12834","becameexpert",1,0,0,0,1
"12835","becamegeneral",1,0,0,0,1
"12836","becamemore",1,0,0,0,1
"12837","becametroubled",1,0,0,0,1
"12838","becamevocal",1,0,0,0,1
"12839","becauseit",1,0,0,0,1
"12840","becauseof",1,0,0,0,1
"12841","becausepresident",1,0,0,0,1
"12842","beckoned",0,1,0,0,1
"12843","beckoningus",1,0,0,0,1
"12844","become",0,0,0,1,1
"12845","becomean",1,0,0,0,1
"12846","becomelarge",1,0,0,0,1
"12847","becomelike",1,0,0,0,1
"12848","becomeone",1,0,0,0,1
"12849","becometoo",1,0,0,0,1
"12850","becoming",0,0,0,1,1
"12851","becominganything",1,0,0,0,1
"12852","becomingmaster",1,0,0,0,1
"12853","becommanded",1,0,0,0,1
"12854","beconstables",1,0,0,0,1
"12855","bedford.main",1,0,0,0,1
"12856","bedford.the",1,0,0,0,1
"12857","bediscovered",1,0,0,0,1
"12858","bedivided",1,0,0,0,1
"12859","bedstead",1,0,0,0,1
"12860","bee",1,0,0,0,1
"12861","beemployed",1,0,0,0,1
"12862","beenable",1,0,0,0,1
"12863","beenat",1,0,0,0,1
"12864","beenattended",1,0,0,0,1
"12865","beenaverted",1,0,0,0,1
"12866","beenbenumbed",1,0,0,0,1
"12867","beenbroadly",1,0,0,0,1
"12868","beencompletely",1,0,0,0,1
"12869","beendared",1,0,0,0,1
"12870","beendured",1,0,0,0,1
"12871","beenduring",1,0,0,0,1
"12872","beenenabled",1,0,0,0,1
"12873","beenenslaved",1,0,0,0,1
"12874","beenexpected",1,0,0,0,1
"12875","beenexperienced",1,0,0,0,1
"12876","beenflung",1,0,0,0,1
"12877","beengreatly",1,0,0,0,1
"12878","beenhimself",1,0,0,0,1
"12879","beenhired",1,0,0,0,1
"12880","beeninformed",1,0,0,0,1
"12881","beenkindly",1,0,0,0,1
"12882","beenmiserable",1,0,0,0,1
"12883","beenmore",1,0,0,0,1
"12884","beenno",1,0,0,0,1
"12885","beenoffered",1,0,0,0,1
"12886","beenone",1,0,0,0,1
"12887","beenpermitted",1,0,0,0,1
"12888","beenrecently",1,0,0,0,1
"12889","beenremoved",1,0,0,0,1
"12890","beenrequired",1,0,0,0,1
"12891","beenreversed",1,0,0,0,1
"12892","beensatisfactory",1,0,0,0,1
"12893","beensouth",1,0,0,0,1
"12894","beenspent",1,0,0,0,1
"12895","beentaken",1,0,0,0,1
"12896","beenvain",1,0,0,0,1
"12897","beenviolently",1,0,0,0,1
"12898","beenwarm",1,0,0,0,1
"12899","bees",1,0,0,0,1
"12900","beestablished",1,0,0,0,1
"12901","befatal",1,0,0,0,1
"12902","befirst",1,0,0,0,1
"12903","befitting",1,0,0,0,1
"12904","before.alas",1,0,0,0,1
"12905","before.but",1,0,0,0,1
"12906","before.on",1,0,0,0,1
"12907","before.the",1,0,0,0,1
"12908","before.we",1,0,0,0,1
"12909","beforeattained",1,0,0,0,1
"12910","beforebeen",1,0,0,0,1
"12911","beforegoing",1,0,0,0,1
"12912","beforehim",1,0,0,0,1
"12913","beforein",1,0,0,0,1
"12914","beforeleaving",1,0,0,0,1
"12915","beforemorning",1,0,0,0,1
"12916","beforenarrated",1,0,0,0,1
"12917","beforepresident",1,0,0,0,1
"12918","beforeseen",1,0,0,0,1
"12919","beforesundown",1,0,0,0,1
"12920","beforethey",1,0,0,0,1
"12921","beforgotten",1,0,0,0,1
"12922","beformally",1,0,0,0,1
"12923","beforwarded",1,0,0,0,1
"12924","befound",1,0,0,0,1
"12925","befred",1,0,0,0,1
"12926","befree",1,0,0,0,1
"12927","befriended",0,1,0,0,1
"12928","beggar",0,1,0,0,1
"12929","beginnings",1,0,0,0,1
"12930","begrimed",1,0,0,0,1
"12931","begs",1,0,0,0,1
"12932","begunto",1,0,0,0,1
"12933","behappy",1,0,0,0,1
"12934","behaves",0,0,0,1,1
"12935","behaving",0,0,1,0,1
"12936","behaviorin",1,0,0,0,1
"12937","behest",1,0,0,0,1
"12938","behind",0,0,0,1,1
"12939","behindhim",1,0,0,0,1
"12940","behindtime",1,0,0,0,1
"12941","behindus",1,0,0,0,1
"12942","beholder",1,0,0,0,1
"12943","beholders",0,1,0,0,1
"12944","beholding",0,1,0,0,1
"12945","beholds",1,0,0,0,1
"12946","behusband",1,0,0,0,1
"12947","beinformed",1,0,0,0,1
"12948","beingdirected",1,0,0,0,1
"12949","beingequal",1,0,0,0,1
"12950","beingfitted",1,0,0,0,1
"12951","beinggratified",1,0,0,0,1
"12952","beinghurried",1,0,0,0,1
"12953","beingpresented",1,0,0,0,1
"12954","beingpublished",1,0,0,0,1
"12955","beingseparated",1,0,0,0,1
"12956","beingstrong",1,0,0,0,1
"12957","beingunalloyed",1,0,0,0,1
"12958","beingwith",1,0,0,0,1
"12959","bejudas",1,0,0,0,1
"12960","bekept",1,0,0,0,1
"12961","beknown",1,0,0,0,1
"12962","belief.then",1,0,0,0,1
"12963","believedi",1,0,0,0,1
"12964","believers",1,0,0,0,1
"12965","believes",1,0,0,0,1
"12966","believethose",1,0,0,0,1
"12967","beliive",0,0,0,1,1
"12968","belittle",1,0,0,0,1
"12969","bellwith",1,0,0,0,1
"12970","belongedto",1,0,0,0,1
"12971","belongingto",1,0,0,0,1
"12972","belongspreëminently",1,0,0,0,1
"12973","belost",1,0,0,0,1
"12974","belovedcongregation",1,0,0,0,1
"12975","bemade",1,0,0,0,1
"12976","beman",1,0,0,0,1
"12977","benediction",0,1,0,0,1
"12978","benefactor.instead",1,0,0,0,1
"12979","beneficialarrangement",1,0,0,0,1
"12980","benefited",1,0,0,0,1
"12981","benefitof",1,0,0,0,1
"12982","benevolentcharacter",1,0,0,0,1
"12983","beni",0,0,0,1,1
"12984","benignantly",1,0,0,0,1
"12985","benignity",0,1,0,0,1
"12986","benj.f",1,0,0,0,1
"12987","benton",0,1,0,0,1
"12988","benumbed",0,1,0,0,1
"12989","beobeyed",1,0,0,0,1
"12990","beobserved",1,0,0,0,1
"12991","beoff",1,0,0,0,1
"12992","bepresident",1,0,0,0,1
"12993","bequeathed",0,1,0,0,1
"12994","beraised",1,0,0,0,1
"12995","beremembered",1,0,0,0,1
"12996","beriah",1,0,0,0,1
"12997","beriahgreene",1,0,0,0,1
"12998","bermingham",0,0,0,1,1
"12999","berths",1,0,0,0,1
"13000","besafely",1,0,0,0,1
"13001","besaid",1,0,0,0,1
"13002","besatisfied",1,0,0,0,1
"13003","besedes",0,0,0,1,1
"13004","beseechingly",0,1,0,0,1
"13005","beseen",1,0,0,0,1
"13006","besidesthese",1,0,0,0,1
"13007","besieged",1,0,0,0,1
"13008","besilent",1,0,0,0,1
"13009","besold",1,0,0,0,1
"13010","best_",0,1,0,0,1
"13011","best_to",1,0,0,0,1
"13012","best.the",1,0,0,0,1
"13013","bestapparel",1,0,0,0,1
"13014","bestappointed",1,0,0,0,1
"13015","besti",1,0,0,0,1
"13016","bestir",0,1,0,0,1
"13017","bestmethods",1,0,0,0,1
"13018","bestof",1,0,0,0,1
"13019","bestonly",1,0,0,0,1
"13020","bests",0,1,0,0,1
"13021","bestto",1,0,0,0,1
"13022","bestwishes",1,0,0,0,1
"13023","besubjected",1,0,0,0,1
"13024","besupposed",1,0,0,0,1
"13025","besurrendered",1,0,0,0,1
"13026","besuspected",1,0,0,0,1
"13027","betake",0,1,0,0,1
"13028","betedious",1,0,0,0,1
"13029","bethe",1,0,0,0,1
"13030","bethlehem",0,0,0,1,1
"13031","betides",0,0,1,0,1
"13032","betokened",0,0,1,0,1
"13033","betokening",0,0,1,0,1
"13034","betookmyself",1,0,0,0,1
"13035","betsy",0,0,1,0,1
"13036","better.in",1,0,0,0,1
"13037","better.perhaps",1,0,0,0,1
"13038","betterday",1,0,0,0,1
"13039","betterillustration",1,0,0,0,1
"13040","betterjudgment",1,0,0,0,1
"13041","betterknown",1,0,0,0,1
"13042","betterqualified",1,0,0,0,1
"13043","betterreception",1,0,0,0,1
"13044","betterworld",1,0,0,0,1
"13045","betweenthe",1,0,0,0,1
"13046","beunanswerable",1,0,0,0,1
"13047","beundertaken",1,0,0,0,1
"13048","beupheld",1,0,0,0,1
"13049","beused",1,0,0,0,1
"13050","bewilderment",1,0,0,0,1
"13051","beyond_",0,1,0,0,1
"13052","beyonddescription",1,0,0,0,1
"13053","beyondmy",1,0,0,0,1
"13054","biased",0,0,0,1,1
"13055","biblotye",0,0,0,1,1
"13056","bidder",0,1,0,0,1
"13057","biddulph",0,0,0,1,1
"13058","bide",1,0,0,0,1
"13059","bigenough",1,0,0,0,1
"13060","biggest",0,1,0,0,1
"13061","biggestin",1,0,0,0,1
"13062","bigotry",1,0,0,0,1
"13063","billows",0,0,0,1,1
"13064","bindingforce",1,0,0,0,1
"13065","biography",0,1,0,0,1
"13066","birmingham",1,0,0,0,1
"13067","birney",1,0,0,0,1
"13068","birthplace",0,0,1,0,1
"13069","births",0,1,0,0,1
"13070","bishop",0,0,0,1,1
"13071","bites",0,1,0,0,1
"13072","bittercontempt",1,0,0,0,1
"13073","bitterestinvectives",1,0,0,0,1
"13074","bitterlythe",1,0,0,0,1
"13075","bitternessand",1,0,0,0,1
"13076","bitternesstoward",1,0,0,0,1
"13077","bitterprejudice",1,0,0,0,1
"13078","bitterresentment",1,0,0,0,1
"13079","biyolow",0,0,0,1,1
"13080","blackcarpenters",1,0,0,0,1
"13081","blackcravat",1,0,0,0,1
"13082","blackedin",1,0,0,0,1
"13083","blacking",1,0,0,0,1
"13084","blackness",0,0,1,0,1
"13085","blacksmithing",0,0,1,0,1
"13086","blade",0,0,0,1,1
"13087","blaine.since",1,0,0,0,1
"13088","blamed",0,1,0,0,1
"13089","bland",1,0,0,0,1
"13090","blankets",0,0,1,0,1
"13091","blasphemous",0,1,0,0,1
"13092","blasphemyand",1,0,0,0,1
"13093","blasting",0,1,0,0,1
"13094","blasts",0,1,0,0,1
"13095","blazing",1,0,0,0,1
"13096","bleakand",1,0,0,0,1
"13097","bleat",0,0,1,0,1
"13098","blemish",1,0,0,0,1
"13099","blending",1,0,0,0,1
"13100","blendingof",1,0,0,0,1
"13101","blessedness",0,0,1,0,1
"13102","blessingmust",1,0,0,0,1
"13103","blessingssought",1,0,0,0,1
"13104","blinding",0,1,0,0,1
"13105","bliss",0,1,0,0,1
"13106","blisters",0,1,0,0,1
"13107","bloated",0,1,0,0,1
"13108","blocks",0,0,0,1,1
"13109","blood.aside",1,0,0,0,1
"13110","blood.chapter",1,0,0,0,1
"13111","blood.i",1,0,0,0,1
"13112","blood.on",1,0,0,0,1
"13113","bloodhound",0,0,1,0,1
"13114","bloodhounds",1,0,0,0,1
"13115","bloodiest",0,0,1,0,1
"13116","bloodinto",1,0,0,0,1
"13117","bloodless",0,1,0,0,1
"13118","bloodless.i",1,0,0,0,1
"13119","bloodthirsty",1,0,0,0,1
"13120","bloss",1,0,0,0,1
"13121","blot",0,1,0,0,1
"13122","blotches",0,1,0,0,1
"13123","blowat",1,0,0,0,1
"13124","blowhis",1,0,0,0,1
"13125","blows.at",1,0,0,0,1
"13126","bluff",1,0,0,0,1
"13127","bluish",1,0,0,0,1
"13128","blunders",0,1,0,0,1
"13129","blunted",0,1,0,0,1
"13130","blunts",0,1,0,0,1
"13131","blush",1,0,0,0,1
"13132","blushed",0,1,0,0,1
"13133","bluster",1,0,0,0,1
"13134","boarded",0,0,0,1,1
"13135","boardsi",1,0,0,0,1
"13136","boardthe",1,0,0,0,1
"13137","boastedthat",1,0,0,0,1
"13138","boastful",1,0,0,0,1
"13139","boats",0,0,0,1,1
"13140","bodrachien",0,0,0,1,1
"13141","bogus",0,1,0,0,1
"13142","boil",0,1,0,0,1
"13143","boilover",1,0,0,0,1
"13144","boils",0,0,1,0,1
"13145","boldnessin",1,0,0,0,1
"13146","boldnesswith",1,0,0,0,1
"13147","bolted",0,0,1,0,1
"13148","boltfrom",1,0,0,0,1
"13149","bombast",0,1,0,0,1
"13150","bondage.i",1,0,0,0,1
"13151","bondage.in",1,0,0,0,1
"13152","bondage.let",1,0,0,0,1
"13153","bondage.the",1,0,0,0,1
"13154","bondman’s",1,0,0,0,1
"13155","bondmen.when",1,0,0,0,1
"13156","bondsman",1,0,0,0,1
"13157","bondsmen",0,1,0,0,1
"13158","bonnard",0,0,0,1,1
"13159","bonnet",1,0,0,0,1
"13160","book.chapter",1,0,0,0,1
"13161","bookat",1,0,0,0,1
"13162","bookbefore",1,0,0,0,1
"13163","booked",0,0,0,1,1
"13164","booksof",1,0,0,0,1
"13165","bookstores",1,0,0,0,1
"13166","boone",1,0,0,0,1
"13167","boost",0,1,0,0,1
"13168","bordeaux",0,0,0,1,1
"13169","borden",1,0,0,0,1
"13170","bordering",0,1,0,0,1
"13171","borderruffians",1,0,0,0,1
"13172","bordeu",0,0,0,1,1
"13173","boring",0,0,0,1,1
"13174","bornepatiently",1,0,0,0,1
"13175","borrower.a",1,0,0,0,1
"13176","bosding",0,0,0,1,1
"13177","bosom.indeed",1,0,0,0,1
"13178","bosomof",1,0,0,0,1
"13179","bostonfriends",1,0,0,0,1
"13180","both.the",1,0,0,0,1
"13181","bothadvanced",1,0,0,0,1
"13182","bothat",1,0,0,0,1
"13183","bothclasses",1,0,0,0,1
"13184","bothcolors",1,0,0,0,1
"13185","bothexerted",1,0,0,0,1
"13186","bothsides",1,0,0,0,1
"13187","bothsons",1,0,0,0,1
"13188","bottles",1,0,0,0,1
"13189","bottomless",1,0,0,0,1
"13190","bottoms",1,0,0,0,1
"13191","botts",1,0,0,0,1
"13192","boughtluxuries",1,0,0,0,1
"13193","boundto",1,0,0,0,1
"13194","boundtogether",1,0,0,0,1
"13195","boundtrip",1,0,0,0,1
"13196","bounteously",0,1,0,0,1
"13197","bounteousprofusion",1,0,0,0,1
"13198","bountiful",1,0,0,0,1
"13199","bountifully",0,0,1,0,1
"13200","bountifulness",0,1,0,0,1
"13201","bounty",1,0,0,0,1
"13202","bourbon",0,0,0,1,1
"13203","bowden",0,0,0,1,1
"13204","bowditch",1,0,0,0,1
"13205","bowdoin",0,1,0,0,1
"13206","bowels",0,1,0,0,1
"13207","bowering",1,0,0,0,1
"13208","bowlein",1,0,0,0,1
"13209","bowley’s",0,0,1,0,1
"13210","bowlien",0,1,0,0,1
"13211","bows",0,0,1,0,1
"13212","boxes",1,0,0,0,1
"13213","boy.they",1,0,0,0,1
"13214","boy’sbitter",1,0,0,0,1
"13215","boymight",1,0,0,0,1
"13216","boysto",1,0,0,0,1
"13217","brace",1,0,0,0,1
"13218","bracing",0,0,0,1,1
"13219","bradburnlooked",1,0,0,0,1
"13220","bragging",1,0,0,0,1
"13221","brakeman",1,0,0,0,1
"13222","branches.this",1,0,0,0,1
"13223","brandies",0,1,0,0,1
"13224","branding",0,1,0,0,1
"13225","brands",1,0,0,0,1
"13226","brandthemselves",1,0,0,0,1
"13227","braves",1,0,0,0,1
"13228","bravesisters",1,0,0,0,1
"13229","bravest",1,0,0,0,1
"13230","brawny",0,1,0,0,1
"13231","braying",0,0,1,0,1
"13232","brazenly",1,0,0,0,1
"13233","brazil",1,0,0,0,1
"13234","brazils",0,1,0,0,1
"13235","breach",1,0,0,0,1
"13236","bread_",0,1,0,0,1
"13237","bread.my",1,0,0,0,1
"13238","breadless",0,1,0,0,1
"13239","breakan",1,0,0,0,1
"13240","breaker.st",1,0,0,0,1
"13241","breakertook",1,0,0,0,1
"13242","breaking.i",1,0,0,0,1
"13243","breckenridgeand",1,0,0,0,1
"13244","breeder",1,0,0,0,1
"13245","breezecombined",1,0,0,0,1
"13246","brenlock",0,0,0,1,1
"13247","bribe",1,0,0,0,1
"13248","bribed",1,0,0,0,1
"13249","brickbats",1,0,0,0,1
"13250","bridged",1,0,0,0,1
"13251","briefest",1,0,0,0,1
"13252","brieflythe",1,0,0,0,1
"13253","briefspeeches",1,0,0,0,1
"13254","brightened",1,0,0,0,1
"13255","brightness",1,0,0,0,1
"13256","brigs",0,0,1,0,1
"13257","brilliantvindication",1,0,0,0,1
"13258","brilliarch",0,0,0,1,1
"13259","brim",0,1,0,0,1
"13260","brimful",0,0,0,1,1
"13261","bringingthem",1,0,0,0,1
"13262","bringme",1,0,0,0,1
"13263","bringthe",1,0,0,0,1
"13264","brinkhouse",0,0,0,1,1
"13265","briny",0,1,0,0,1
"13266","bristol",0,1,0,0,1
"13267","britanique",0,0,0,1,1
"13268","britannique",0,0,0,1,1
"13269","britishisles",1,0,0,0,1
"13270","brittle",0,1,0,0,1
"13271","broach",1,0,0,0,1
"13272","broadand",1,0,0,0,1
"13273","broadbosom",1,0,0,0,1
"13274","broadest",1,0,0,0,1
"13275","broadstreet",0,0,0,1,1
"13276","broadsurvey",1,0,0,0,1
"13277","broadthat",1,0,0,0,1
"13278","broadwalks",1,0,0,0,1
"13279","broadway",0,1,0,0,1
"13280","broadway.though",1,0,0,0,1
"13281","brokedown",1,0,0,0,1
"13282","brokenhearted",0,1,0,0,1
"13283","brokenvoice",1,0,0,0,1
"13284","brook’s",0,1,0,0,1
"13285","brooklyn",1,0,0,0,1
"13286","brooks",1,0,0,0,1
"13287","brotherbondman",1,0,0,0,1
"13288","brotherhood.in",1,0,0,0,1
"13289","brotherin",1,0,0,0,1
"13290","brotherlysympathy",1,0,0,0,1
"13291","broughtabraham",1,0,0,0,1
"13292","broughtinto",1,0,0,0,1
"13293","broughtout",1,0,0,0,1
"13294","broughtthis",1,0,0,0,1
"13295","broughttogether",1,0,0,0,1
"13296","brown’sfort",1,0,0,0,1
"13297","brown’strial",1,0,0,0,1
"13298","brownagainst",1,0,0,0,1
"13299","browndid",1,0,0,0,1
"13300","brownimplicated",1,0,0,0,1
"13301","browning",0,0,0,1,1
"13302","browns_",0,1,0,0,1
"13303","brownson’s",1,0,0,0,1
"13304","brownsong",1,0,0,0,1
"13305","bruce",1,0,0,0,1
"13306","bruisedheart",1,0,0,0,1
"13307","brushed",1,0,0,0,1
"13308","brusqueness",1,0,0,0,1
"13309","brutalchastisement",1,0,0,0,1
"13310","brutalize",0,0,1,0,1
"13311","brutalmanner",1,0,0,0,1
"13312","brutus",0,0,0,1,1
"13313","bryan",0,0,0,1,1
"13314","bryant",0,1,0,0,1
"13315","bubble",1,0,0,0,1
"13316","buffaloand",1,0,0,0,1
"13317","buffaloconvention",1,0,0,0,1
"13318","buffum’s",1,0,0,0,1
"13319","buffums",1,0,0,0,1
"13320","builded",1,0,0,0,1
"13321","builderon",1,0,0,0,1
"13322","buildhigh",1,0,0,0,1
"13323","buildingsof",1,0,0,0,1
"13324","builts",0,0,0,1,1
"13325","bull.i",1,0,0,0,1
"13326","bullseye",0,0,0,1,1
"13327","bullying.as",1,0,0,0,1
"13328","bulwark",0,1,0,0,1
"13329","bunch",0,1,0,0,1
"13330","buoyancy",1,0,0,0,1
"13331","burdenlightened",1,0,0,0,1
"13332","burdensof",1,0,0,0,1
"13333","bureed",0,0,0,1,1
"13334","buren",1,0,0,0,1
"13335","burgesses",1,0,0,0,1
"13336","burglars",1,0,0,0,1
"13337","burialof",1,0,0,0,1
"13338","burningwith",1,0,0,0,1
"13339","burnished",1,0,0,0,1
"13340","burns",1,0,0,0,1
"13341","burnt_",0,1,0,0,1
"13342","bursting",0,1,0,0,1
"13343","business.on",1,0,0,0,1
"13344","but_determined",1,0,0,0,1
"13345","buta",1,0,0,0,1
"13346","butafter",1,0,0,0,1
"13347","butagainst",1,0,0,0,1
"13348","butalas",1,0,0,0,1
"13349","butalso",1,0,0,0,1
"13350","butan",1,0,0,0,1
"13351","butat",1,0,0,0,1
"13352","butbe",1,0,0,0,1
"13353","butcher",0,1,0,0,1
"13354","butdenying",1,0,0,0,1
"13355","butdirectly",1,0,0,0,1
"13356","butemancipated",1,0,0,0,1
"13357","butextolling",1,0,0,0,1
"13358","butfew",1,0,0,0,1
"13359","butfor",1,0,0,0,1
"13360","buthappily",1,0,0,0,1
"13361","butincredible",1,0,0,0,1
"13362","butinvited",1,0,0,0,1
"13363","butit",1,0,0,0,1
"13364","butlerdeclaring",1,0,0,0,1
"13365","butlimited",1,0,0,0,1
"13366","butlooking",1,0,0,0,1
"13367","butmonarchical",1,0,0,0,1
"13368","butof",1,0,0,0,1
"13369","butputting",1,0,0,0,1
"13370","butsimply",1,0,0,0,1
"13371","butsix",1,0,0,0,1
"13372","butsomething",1,0,0,0,1
"13373","butstill",1,0,0,0,1
"13374","butsurely",1,0,0,0,1
"13375","butt",0,1,0,0,1
"13376","butthen",1,0,0,0,1
"13377","butthere",1,0,0,0,1
"13378","butthis",1,0,0,0,1
"13379","butthus",1,0,0,0,1
"13380","buttons",1,0,0,0,1
"13381","butunfortunately",1,0,0,0,1
"13382","butwalked",1,0,0,0,1
"13383","butweighty",1,0,0,0,1
"13384","butwhat",1,0,0,0,1
"13385","butwhich",1,0,0,0,1
"13386","butwhile",1,0,0,0,1
"13387","butyou",1,0,0,0,1
"13388","butyoung",1,0,0,0,1
"13389","buxton",1,0,0,0,1
"13390","buys",0,0,1,0,1
"13391","byand",1,0,0,0,1
"13392","byany",1,0,0,0,1
"13393","byappropriate",1,0,0,0,1
"13394","byattendance",1,0,0,0,1
"13395","bybecoming",1,0,0,0,1
"13396","bycol",1,0,0,0,1
"13397","bycommon",1,0,0,0,1
"13398","bycontact",1,0,0,0,1
"13399","bydisproving",1,0,0,0,1
"13400","bydoctor",1,0,0,0,1
"13401","bydr",1,0,0,0,1
"13402","byevents",1,0,0,0,1
"13403","byeveryone",1,0,0,0,1
"13404","byevil",1,0,0,0,1
"13405","byferry",1,0,0,0,1
"13406","byfillibustering",1,0,0,0,1
"13407","byforever",1,0,0,0,1
"13408","bygone",1,0,0,0,1
"13409","byheartless",1,0,0,0,1
"13410","byher",1,0,0,0,1
"13411","byindustry",1,0,0,0,1
"13412","byintimidation",1,0,0,0,1
"13413","byleaving",1,0,0,0,1
"13414","byme",1,0,0,0,1
"13415","bymr",1,0,0,0,1
"13416","bymy",1,0,0,0,1
"13417","byno",1,0,0,0,1
"13418","bynobody",1,0,0,0,1
"13419","byone",1,0,0,0,1
"13420","byopenly",1,0,0,0,1
"13421","byothers",1,0,0,0,1
"13422","byreason",1,0,0,0,1
"13423","byrefusing",1,0,0,0,1
"13424","byse",0,0,0,1,1
"13425","byseeking",1,0,0,0,1
"13426","byseveral",1,0,0,0,1
"13427","byslaves",1,0,0,0,1
"13428","bysoft",1,0,0,0,1
"13429","bysome",1,0,0,0,1
"13430","byspring",1,0,0,0,1
"13431","bystrangers",1,0,0,0,1
"13432","bystudy",1,0,0,0,1
"13433","bytelling",1,0,0,0,1
"13434","bythat",1,0,0,0,1
"13435","bythese",1,0,0,0,1
"13436","bythis",1,0,0,0,1
"13437","bytowering",1,0,0,0,1
"13438","bywilliam",1,0,0,0,1
"13439","c.wright",1,0,0,0,1
"13440","cabbage",1,0,0,0,1
"13441","cabinettowards",1,0,0,0,1
"13442","cabinhad",1,0,0,0,1
"13443","cabins.this",1,0,0,0,1
"13444","cabinseparate",1,0,0,0,1
"13445","cabinwhere",1,0,0,0,1
"13446","caboose",1,0,0,0,1
"13447","cady",1,0,0,0,1
"13448","caitness",0,0,0,1,1
"13449","calculating",1,0,0,0,1
"13450","calculationwas",1,0,0,0,1
"13451","calcutta",0,0,0,1,1
"13452","caleb",1,0,0,0,1
"13453","caledonia",0,0,0,1,1
"13454","calidian",0,0,0,1,1
"13455","calker’s",1,0,0,0,1
"13456","calledinto",1,0,0,0,1
"13457","calledno",1,0,0,0,1
"13458","calledon",1,0,0,0,1
"13459","calledover",1,0,0,0,1
"13460","calledowners",1,0,0,0,1
"13461","calledparticularly",1,0,0,0,1
"13462","calledthe",1,0,0,0,1
"13463","calledup",1,0,0,0,1
"13464","callhe",1,0,0,0,1
"13465","callingon",1,0,0,0,1
"13466","callls",0,1,0,0,1
"13467","callout",1,0,0,0,1
"13468","calmand",1,0,0,0,1
"13469","calmest",1,0,0,0,1
"13470","calmlyawaited",1,0,0,0,1
"13471","calmself",1,0,0,0,1
"13472","calumniators",0,0,1,0,1
"13473","camals",0,0,0,1,1
"13474","camden",1,0,0,0,1
"13475","camea",1,0,0,0,1
"13476","cameafter",1,0,0,0,1
"13477","cameas",1,0,0,0,1
"13478","cameforward",1,0,0,0,1
"13479","camefrom",1,0,0,0,1
"13480","camel’s",1,0,0,0,1
"13481","camels",0,0,0,1,1
"13482","cameon",1,0,0,0,1
"13483","cameout",1,0,0,0,1
"13484","camepoint",1,0,0,0,1
"13485","cameron",1,0,0,0,1
"13486","camethe",1,0,0,0,1
"13487","campaigns",1,0,0,0,1
"13488","campbell",0,1,0,0,1
"13489","canada.this",1,0,0,0,1
"13490","canals",0,0,0,1,1
"13491","canand",1,0,0,0,1
"13492","canandaigua",1,0,0,0,1
"13493","canbe",1,0,0,0,1
"13494","canceled",0,0,0,1,1
"13495","candid",1,0,0,0,1
"13496","candies",0,1,0,0,1
"13497","candleworks",1,0,0,0,1
"13498","canin",1,0,0,0,1
"13499","cannon’s",1,0,0,0,1
"13500","cannonmills",1,0,0,0,1
"13501","cannotforbear",1,0,0,0,1
"13502","canopy",0,1,0,0,1
"13503","canrepair",1,0,0,0,1
"13504","canshoot",1,0,0,0,1
"13505","cantell",1,0,0,0,1
"13506","canthese",1,0,0,0,1
"13507","cap’n",0,1,0,0,1
"13508","capets",0,0,0,1,1
"13509","capitoline",0,0,0,1,1
"13510","capri",0,0,0,1,1
"13511","caps",0,0,0,1,1
"13512","capt.auld",1,0,0,0,1
"13513","captain’ssaloon",1,0,0,0,1
"13514","captainanthony",1,0,0,0,1
"13515","captainbrown",1,0,0,0,1
"13516","captan",0,1,0,0,1
"13517","captive’s",0,0,1,0,1
"13518","captives",0,1,0,0,1
"13519","captorsto",1,0,0,0,1
"13520","captureall",1,0,0,0,1
"13521","capuchen",0,0,0,1,1
"13522","car_",0,1,0,0,1
"13523","car.my",1,0,0,0,1
"13524","carao",0,0,0,1,1
"13525","caravan",0,0,0,1,1
"13526","cards",1,0,0,0,1
"13527","cardwell",0,0,0,1,1
"13528","carefullybrought",1,0,0,0,1
"13529","carefulness",0,0,1,0,1
"13530","careless",1,0,0,0,1
"13531","carelessly",1,0,0,0,1
"13532","careof",1,0,0,0,1
"13533","cargo",0,1,0,0,1
"13534","cargoes",0,1,0,0,1
"13535","cargoof",1,0,0,0,1
"13536","caricature",0,0,1,0,1
"13537","carigio",0,0,0,1,1
"13538","carnivalof",1,0,0,0,1
"13539","carolinas",0,0,1,0,1
"13540","carolineanswered",1,0,0,0,1
"13541","carpenter’s",1,0,0,0,1
"13542","carpenterand",1,0,0,0,1
"13543","carpenterssanctioned",1,0,0,0,1
"13544","carpetbag",1,0,0,0,1
"13545","carriagehouse",1,0,0,0,1
"13546","carribean",1,0,0,0,1
"13547","carriedaway",1,0,0,0,1
"13548","carriedout",1,0,0,0,1
"13549","carrollton",1,0,0,0,1
"13550","carrythat",1,0,0,0,1
"13551","carsfor",1,0,0,0,1
"13552","cartridge",1,0,0,0,1
"13553","cartwrighting",0,0,1,0,1
"13554","carve",0,1,0,0,1
"13555","carvings",0,0,0,1,1
"13556","cascades",0,0,0,1,1
"13557","case",0,0,0,1,1
"13558","case.in",1,0,0,0,1
"13559","casepay",1,0,0,0,1
"13560","cases",0,0,0,1,1
"13561","caseto",1,0,0,0,1
"13562","cashier",1,0,0,0,1
"13563","casket",0,0,0,1,1
"13564","casta",1,0,0,0,1
"13565","castings",1,0,0,0,1
"13566","casts",0,1,0,0,1
"13567","catcher",0,1,0,0,1
"13568","catcherhad",1,0,0,0,1
"13569","caterers",0,1,0,0,1
"13570","cathaderal",0,0,0,1,1
"13571","catholicity",1,0,0,0,1
"13572","cattle.no",1,0,0,0,1
"13573","caucasianrace",1,0,0,0,1
"13574","caughtthe",1,0,0,0,1
"13575","caulking",1,0,0,0,1
"13576","cause",0,0,0,1,1
"13577","cause.wilson",1,0,0,0,1
"13578","causedme",1,0,0,0,1
"13579","causehere",1,0,0,0,1
"13580","causeof",1,0,0,0,1
"13581","causeth",0,0,0,1,1
"13582","causway",0,1,0,0,1
"13583","cautioning",0,1,0,0,1
"13584","cautions",1,0,0,0,1
"13585","cautious",1,0,0,0,1
"13586","cautiouslyapproached",1,0,0,0,1
"13587","cavils",1,0,0,0,1
"13588","ceal",0,1,0,0,1
"13589","ceal’s",0,1,0,0,1
"13590","ceaser",0,0,0,1,1
"13591","cedar",0,0,0,1,1
"13592","ceilings",0,1,0,0,1
"13593","celebratewest",1,0,0,0,1
"13594","celebrating",0,1,0,0,1
"13595","celebrities",1,0,0,0,1
"13596","celestialexpression",0,0,0,1,1
"13597","celibrated",0,0,0,1,1
"13598","cell",0,1,0,0,1
"13599","cells",0,0,1,0,1
"13600","cementary",0,0,0,1,1
"13601","cemetarie",0,0,0,1,1
"13602","cemetaries",0,0,0,1,1
"13603","cemetery",1,0,0,0,1
"13604","cemitarie",0,0,0,1,1
"13605","centennial",0,0,0,1,1
"13606","centered",0,1,0,0,1
"13607","centrally",1,0,0,0,1
"13608","centralrailroad",1,0,0,0,1
"13609","centre",1,0,0,0,1
"13610","centson",1,0,0,0,1
"13611","centuries.garrison",1,0,0,0,1
"13612","centurion",1,0,0,0,1
"13613","cerimony",0,0,0,1,1
"13614","certain.the",1,0,0,0,1
"13615","certaindegree",1,0,0,0,1
"13616","certainevents",1,0,0,0,1
"13617","certainlyhave",1,0,0,0,1
"13618","certifying",1,0,0,0,1
"13619","cessation",0,1,0,0,1
"13620","cested",0,1,0,0,1
"13621","chace",1,0,0,0,1
"13622","chaces",1,0,0,0,1
"13623","chain.chapter",1,0,0,0,1
"13624","chainings",0,1,0,0,1
"13625","chainsto",1,0,0,0,1
"13626","chair.in",1,0,0,0,1
"13627","chalkfor",1,0,0,0,1
"13628","challenge",1,0,0,0,1
"13629","chamberlain",1,0,0,0,1
"13630","chancewith",1,0,0,0,1
"13631","chandeler",0,0,0,1,1
"13632","chandeliers",1,0,0,0,1
"13633","changea",1,0,0,0,1
"13634","changedonce",1,0,0,0,1
"13635","changedthe",1,0,0,0,1
"13636","changeof",1,0,0,0,1
"13637","changes",0,0,0,1,1
"13638","changeshad",1,0,0,0,1
"13639","changingof",1,0,0,0,1
"13640","chant",0,0,0,1,1
"13641","chaotic",0,0,0,1,1
"13642","chapman",1,0,0,0,1
"13643","chapter.chapter",1,0,0,0,1
"13644","chapter.i",1,0,0,0,1
"13645","chapterof",1,0,0,0,1
"13646","chaptersets",1,0,0,0,1
"13647","chara",0,1,0,0,1
"13648","characterand",1,0,0,0,1
"13649","characteri",1,0,0,0,1
"13650","characterization",0,1,0,0,1
"13651","characterizationwould",1,0,0,0,1
"13652","characterof",1,0,0,0,1
"13653","characterwhich",1,0,0,0,1
"13654","chargedo’connell",1,0,0,0,1
"13655","chargedwith",1,0,0,0,1
"13656","charlotte",0,0,0,1,1
"13657","charmer",0,1,0,0,1
"13658","chartered",0,1,0,0,1
"13659","chas",0,0,0,1,1
"13660","chas.sumner",1,0,0,0,1
"13661","chases",1,0,0,0,1
"13662","chateau",0,0,0,1,1
"13663","chatter",1,0,0,0,1
"13664","che",0,0,0,1,1
"13665","cheafo",0,0,0,1,1
"13666","cheap",0,1,0,0,1
"13667","cheat",0,0,1,0,1
"13668","cheats",0,0,1,0,1
"13669","cheeirs",0,0,0,1,1
"13670","cheeney",1,0,0,0,1
"13671","cheeredrepeatedly",1,0,0,0,1
"13672","cheerful.the",1,0,0,0,1
"13673","cheltenham",0,0,0,1,1
"13674","cheofos",0,0,0,1,1
"13675","cherishedaspirations",1,0,0,0,1
"13676","cherishedenterprise",1,0,0,0,1
"13677","cherry",0,0,1,0,1
"13678","chesapeakebay",1,0,0,0,1
"13679","chest",0,1,0,0,1
"13680","chester",0,0,0,1,1
"13681","chestnutstreets",1,0,0,0,1
"13682","chided",0,1,0,0,1
"13683","chiefamongst",1,0,0,0,1
"13684","chiefmagistrate",1,0,0,0,1
"13685","chieftrouble",1,0,0,0,1
"13686","chiel",0,1,0,0,1
"13687","childhood.some",1,0,0,0,1
"13688","childhood.the",1,0,0,0,1
"13689","children.play",1,0,0,0,1
"13690","children.young",1,0,0,0,1
"13691","childrento",1,0,0,0,1
"13692","chillingblasts",1,0,0,0,1
"13693","chimed",1,0,0,0,1
"13694","chimneysof",1,0,0,0,1
"13695","chirurgical",0,1,0,0,1
"13696","choate",1,0,0,0,1
"13697","choir",0,0,0,1,1
"13698","choked",1,0,0,0,1
"13699","chooses",0,1,0,0,1
"13700","chopped",0,1,0,0,1
"13701","choptankriver",1,0,0,0,1
"13702","chord",0,1,0,0,1
"13703","chosen.in",1,0,0,0,1
"13704","christ.all",1,0,0,0,1
"13705","christ’s",0,0,1,0,1
"13706","christeaned ",0,0,0,1,1
"13707","christian_",0,1,0,0,1
"13708","christian’s",0,1,0,0,1
"13709","christianaand",1,0,0,0,1
"13710","christiancity",1,0,0,0,1
"13711","christianclass",1,0,0,0,1
"13712","christiangraces",1,0,0,0,1
"13713","christianministers",1,0,0,0,1
"13714","christjesus",1,0,0,0,1
"13715","christo",0,0,0,1,1
"13716","christopher",1,0,0,0,1
"13717","chronic",1,0,0,0,1
"13718","chronicle",1,0,0,0,1
"13719","chronicled",0,1,0,0,1
"13720","church_",1,0,0,0,1
"13721","church.my",1,0,0,0,1
"13722","church.there",1,0,0,0,1
"13723","churchheld",1,0,0,0,1
"13724","churchmen",0,1,0,0,1
"13725","churchor",1,0,0,0,1
"13726","cinders",1,0,0,0,1
"13727","circleof",1,0,0,0,1
"13728","circling",0,1,0,0,1
"13729","circulars",1,0,0,0,1
"13730","circulated",1,0,0,0,1
"13731","circumference",1,0,0,0,1
"13732","circumstanceoccurred",1,0,0,0,1
"13733","circumstances.as",1,0,0,0,1
"13734","circumstances.while",1,0,0,0,1
"13735","circumstances.without",1,0,0,0,1
"13736","circumstancesare",1,0,0,0,1
"13737","circumstancethat",1,0,0,0,1
"13738","circumvent",1,0,0,0,1
"13739","citizen.when",1,0,0,0,1
"13740","citizenof",1,0,0,0,1
"13741","citizens.i",1,0,0,0,1
"13742","citizens.the",1,0,0,0,1
"13743","city.secrecy",1,0,0,0,1
"13744","cityat",1,0,0,0,1
"13745","citylimits",1,0,0,0,1
"13746","cityrecently",1,0,0,0,1
"13747","civiland",1,0,0,0,1
"13748","civilization.allow",1,0,0,0,1
"13749","civilizationof",1,0,0,0,1
"13750","civilizedpeople",1,0,0,0,1
"13751","civilizedworld",1,0,0,0,1
"13752","civilizing",0,1,0,0,1
"13753","civilly",1,0,0,0,1
"13754","civilpower",1,0,0,0,1
"13755","claimant",1,0,0,0,1
"13756","claimfull",1,0,0,0,1
"13757","claimsof",1,0,0,0,1
"13758","clamored",1,0,0,0,1
"13759","clamour",0,0,0,1,1
"13760","clamouring",0,0,0,1,1
"13761","clanking",0,0,1,0,1
"13762","clap",1,0,0,0,1
"13763","clapham",1,0,0,0,1
"13764","clapped",1,0,0,0,1
"13765","clarks",1,0,0,0,1
"13766","clasped",1,0,0,0,1
"13767","class_",0,1,0,0,1
"13768","class.her",1,0,0,0,1
"13769","classed",0,0,0,1,1
"13770","classesof",1,0,0,0,1
"13771","classical",1,0,0,0,1
"13772","classics",0,1,0,0,1
"13773","classifying",0,1,0,0,1
"13774","classleader",0,1,0,0,1
"13775","classwas",1,0,0,0,1
"13776","classwhose",1,0,0,0,1
"13777","clave",0,1,0,0,1
"13778","clay’s",1,0,0,0,1
"13779","cleanse",0,1,0,0,1
"13780","cleansed",1,0,0,0,1
"13781","cleansing",0,1,0,0,1
"13782","clearcomprehension",1,0,0,0,1
"13783","clearconception",1,0,0,0,1
"13784","clearing",0,0,1,0,1
"13785","clearsighted",1,0,0,0,1
"13786","cleinly",0,0,0,1,1
"13787","clemency",0,1,0,0,1
"13788","cleverly",0,1,0,0,1
"13789","click",1,0,0,0,1
"13790","climb",1,0,0,0,1
"13791","climbing",0,1,0,0,1
"13792","cling",0,0,1,0,1
"13793","clinging",1,0,0,0,1
"13794","clinton",1,0,0,0,1
"13795","clippers",0,1,0,0,1
"13796","closedtheir",1,0,0,0,1
"13797","closelytrimmed",1,0,0,0,1
"13798","closeof",1,0,0,0,1
"13799","closerexamination",1,0,0,0,1
"13800","closes",0,0,0,1,1
"13801","closethe",1,0,0,0,1
"13802","clotheevangelical",1,0,0,0,1
"13803","clother",1,0,0,0,1
"13804","cloths",0,0,0,1,1
"13805","cloudy",0,0,0,1,1
"13806","cloven",0,1,0,0,1
"13807","clubs",0,1,0,0,1
"13808","clumsily",0,1,0,0,1
"13809","clumsy",0,1,0,0,1
"13810","clustered",0,1,0,0,1
"13811","clusteredround",1,0,0,0,1
"13812","clusters",0,0,0,1,1
"13813","clutch",1,0,0,0,1
"13814","clutched",0,1,0,0,1
"13815","clutches",1,0,0,0,1
"13816","coach",0,0,1,0,1
"13817","coachman",1,0,0,0,1
"13818","coachwith",1,0,0,0,1
"13819","coals",0,1,0,0,1
"13820","coarsely",0,1,0,0,1
"13821","coatabout",1,0,0,0,1
"13822","coated",0,1,0,0,1
"13823","coaxed",1,0,0,0,1
"13824","coaxened",0,0,0,1,1
"13825","coaxing",0,1,0,0,1
"13826","cobdenhad",1,0,0,0,1
"13827","cock",1,0,0,0,1
"13828","code_",0,1,0,0,1
"13829","coerce",1,0,0,0,1
"13830","coextensive",0,1,0,0,1
"13831","coffins",0,0,0,1,1
"13832","cogent",1,0,0,0,1
"13833","cognizance",0,1,0,0,1
"13834","cognizanceof",1,0,0,0,1
"13835","coiled",0,0,1,0,1
"13836","coin",1,0,0,0,1
"13837","coincided",0,0,1,0,1
"13838","col.edward",1,0,0,0,1
"13839","col.shaw",1,0,0,0,1
"13840","coldand",1,0,0,0,1
"13841","coldhearted",0,1,0,0,1
"13842","colection",0,0,0,1,1
"13843","coleridge",0,1,0,0,1
"13844","collapse",1,0,0,0,1
"13845","collections",1,0,0,0,1
"13846","collectorat",1,0,0,0,1
"13847","collectsufficient",1,0,0,0,1
"13848","collisions",0,1,0,0,1
"13849","collison",0,1,0,0,1
"13850","colonellloyd",1,0,0,0,1
"13851","coloneltreat",1,0,0,0,1
"13852","colonial",1,0,0,0,1
"13853","colony.the",1,0,0,0,1
"13854","color.in",1,0,0,0,1
"13855","coloredand",1,0,0,0,1
"13856","coloredbrother",1,0,0,0,1
"13857","coloredcitizens",1,0,0,0,1
"13858","coloredflowers",1,0,0,0,1
"13859","coloredfriend",1,0,0,0,1
"13860","coloredfriends",1,0,0,0,1
"13861","coloredmaid",1,0,0,0,1
"13862","coloredman’s",1,0,0,0,1
"13863","coloredmen",1,0,0,0,1
"13864","coloredpassenger",1,0,0,0,1
"13865","coloredpassengers",1,0,0,0,1
"13866","coloredperson",1,0,0,0,1
"13867","coloredresidents",1,0,0,0,1
"13868","coloredunited",1,0,0,0,1
"13869","colorof",1,0,0,0,1
"13870","colorphobia",1,0,0,0,1
"13871","colorto",1,0,0,0,1
"13872","colossium",0,0,0,1,1
"13873","colouma",0,0,0,1,1
"13874","columbia.it",1,0,0,0,1
"13875","columbianorator",1,0,0,0,1
"13876","columbus",1,0,0,0,1
"13877","combating",0,0,1,0,1
"13878","combats",0,1,0,0,1
"13879","combe’s",1,0,0,0,1
"13880","combined.equally",1,0,0,0,1
"13881","combines",0,1,0,0,1
"13882","combustible",0,1,0,0,1
"13883","come.the",1,0,0,0,1
"13884","comefor",1,0,0,0,1
"13885","comehelp",1,0,0,0,1
"13886","comeinto",1,0,0,0,1
"13887","comeliness",0,1,0,0,1
"13888","comelycolored",1,0,0,0,1
"13889","comers",0,1,0,0,1
"13890","comes",0,0,0,1,1
"13891","cometh",0,1,0,0,1
"13892","comewhat",1,0,0,0,1
"13893","comfortablemethod",1,0,0,0,1
"13894","comfortableretreats",1,0,0,0,1
"13895","comforting",0,1,0,0,1
"13896","comicfeatures",1,0,0,0,1
"13897","comin",0,1,0,0,1
"13898","comingchapters",1,0,0,0,1
"13899","comingfrom",1,0,0,0,1
"13900","comings",0,0,1,0,1
"13901","comingto",1,0,0,0,1
"13902","comingtoward",1,0,0,0,1
"13903","commandand",1,0,0,0,1
"13904","commandedthe",1,0,0,0,1
"13905","commanders",1,0,0,0,1
"13906","commandof",1,0,0,0,1
"13907","commandto",1,0,0,0,1
"13908","commemorating",1,0,0,0,1
"13909","commenced.the",1,0,0,0,1
"13910","commendable",0,1,0,0,1
"13911","commendedfor",1,0,0,0,1
"13912","commendto",1,0,0,0,1
"13913","comment",0,1,0,0,1
"13914","commentary",1,0,0,0,1
"13915","comments",1,0,0,0,1
"13916","commerceand",1,0,0,0,1
"13917","commissary",1,0,0,0,1
"13918","commitany",1,0,0,0,1
"13919","committedany",1,0,0,0,1
"13920","committedin",1,0,0,0,1
"13921","committedthe",1,0,0,0,1
"13922","committingthe",1,0,0,0,1
"13923","commodore",1,0,0,0,1
"13924","commoncause",1,0,0,0,1
"13925","commonlaborer",1,0,0,0,1
"13926","commonpassion",1,0,0,0,1
"13927","commonpeople",1,0,0,0,1
"13928","commonto",1,0,0,0,1
"13929","commotion",1,0,0,0,1
"13930","communicationthat",1,0,0,0,1
"13931","communicative",0,1,0,0,1
"13932","community.the",1,0,0,0,1
"13933","communityi",1,0,0,0,1
"13934","compactand",1,0,0,0,1
"13935","companions_",0,1,0,0,1
"13936","companionship",1,0,0,0,1
"13937","companythat",1,0,0,0,1
"13938","companywith",1,0,0,0,1
"13939","comparativeindependence",1,0,0,0,1
"13940","comparativelyfree.slaves",1,0,0,0,1
"13941","comparativelyunimportant",1,0,0,0,1
"13942","comparativepeace",1,0,0,0,1
"13943","comparedfavorably",1,0,0,0,1
"13944","comparing",0,1,0,0,1
"13945","compass",0,0,1,0,1
"13946","compassing",0,0,1,0,1
"13947","compelconsideration",1,0,0,0,1
"13948","compelledoften",1,0,0,0,1
"13949","compelledto",1,0,0,0,1
"13950","compelutterance",1,0,0,0,1
"13951","compensate",0,0,1,0,1
"13952","compensatedme",1,0,0,0,1
"13953","compensations",1,0,0,0,1
"13954","compensations.in",1,0,0,0,1
"13955","competency",1,0,0,0,1
"13956","competitor",1,0,0,0,1
"13957","complacency.i",1,0,0,0,1
"13958","complete.during",1,0,0,0,1
"13959","completehelplessness",1,0,0,0,1
"13960","completelyfulfilled",1,0,0,0,1
"13961","completelyput",1,0,0,0,1
"13962","completeness",1,0,0,0,1
"13963","complicity",1,0,0,0,1
"13964","compliedfor",1,0,0,0,1
"13965","complimentwhich",1,0,0,0,1
"13966","comply.i",1,0,0,0,1
"13967","complyingwith",1,0,0,0,1
"13968","composing",1,0,0,0,1
"13969","comprehends",0,1,0,0,1
"13970","comprehensivestatesman",1,0,0,0,1
"13971","compression",1,0,0,0,1
"13972","comprised",0,1,0,0,1
"13973","comprisedtwenty",1,0,0,0,1
"13974","compromise.to",1,0,0,0,1
"13975","compromisealluded",1,0,0,0,1
"13976","compromisers",1,0,0,0,1
"13977","compromises",1,0,0,0,1
"13978","compromising",0,1,0,0,1
"13979","conceals",0,1,0,0,1
"13980","conceivethat",1,0,0,0,1
"13981","concentrating",0,1,0,0,1
"13982","conceptions",0,1,0,0,1
"13983","concernedabout",1,0,0,0,1
"13984","concerningtheir",1,0,0,0,1
"13985","concessions.they",1,0,0,0,1
"13986","conciliatory",1,0,0,0,1
"13987","concludes",0,1,0,0,1
"13988","concluding",1,0,0,0,1
"13989","conclusion.as",1,0,0,0,1
"13990","conclusionthat",1,0,0,0,1
"13991","conclusiveon",1,0,0,0,1
"13992","concord",0,0,0,1,1
"13993","concubinage",0,0,1,0,1
"13994","concurred",1,0,0,0,1
"13995","condemnationof",1,0,0,0,1
"13996","condemnedme",1,0,0,0,1
"13997","condensation",1,0,0,0,1
"13998","condenses",0,1,0,0,1
"13999","condescend",0,1,0,0,1
"14000","condescendedto",1,0,0,0,1
"14001","condescendto",1,0,0,0,1
"14002","condescension",0,1,0,0,1
"14003","condition_",0,1,0,0,1
"14004","condition.i",1,0,0,0,1
"14005","conditional",1,0,0,0,1
"14006","conditionally",1,0,0,0,1
"14007","conditionscan",1,0,0,0,1
"14008","conditionsless",1,0,0,0,1
"14009","conditionwas",1,0,0,0,1
"14010","condolence.the",1,0,0,0,1
"14011","conductof",1,0,0,0,1
"14012","confer",1,0,0,0,1
"14013","conferences",1,0,0,0,1
"14014","conferred",0,0,1,0,1
"14015","conferwith",1,0,0,0,1
"14016","confessing",0,1,0,0,1
"14017","confessionheard",1,0,0,0,1
"14018","confessionof",1,0,0,0,1
"14019","confidenceof",1,0,0,0,1
"14020","confidencewas",1,0,0,0,1
"14021","confidently",1,0,0,0,1
"14022","confidentutterances",1,0,0,0,1
"14023","confine",0,1,0,0,1
"14024","confinedwithin",1,0,0,0,1
"14025","confirm",0,1,0,0,1
"14026","confirmationbefore",1,0,0,0,1
"14027","conflagration",0,1,0,0,1
"14028","conflictdid",1,0,0,0,1
"14029","conflicts",0,1,0,0,1
"14030","confluence",1,0,0,0,1
"14031","conform.it",1,0,0,0,1
"14032","conformists",0,1,0,0,1
"14033","conforms",1,0,0,0,1
"14034","confront",0,1,0,0,1
"14035","confusionof",1,0,0,0,1
"14036","conglomeration",0,1,0,0,1
"14037","congratulated",1,0,0,0,1
"14038","congratulation",1,0,0,0,1
"14039","congregational",1,0,0,0,1
"14040","congressby",1,0,0,0,1
"14041","congressfrom",1,0,0,0,1
"14042","congressto",1,0,0,0,1
"14043","conical",0,0,0,1,1
"14044","conjectures",0,0,1,0,1
"14045","conjunction",1,0,0,0,1
"14046","conjuration",1,0,0,0,1
"14047","conn",1,0,0,0,1
"14048","connecticut",1,0,0,0,1
"14049","conquering",1,0,0,0,1
"14050","consciencecannot",1,0,0,0,1
"14051","conscientiously",1,0,0,0,1
"14052","consecrate",0,0,1,0,1
"14053","consecrated",0,0,1,0,1
"14054","consecrating",0,0,1,0,1
"14055","consentto",1,0,0,0,1
"14056","consequencein",1,0,0,0,1
"14057","consequenceof",1,0,0,0,1
"14058","consequencewhether",1,0,0,0,1
"14059","consequentusefulness.here",1,0,0,0,1
"14060","conservatismunited",1,0,0,0,1
"14061","conservativeclass",1,0,0,0,1
"14062","conservatives",1,0,0,0,1
"14063","conserve",0,0,0,1,1
"14064","considerablelength",1,0,0,0,1
"14065","considerablesums",1,0,0,0,1
"14066","considerablydistinguished",1,0,0,0,1
"14067","consideredme",1,0,0,0,1
"14068","considering",0,0,0,1,1
"14069","considertion",0,1,0,0,1
"14070","consignment",1,0,0,0,1
"14071","consigns",0,1,0,0,1
"14072","consist",0,0,0,1,1
"14073","consistedof",1,0,0,0,1
"14074","consistory",0,0,0,1,1
"14075","consociate",0,1,0,0,1
"14076","consolidating",0,1,0,0,1
"14077","consolingthought",1,0,0,0,1
"14078","conspicuousand",1,0,0,0,1
"14079","conspiring",1,0,0,0,1
"14080","constableswere",1,0,0,0,1
"14081","constancy",1,0,0,0,1
"14082","constantlyregarded",1,0,0,0,1
"14083","constantsinging",1,0,0,0,1
"14084","consternation.the",1,0,0,0,1
"14085","constitutes",0,1,0,0,1
"14086","constitution.we",1,0,0,0,1
"14087","constitutionin",1,0,0,0,1
"14088","constitutions",0,1,0,0,1
"14089","construct",1,0,0,0,1
"14090","construction",1,0,0,0,1
"14091","consults",1,0,0,0,1
"14092","consuming",1,0,0,0,1
"14093","consummate",0,0,1,0,1
"14094","consummation",1,0,0,0,1
"14095","consur",0,0,0,1,1
"14096","containnumerous",1,0,0,0,1
"14097","contentedin",1,0,0,0,1
"14098","continents",1,0,0,0,1
"14099","contingency",1,0,0,0,1
"14100","contingencythey",1,0,0,0,1
"14101","continual",0,1,0,0,1
"14102","continuanceof",1,0,0,0,1
"14103","continuedduring",1,0,0,0,1
"14104","continuous",0,1,0,0,1
"14105","contortions",0,0,0,1,1
"14106","contrabands",1,0,0,0,1
"14107","contract",0,1,0,0,1
"14108","contractresting",1,0,0,0,1
"14109","contradicted",1,0,0,0,1
"14110","contradictionnow",1,0,0,0,1
"14111","contradictions",1,0,0,0,1
"14112","contradictthat",1,0,0,0,1
"14113","contradistinction",0,1,0,0,1
"14114","contrast.the",1,0,0,0,1
"14115","contravenes",0,1,0,0,1
"14116","contribution",1,0,0,0,1
"14117","contrived",1,0,0,0,1
"14118","control.invited",1,0,0,0,1
"14119","controlwhich",1,0,0,0,1
"14120","controversies",1,0,0,0,1
"14121","convened",1,0,0,0,1
"14122","conventionalities",0,1,0,0,1
"14123","conversingfor",1,0,0,0,1
"14124","converted.my",1,0,0,0,1
"14125","convertinghis",1,0,0,0,1
"14126","convictionbecame",1,0,0,0,1
"14127","convictions.on",1,0,0,0,1
"14128","convictionthat",1,0,0,0,1
"14129","convulsed",0,1,0,0,1
"14130","cookmanwas",1,0,0,0,1
"14131","coolor",1,0,0,0,1
"14132","cooperate",0,1,0,0,1
"14133","coöperated",1,0,0,0,1
"14134","cooperating",0,1,0,0,1
"14135","coöperating",1,0,0,0,1
"14136","cooperation",0,1,0,0,1
"14137","cope",1,0,0,0,1
"14138","copeland",1,0,0,0,1
"14139","copies",1,0,0,0,1
"14140","coppering",0,1,0,0,1
"14141","coptic",0,0,0,1,1
"14142","copyingfrom",1,0,0,0,1
"14143","copyingthe",1,0,0,0,1
"14144","copyist",0,0,1,0,1
"14145","cordialgreeting",1,0,0,0,1
"14146","core",0,1,0,0,1
"14147","corinithian",0,0,0,1,1
"14148","cornhill",0,0,1,0,1
"14149","cornlaw",1,0,0,0,1
"14150","coron",0,0,0,1,1
"14151","coroner",0,0,1,0,1
"14152","corporate",1,0,0,0,1
"14153","corporation",1,0,0,0,1
"14154","corps",1,0,0,0,1
"14155","corpsof",1,0,0,0,1
"14156","correctnessof",1,0,0,0,1
"14157","corresponded",1,0,0,0,1
"14158","correspondence_possible_",1,0,0,0,1
"14159","correspondencecarried",1,0,0,0,1
"14160","correspondingly",1,0,0,0,1
"14161","corresponds",1,0,0,0,1
"14162","corridors",1,0,0,0,1
"14163","corrodors",0,0,0,1,1
"14164","corrupted",0,1,0,0,1
"14165","corrupting",0,1,0,0,1
"14166","corruption",0,1,0,0,1
"14167","cosdry.although",1,0,0,0,1
"14168","costing",0,1,0,0,1
"14169","cot",0,1,0,0,1
"14170","cottages",0,0,0,1,1
"14171","cottonand",1,0,0,0,1
"14172","couldassist",1,0,0,0,1
"14173","couldbring",1,0,0,0,1
"14174","couldcome",1,0,0,0,1
"14175","coulddesire",1,0,0,0,1
"14176","coulddo",1,0,0,0,1
"14177","couldeasily",1,0,0,0,1
"14178","couldentertain",1,0,0,0,1
"14179","couldoccasionally",1,0,0,0,1
"14180","couldplease",1,0,0,0,1
"14181","couldrealize",1,0,0,0,1
"14182","couldreally",1,0,0,0,1
"14183","couldsee",1,0,0,0,1
"14184","couldthey",1,0,0,0,1
"14185","couldto",1,0,0,0,1
"14186","counseland",1,0,0,0,1
"14187","counseled",1,0,0,0,1
"14188","counselledme",1,0,0,0,1
"14189","counselledthe",1,0,0,0,1
"14190","counsellors",1,0,0,0,1
"14191","counselsprevailed",1,0,0,0,1
"14192","countenancesuch",1,0,0,0,1
"14193","countenancewhen",1,0,0,0,1
"14194","counteractand",1,0,0,0,1
"14195","counterfeits",0,1,0,0,1
"14196","countermanded",1,0,0,0,1
"14197","country.about",1,0,0,0,1
"14198","country.after",1,0,0,0,1
"14199","country.few",1,0,0,0,1
"14200","country.we",1,0,0,0,1
"14201","country’scause",1,0,0,0,1
"14202","countryagainst",1,0,0,0,1
"14203","countryare",1,0,0,0,1
"14204","countryfrom",1,0,0,0,1
"14205","countryi",1,0,0,0,1
"14206","countryinto",1,0,0,0,1
"14207","countryis",1,0,0,0,1
"14208","countryman",1,0,0,0,1
"14209","countrymenagainst",1,0,0,0,1
"14210","countryor",1,0,0,0,1
"14211","countrywas",1,0,0,0,1
"14212","countrywhose",1,0,0,0,1
"14213","county_",1,0,0,0,1
"14214","countyfrom",1,0,0,0,1
"14215","courage.you",1,0,0,0,1
"14216","courageequal",1,0,0,0,1
"14217","coursed",1,0,0,0,1
"14218","courseformed",1,0,0,0,1
"14219","coursethereafter",1,0,0,0,1
"14220","courseto",1,0,0,0,1
"14221","courteously",0,0,0,1,1
"14222","courtious",0,0,0,1,1
"14223","courtship.although",1,0,0,0,1
"14224","cousien",0,0,0,1,1
"14225","coventry",1,0,0,0,1
"14226","coveredwagons",1,0,0,0,1
"14227","coveted",0,1,0,0,1
"14228","covetedprivilege",1,0,0,0,1
"14229","covey.my",1,0,0,0,1
"14230","covey.while",1,0,0,0,1
"14231","covey’s.escape",1,0,0,0,1
"14232","covey’s.notwithstanding",1,0,0,0,1
"14233","coveyand",1,0,0,0,1
"14234","coveyhad",1,0,0,0,1
"14235","coveyhave",1,0,0,0,1
"14236","coveyon",1,0,0,0,1
"14237","coveys",0,1,0,0,1
"14238","coveythought",1,0,0,0,1
"14239","coveywas",1,0,0,0,1
"14240","coveywished",1,0,0,0,1
"14241","coveywould",1,0,0,0,1
"14242","cowardlyalarm",1,0,0,0,1
"14243","cowardlyone",1,0,0,0,1
"14244","cowards",1,0,0,0,1
"14245","cowhideleather",1,0,0,0,1
"14246","craftyand",1,0,0,0,1
"14247","cram",0,0,1,0,1
"14248","cramming",0,1,0,0,1
"14249","crampedand",1,0,0,0,1
"14250","crane",1,0,0,0,1
"14251","cravat",1,0,0,0,1
"14252","crazy",1,0,0,0,1
"14253","creatureof",1,0,0,0,1
"14254","credence",0,1,0,0,1
"14255","credit.after",1,0,0,0,1
"14256","creditablemanner",1,0,0,0,1
"14257","credited",1,0,0,0,1
"14258","creditof",1,0,0,0,1
"14259","creditor",1,0,0,0,1
"14260","creditors",1,0,0,0,1
"14261","creduality",0,0,0,1,1
"14262","credulous",0,0,0,1,1
"14263","creeds",1,0,0,0,1
"14264","creeping",1,0,0,0,1
"14265","creet",0,0,0,1,1
"14266","crept",0,1,0,0,1
"14267","crested",1,0,0,0,1
"14268","crevice",0,1,0,0,1
"14269","crevices",0,1,0,0,1
"14270","crime.i",1,0,0,0,1
"14271","crime.we",1,0,0,0,1
"14272","criminalwas",1,0,0,0,1
"14273","crimsoned",0,0,1,0,1
"14274","crippleand",1,0,0,0,1
"14275","crisen",0,0,0,1,1
"14276","crispy",1,0,0,0,1
"14277","criterion",0,0,0,1,1
"14278","criticise",0,1,0,0,1
"14279","criticize",1,0,0,0,1
"14280","crocodile",0,0,1,0,1
"14281","crooked",0,0,0,1,1
"14282","crookedess",0,0,0,1,1
"14283","cropped",0,1,0,0,1
"14284","crosses",0,0,0,1,1
"14285","crouch",0,0,1,0,1
"14286","crowbar",0,0,1,0,1
"14287","crowcar",1,0,0,0,1
"14288","crowdedwith",1,0,0,0,1
"14289","crowdto",1,0,0,0,1
"14290","crownof",1,0,0,0,1
"14291","crucified",0,0,0,1,1
"14292","crucifixion",0,0,0,1,1
"14293","crude",0,1,0,0,1
"14294","cruelenactment",1,0,0,0,1
"14295","cruellyabused",1,0,0,0,1
"14296","crueltiesand",1,0,0,0,1
"14297","cruelty_",0,1,0,0,1
"14298","cruelty.to",1,0,0,0,1
"14299","crumb",0,1,0,0,1
"14300","crumble",0,0,0,1,1
"14301","crumbled",1,0,0,0,1
"14302","crummells",1,0,0,0,1
"14303","crusade",1,0,0,0,1
"14304","crushedmy",1,0,0,0,1
"14305","crushingit",1,0,0,0,1
"14306","cruss",0,1,0,0,1
"14307","crutches",0,1,0,0,1
"14308","cudgel",0,0,1,0,1
"14309","cuffs",0,1,0,0,1
"14310","culminating",1,0,0,0,1
"14311","cultivate",0,1,0,0,1
"14312","cumber",0,1,0,0,1
"14313","cumbering",0,1,0,0,1
"14314","cumbrous",0,1,0,0,1
"14315","cumin",0,0,1,0,1
"14316","cupidity",1,0,0,0,1
"14317","curbstone",1,0,0,0,1
"14318","cured",0,1,0,0,1
"14319","curiosities",0,0,0,1,1
"14320","curiously",0,0,0,1,1
"14321","currentexpenses",1,0,0,0,1
"14322","currentof",1,0,0,0,1
"14323","curried",0,0,1,0,1
"14324","cursedme",1,0,0,0,1
"14325","curses.the",1,0,0,0,1
"14326","curtailing",1,0,0,0,1
"14327","curtainof",1,0,0,0,1
"14328","curtiss",1,0,0,0,1
"14329","curves",0,0,0,1,1
"14330","custodian",1,0,0,0,1
"14331","custody",1,0,0,0,1
"14332","custom.our",1,0,0,0,1
"14333","customin",1,0,0,0,1
"14334","cutter:i",1,0,0,0,1
"14335","cutup",1,0,0,0,1
"14336","cyphering",0,1,0,0,1
"14337","d.d",1,0,0,0,1
"14338","d.porter",1,0,0,0,1
"14339","dahhabezez",0,0,0,1,1
"14340","damages",1,0,0,0,1
"14341","damagingthan",1,0,0,0,1
"14342","damper",1,0,0,0,1
"14343","dancing.with",1,0,0,0,1
"14344","dangerously",0,0,1,0,1
"14345","danielmitchell",1,0,0,0,1
"14346","danielo’connell",1,0,0,0,1
"14347","danielwebster",1,0,0,0,1
"14348","dareis",1,0,0,0,1
"14349","darkcorner.this",1,0,0,0,1
"14350","darkened",0,1,0,0,1
"14351","darkening",0,1,0,0,1
"14352","darkens",0,0,0,1,1
"14353","darktransaction",1,0,0,0,1
"14354","darky",0,0,1,0,1
"14355","dartedtoward",1,0,0,0,1
"14356","dartmouth",0,1,0,0,1
"14357","dashedthemselves",1,0,0,0,1
"14358","dast",0,0,0,1,1
"14359","dauntless",1,0,0,0,1
"14360","daves",0,0,0,1,1
"14361","dawn.i",1,0,0,0,1
"14362","dawnedupon",1,0,0,0,1
"14363","dawns",1,0,0,0,1
"14364","day.after",1,0,0,0,1
"14365","day.well",1,0,0,0,1
"14366","day’sindependence",1,0,0,0,1
"14367","dayafter",1,0,0,0,1
"14368","daybe",1,0,0,0,1
"14369","dayfor",1,0,0,0,1
"14370","dayin",1,0,0,0,1
"14371","dayis",1,0,0,0,1
"14372","daylonger",1,0,0,0,1
"14373","daysand",1,0,0,0,1
"14374","daysduring",1,0,0,0,1
"14375","daysfor",1,0,0,0,1
"14376","daysstretched",1,0,0,0,1
"14377","daysthat",1,0,0,0,1
"14378","dayswere",1,0,0,0,1
"14379","dayton",1,0,0,0,1
"14380","daywas",1,0,0,0,1
"14381","dazzled",1,0,0,0,1
"14382","deadest ",0,0,0,1,1
"14383","deadlyhate",1,0,0,0,1
"14384","deadlypurpose",1,0,0,0,1
"14385","deafen",0,1,0,0,1
"14386","dealwith",1,0,0,0,1
"14387","dearborns",0,0,1,0,1
"14388","death.once",1,0,0,0,1
"14389","death.previously",1,0,0,0,1
"14390","death.there",1,0,0,0,1
"14391","debarred",0,1,0,0,1
"14392","debase",0,0,1,0,1
"14393","debaters",1,0,0,0,1
"14394","debauch.the",1,0,0,0,1
"14395","debts",1,0,0,0,1
"14396","debuty",0,1,0,0,1
"14397","decades",1,0,0,0,1
"14398","decalogue",0,1,0,0,1
"14399","decanters",1,0,0,0,1
"14400","decayed",1,0,0,0,1
"14401","decaying",0,1,0,0,1
"14402","deceitful",0,0,1,0,1
"14403","deceiver",0,0,1,0,1
"14404","decent",0,1,0,0,1
"14405","decently",1,0,0,0,1
"14406","deception",0,1,0,0,1
"14407","deceptive",0,1,0,0,1
"14408","decisive",1,0,0,0,1
"14409","deckand",1,0,0,0,1
"14410","declamatory",0,1,0,0,1
"14411","declared.in",1,0,0,0,1
"14412","declaringhimself",1,0,0,0,1
"14413","decorously",0,1,0,0,1
"14414","decorously.this",1,0,0,0,1
"14415","decosa",1,0,0,0,1
"14416","decrees",0,1,0,0,1
"14417","decry",1,0,0,0,1
"14418","dedicateda",1,0,0,0,1
"14419","deduction",0,1,0,0,1
"14420","deductive",0,1,0,0,1
"14421","deeming",0,1,0,0,1
"14422","deemingit",1,0,0,0,1
"14423","deepemotion",1,0,0,0,1
"14424","deeperlove",1,0,0,0,1
"14425","deepestinterest",1,0,0,0,1
"14426","deepgashes",1,0,0,0,1
"14427","deepimpression",1,0,0,0,1
"14428","deeplyattached",1,0,0,0,1
"14429","deeplydistressed",1,0,0,0,1
"14430","deeplymoved",1,0,0,0,1
"14431","deepsatisfaction",1,0,0,0,1
"14432","deface",0,1,0,0,1
"14433","defeating",1,0,0,0,1
"14434","defeats",1,0,0,0,1
"14435","defectsinherited",1,0,0,0,1
"14436","defendedslavery",1,0,0,0,1
"14437","defenderof",1,0,0,0,1
"14438","defendingourselves",1,0,0,0,1
"14439","defendthemselves",1,0,0,0,1
"14440","defense_",0,1,0,0,1
"14441","defenseof",1,0,0,0,1
"14442","defiled",0,0,1,0,1
"14443","define",0,1,0,0,1
"14444","definedin",1,0,0,0,1
"14445","defraud",1,0,0,0,1
"14446","defying",0,1,0,0,1
"14447","degation",0,0,0,1,1
"14448","degradation.to",1,0,0,0,1
"14449","degradationof",1,0,0,0,1
"14450","degradingpunishment",1,0,0,0,1
"14451","degreeof",1,0,0,0,1
"14452","deify",0,0,0,1,1
"14453","deity",0,0,0,1,1
"14454","dejection",1,0,0,0,1
"14455","dela",0,0,0,1,1
"14456","delany",0,0,0,1,1
"14457","delapidated",1,0,0,0,1
"14458","delay.i",1,0,0,0,1
"14459","delayed.it",1,0,0,0,1
"14460","delays",0,1,0,0,1
"14461","delegated",1,0,0,0,1
"14462","delegatesfrom",1,0,0,0,1
"14463","delegation.both",1,0,0,0,1
"14464","delegationmade",1,0,0,0,1
"14465","delegent",0,0,0,1,1
"14466","deleterious",0,1,0,0,1
"14467","deliberations",1,0,0,0,1
"14468","delicately",1,0,0,0,1
"14469","delicatelyformed",1,0,0,0,1
"14470","delightfuli",1,0,0,0,1
"14471","delightfully",0,1,0,0,1
"14472","delightfulmorning",1,0,0,0,1
"14473","delineation",1,0,0,0,1
"14474","delivera",1,0,0,0,1
"14475","deliveredby",1,0,0,0,1
"14476","deliveredup",1,0,0,0,1
"14477","delivering",1,0,0,0,1
"14478","delusive.life",1,0,0,0,1
"14479","delve",0,1,0,0,1
"14480","demagogue.i",1,0,0,0,1
"14481","demandfor",1,0,0,0,1
"14482","demandingmy",1,0,0,0,1
"14483","demeanor",0,1,0,0,1
"14484","democraticfellow",1,0,0,0,1
"14485","demon.he",1,0,0,0,1
"14486","demonstratedthat",1,0,0,0,1
"14487","demoralize",0,1,0,0,1
"14488","demoralized",1,0,0,0,1
"14489","denby.on",1,0,0,0,1
"14490","denbythree",1,0,0,0,1
"14491","denialof",1,0,0,0,1
"14492","denialto",1,0,0,0,1
"14493","denialwith",1,0,0,0,1
"14494","denmark",1,0,0,0,1
"14495","denominated",1,0,0,0,1
"14496","denomination",1,0,0,0,1
"14497","denominational",0,1,0,0,1
"14498","denouncedthis",1,0,0,0,1
"14499","denounceit",1,0,0,0,1
"14500","denounces",0,1,0,0,1
"14501","denouncethe",1,0,0,0,1
"14502","denouncingsouth",1,0,0,0,1
"14503","denton",0,1,0,0,1
"14504","denunciationthan",1,0,0,0,1
"14505","denunciatory",0,1,0,0,1
"14506","departin",1,0,0,0,1
"14507","departureof",1,0,0,0,1
"14508","departwithout",1,0,0,0,1
"14509","dependedon",1,0,0,0,1
"14510","dependedupon",1,0,0,0,1
"14511","depict",0,0,1,0,1
"14512","depicted",1,0,0,0,1
"14513","depictedon",1,0,0,0,1
"14514","depleted",1,0,0,0,1
"14515","deport",1,0,0,0,1
"14516","deported",1,0,0,0,1
"14517","deposit",1,0,0,0,1
"14518","deposits",1,0,0,0,1
"14519","depraved",0,1,0,0,1
"14520","depreciated",0,1,0,0,1
"14521","depressing",0,1,0,0,1
"14522","deprivethe",1,0,0,0,1
"14523","depriving",0,1,0,0,1
"14524","deputies",1,0,0,0,1
"14525","der",0,0,0,1,1
"14526","derisionat",1,0,0,0,1
"14527","derisionof",1,0,0,0,1
"14528","derives",1,0,0,0,1
"14529","des",0,0,0,1,1
"14530","descendant",1,0,0,0,1
"14531","descends",0,1,0,0,1
"14532","described.chapter",1,0,0,0,1
"14533","describes",0,1,0,0,1
"14534","describeto",1,0,0,0,1
"14535","description.the",1,0,0,0,1
"14536","descriptionof",1,0,0,0,1
"14537","desdemoni",0,0,0,1,1
"14538","desease",0,0,0,1,1
"14539","desecrate",0,1,0,0,1
"14540","desecrated",0,1,0,0,1
"14541","desertedfor",1,0,0,0,1
"14542","desertmy",1,0,0,0,1
"14543","desideratum",1,0,0,0,1
"14544","designated.recognizing",1,0,0,0,1
"14545","designedto",1,0,0,0,1
"14546","desiredme",1,0,0,0,1
"14547","desiremy",1,0,0,0,1
"14548","desireof",1,0,0,0,1
"14549","desistthen",1,0,0,0,1
"14550","despairedof",1,0,0,0,1
"14551","despatched",1,0,0,0,1
"14552","desperateunder",1,0,0,0,1
"14553","desperation.thus",1,0,0,0,1
"14554","desperationi",1,0,0,0,1
"14555","despisableby",1,0,0,0,1
"14556","despised.chapter",1,0,0,0,1
"14557","despisedclass",1,0,0,0,1
"14558","despiseth",0,1,0,0,1
"14559","despisethemselves.you",1,0,0,0,1
"14560","despising",0,1,0,0,1
"14561","despite",0,0,0,1,1
"14562","despoiled",1,0,0,0,1
"14563","despotesum",0,0,0,1,1
"14564","despotic",0,1,0,0,1
"14565","despotism",1,0,0,0,1
"14566","despotisms",0,1,0,0,1
"14567","destinyis",1,0,0,0,1
"14568","destinynearer",1,0,0,0,1
"14569","destinyof",1,0,0,0,1
"14570","destitutionof",1,0,0,0,1
"14571","destroyers",1,0,0,0,1
"14572","destruction.as",1,0,0,0,1
"14573","destruction.the",1,0,0,0,1
"14574","detail",0,0,0,1,1
"14575","details.as",1,0,0,0,1
"14576","detailsconcerning",1,0,0,0,1
"14577","detailsof",1,0,0,0,1
"14578","detectives",1,0,0,0,1
"14579","detectno",1,0,0,0,1
"14580","detention",1,0,0,0,1
"14581","deterioration",0,0,1,0,1
"14582","determination.toward",1,0,0,0,1
"14583","determined.though",1,0,0,0,1
"14584","determinedon",1,0,0,0,1
"14585","determinedthat",1,0,0,0,1
"14586","detestablecharacter",1,0,0,0,1
"14587","detestedslavery",1,0,0,0,1
"14588","detraction",1,0,0,0,1
"14589","detracts",0,1,0,0,1
"14590","detroit",1,0,0,0,1
"14591","developing",0,1,0,0,1
"14592","devicethat",1,0,0,0,1
"14593","devilish",0,1,0,0,1
"14594","devils",0,0,1,0,1
"14595","devisingsome",1,0,0,0,1
"14596","devolved",1,0,0,0,1
"14597","devotedtheir",1,0,0,0,1
"14598","devotedto",1,0,0,0,1
"14599","dew",0,1,0,0,1
"14600","dial",1,0,0,0,1
"14601","dialect",0,1,0,0,1
"14602","dialoguebetween",1,0,0,0,1
"14603","dialogues",0,1,0,0,1
"14604","dialoguewith",1,0,0,0,1
"14605","diametre",0,0,0,1,1
"14606","dick",0,0,1,0,1
"14607","dickens’s",0,1,0,0,1
"14608","dickinson",1,0,0,0,1
"14609","dictation",1,0,0,0,1
"14610","diction",1,0,0,0,1
"14611","diddaniel",1,0,0,0,1
"14612","didmuch",1,0,0,0,1
"14613","didn’t",0,0,1,0,1
"14614","didwhen",1,0,0,0,1
"14615","die.no",1,0,0,0,1
"14616","diedwhen",1,0,0,0,1
"14617","dielike",1,0,0,0,1
"14618","differenced",0,1,0,0,1
"14619","differenthandicraftsmen",1,0,0,0,1
"14620","differentindividuals",1,0,0,0,1
"14621","differentlooking",1,0,0,0,1
"14622","differentthing",1,0,0,0,1
"14623","differs",0,1,0,0,1
"14624","difficulttask",1,0,0,0,1
"14625","difficultyagainst",1,0,0,0,1
"14626","difficultythat",1,0,0,0,1
"14627","diffidence",0,0,1,0,1
"14628","diffident",0,1,0,0,1
"14629","diffidently",0,1,0,0,1
"14630","diffuse",1,0,0,0,1
"14631","diffusing",0,1,0,0,1
"14632","dignitary",1,0,0,0,1
"14633","dignitaryfurther",1,0,0,0,1
"14634","dignityof",1,0,0,0,1
"14635","digression",1,0,0,0,1
"14636","dilapidation",0,1,0,0,1
"14637","dilapidationof",1,0,0,0,1
"14638","diligentlyperusing",1,0,0,0,1
"14639","dime",1,0,0,0,1
"14640","dimhopes",1,0,0,0,1
"14641","diminish",1,0,0,0,1
"14642","dimly",0,1,0,0,1
"14643","dingy",1,0,0,0,1
"14644","diningroom",1,0,0,0,1
"14645","dinnerbell",1,0,0,0,1
"14646","dinners.in",1,0,0,0,1
"14647","diploma",0,1,0,0,1
"14648","diplomat",1,0,0,0,1
"14649","diplomatic",1,0,0,0,1
"14650","dire",0,1,0,0,1
"14651","direction.she",1,0,0,0,1
"14652","direction.they",1,0,0,0,1
"14653","directionindicated",1,0,0,0,1
"14654","directlyto",1,0,0,0,1
"14655","direeffects",1,0,0,0,1
"14656","direful",0,0,1,0,1
"14657","disabled",1,0,0,0,1
"14658","disagreement",1,0,0,0,1
"14659","disappearing",0,1,0,0,1
"14660","disappointedto",1,0,0,0,1
"14661","disappointment.i",1,0,0,0,1
"14662","disappointment.the",1,0,0,0,1
"14663","disarmed",1,0,0,0,1
"14664","disarmingthe",1,0,0,0,1
"14665","disarms",1,0,0,0,1
"14666","disastrous",0,0,1,0,1
"14667","disbandment",1,0,0,0,1
"14668","discards",1,0,0,0,1
"14669","discern",1,0,0,0,1
"14670","discharging",0,1,0,0,1
"14671","disclaim",1,0,0,0,1
"14672","disclosed",0,0,1,0,1
"14673","discloses",1,0,0,0,1
"14674","disclosure",1,0,0,0,1
"14675","disclosures",0,1,0,0,1
"14676","discomfiture",1,0,0,0,1
"14677","disconcerted",1,0,0,0,1
"14678","discontened",0,1,0,0,1
"14679","discontentment",0,0,1,0,1
"14680","discontinued",1,0,0,0,1
"14681","discordant",0,0,1,0,1
"14682","discount",1,0,0,0,1
"14683","discouragement",1,0,0,0,1
"14684","discouragements",0,1,0,0,1
"14685","discouragingly",1,0,0,0,1
"14686","discoursewas",1,0,0,0,1
"14687","discoursewithout",1,0,0,0,1
"14688","discoveredmy",1,0,0,0,1
"14689","discoveredor",1,0,0,0,1
"14690","discoveredtoo",1,0,0,0,1
"14691","discredit",0,0,1,0,1
"14692","discreditable",0,1,0,0,1
"14693","discredited",1,0,0,0,1
"14694","discreet",1,0,0,0,1
"14695","discreetand",1,0,0,0,1
"14696","discrepancy",1,0,0,0,1
"14697","discriminated",1,0,0,0,1
"14698","discriminately",0,1,0,0,1
"14699","discrimination",0,1,0,0,1
"14700","discriminations",1,0,0,0,1
"14701","discription",0,0,0,1,1
"14702","discriptions",0,0,0,1,1
"14703","discussion.i",1,0,0,0,1
"14704","discussions",1,0,0,0,1
"14705","discussto",1,0,0,0,1
"14706","disdained",1,0,0,0,1
"14707","disdainful",0,1,0,0,1
"14708","diseased",1,0,0,0,1
"14709","disentangled",0,0,1,0,1
"14710","disenthralled",0,1,0,0,1
"14711","disenthrallment",0,1,0,0,1
"14712","disfavor",1,0,0,0,1
"14713","disfranchise",1,0,0,0,1
"14714","disgraceful.the",1,0,0,0,1
"14715","disgust.on",1,0,0,0,1
"14716","disgusted.of",1,0,0,0,1
"14717","disgustingand",1,0,0,0,1
"14718","disheveled",0,1,0,0,1
"14719","dishonest",1,0,0,0,1
"14720","dishonorable",1,0,0,0,1
"14721","dishonorablein",1,0,0,0,1
"14722","disinterestedly",1,0,0,0,1
"14723","disinterment",0,1,0,0,1
"14724","disinterred",1,0,0,0,1
"14725","disliked",1,0,0,0,1
"14726","disloyalrebel",1,0,0,0,1
"14727","dismember",1,0,0,0,1
"14728","dismemberedand",1,0,0,0,1
"14729","dismounting",0,0,1,0,1
"14730","disobey",0,0,1,0,1
"14731","disowned",0,1,0,0,1
"14732","disowns",0,1,0,0,1
"14733","disparaged",1,0,0,0,1
"14734","disparity",0,1,0,0,1
"14735","dispatch",1,0,0,0,1
"14736","dispatchedpassengers",1,0,0,0,1
"14737","dispelledby",1,0,0,0,1
"14738","disposal",0,0,1,0,1
"14739","disposedof",1,0,0,0,1
"14740","disposes",0,1,0,0,1
"14741","dispositions",0,0,1,0,1
"14742","dispossess",1,0,0,0,1
"14743","disproportionate",1,0,0,0,1
"14744","disproving",1,0,0,0,1
"14745","disputed.i",1,0,0,0,1
"14746","disputes",0,0,1,0,1
"14747","disputingeither",1,0,0,0,1
"14748","disqualification",1,0,0,0,1
"14749","disqualified",1,0,0,0,1
"14750","disquietwith",1,0,0,0,1
"14751","disrelish",0,1,0,0,1
"14752","disruption",1,0,0,0,1
"14753","dissented",0,1,0,0,1
"14754","dissenters",0,1,0,0,1
"14755","dissuade",1,0,0,0,1
"14756","dissuaded",1,0,0,0,1
"14757","dissuading",1,0,0,0,1
"14758","dissuadings",0,1,0,0,1
"14759","distancefrom",1,0,0,0,1
"14760","distanceof",1,0,0,0,1
"14761","distanceto",1,0,0,0,1
"14762","distasteful",1,0,0,0,1
"14763","distinct.as",1,0,0,0,1
"14764","distinctionbetween",1,0,0,0,1
"14765","distinctive",1,0,0,0,1
"14766","distinctlyremember",1,0,0,0,1
"14767","distinctlysee",1,0,0,0,1
"14768","distinctness",0,1,0,0,1
"14769","distinguishbetween",1,0,0,0,1
"14770","distinguisheddemocrat",1,0,0,0,1
"14771","distinguishedme",1,0,0,0,1
"14772","distinguishedpersons",1,0,0,0,1
"14773","distorted",1,0,0,0,1
"14774","distracted",1,0,0,0,1
"14775","distressedme",1,0,0,0,1
"14776","distressingly",1,0,0,0,1
"14777","distressingrevelation",1,0,0,0,1
"14778","distributed",1,0,0,0,1
"14779","distribution",1,0,0,0,1
"14780","districtconstituted",1,0,0,0,1
"14781","districtof",1,0,0,0,1
"14782","districtsof",1,0,0,0,1
"14783","distroyed",0,0,0,1,1
"14784","distructive",0,0,0,1,1
"14785","distrust",0,0,1,0,1
"14786","disunionby",1,0,0,0,1
"14787","disunited",1,0,0,0,1
"14788","ditches",0,1,0,0,1
"14789","ditchesand",1,0,0,0,1
"14790","ditto",1,0,0,0,1
"14791","diun",0,0,0,1,1
"14792","diverged",0,1,0,0,1
"14793","divert",0,1,0,0,1
"14794","diverted",0,1,0,0,1
"14795","diverting",0,1,0,0,1
"14796","divesting",1,0,0,0,1
"14797","dividedwith",1,0,0,0,1
"14798","dividers",1,0,0,0,1
"14799","divination",0,1,0,0,1
"14800","divineinterference",1,0,0,0,1
"14801","diving",0,0,0,1,1
"14802","divinity_",0,1,0,0,1
"14803","divisionof",1,0,0,0,1
"14804","dling",0,0,0,1,1
"14805","do.hunger",1,0,0,0,1
"14806","do.mr",1,0,0,0,1
"14807","do.my",1,0,0,0,1
"14808","do.this",1,0,0,0,1
"14809","doctorgodwin",1,0,0,0,1
"14810","doctorschalmers",1,0,0,0,1
"14811","doctorwayland",1,0,0,0,1
"14812","doctrinewould",1,0,0,0,1
"14813","dodge",1,0,0,0,1
"14814","dodos",0,1,0,0,1
"14815","dodson",0,0,1,0,1
"14816","doer",0,1,0,0,1
"14817","doeth",0,0,1,0,1
"14818","doges",0,0,0,1,1
"14819","doggeddetermination",1,0,0,0,1
"14820","dogsand",1,0,0,0,1
"14821","dohonor",1,0,0,0,1
"14822","doin",1,0,0,0,1
"14823","doingit",1,0,0,0,1
"14824","doings",0,1,0,0,1
"14825","doingso",1,0,0,0,1
"14826","dolars",0,1,0,0,1
"14827","doleful",0,1,0,0,1
"14828","doll",0,0,1,0,1
"14829","domeof",1,0,0,0,1
"14830","domes",1,0,0,0,1
"14831","dominant",0,1,0,0,1
"14832","domingowanted",1,0,0,0,1
"14833","domy",1,0,0,0,1
"14834","dona",0,0,1,0,1
"14835","donations",0,1,0,0,1
"14836","done.captain",1,0,0,0,1
"14837","donea",1,0,0,0,1
"14838","donefor",1,0,0,0,1
"14839","doneits",1,0,0,0,1
"14840","donetowards",1,0,0,0,1
"14841","donkees",0,0,0,1,1
"14842","donkey",0,0,0,1,1
"14843","donothing",1,0,0,0,1
"14844","dooms",0,1,0,0,1
"14845","doorsof",1,0,0,0,1
"14846","dora",0,0,0,1,1
"14847","dormant",0,1,0,0,1
"14848","dorrites",1,0,0,0,1
"14849","dorrwas",1,0,0,0,1
"14850","dosomething",1,0,0,0,1
"14851","dost",0,1,0,0,1
"14852","dot",0,0,0,1,1
"14853","dothey",1,0,0,0,1
"14854","doublydisappointed",1,0,0,0,1
"14855","doubtindulged",1,0,0,0,1
"14856","doubtlesscost",1,0,0,0,1
"14857","doubtspend",1,0,0,0,1
"14858","doubtthat",1,0,0,0,1
"14859","dough",0,1,0,0,1
"14860","douglas.chapter",1,0,0,0,1
"14861","douglaswas",1,0,0,0,1
"14862","doutful",0,0,0,1,1
"14863","dowas",1,0,0,0,1
"14864","dowe",1,0,0,0,1
"14865","down.the",1,0,0,0,1
"14866","downamong",1,0,0,0,1
"14867","downhere",1,0,0,0,1
"14868","downhis",1,0,0,0,1
"14869","downin",1,0,0,0,1
"14870","downknelt",1,0,0,0,1
"14871","downthe",1,0,0,0,1
"14872","downto",1,0,0,0,1
"14873","downtrodden",0,1,0,0,1
"14874","downunion",1,0,0,0,1
"14875","dozens",0,1,0,0,1
"14876","dozer’s",1,0,0,0,1
"14877","drafts",1,0,0,0,1
"14878","drained",0,0,1,0,1
"14879","dram",0,0,1,0,1
"14880","dramas",1,0,0,0,1
"14881","dramatized",1,0,0,0,1
"14882","drank",0,1,0,0,1
"14883","drawbacks",1,0,0,0,1
"14884","drawer",1,0,0,0,1
"14885","drawers",1,0,0,0,1
"14886","drawings",1,0,0,0,1
"14887","dreadfulsounds",1,0,0,0,1
"14888","dreadfulthing",1,0,0,0,1
"14889","dreading",0,0,0,1,1
"14890","dreadof",1,0,0,0,1
"14891","dreads",1,0,0,0,1
"14892","dream.my",1,0,0,0,1
"14893","dreamedof",1,0,0,0,1
"14894","drear",0,1,0,0,1
"14895","dreary",1,0,0,0,1
"14896","drearyspaces",1,0,0,0,1
"14897","dressedyoung",1,0,0,0,1
"14898","dresses",0,0,0,1,1
"14899","drewall",1,0,0,0,1
"14900","drift",1,0,0,0,1
"14901","drill",0,1,0,0,1
"14902","drilled",1,0,0,0,1
"14903","drills",1,0,0,0,1
"14904","drinkthe",1,0,0,0,1
"14905","drip",0,0,1,0,1
"14906","drizzling",1,0,0,0,1
"14907","dropof",1,0,0,0,1
"14908","dropping",0,1,0,0,1
"14909","droves",0,1,0,0,1
"14910","drown",0,0,1,0,1
"14911","drowning",1,0,0,0,1
"14912","drugs",1,0,0,0,1
"14913","drunk.in",1,0,0,0,1
"14914","drunkthe",1,0,0,0,1
"14915","duck’s",0,1,0,0,1
"14916","duedeliberation",1,0,0,0,1
"14917","dueform",1,0,0,0,1
"14918","duelist",1,0,0,0,1
"14919","duffys",1,0,0,0,1
"14920","dugout",1,0,0,0,1
"14921","dulyelected",1,0,0,0,1
"14922","dumb.bull",1,0,0,0,1
"14923","dungeons",0,0,0,1,1
"14924","duomo",0,0,0,1,1
"14925","duringall",1,0,0,0,1
"14926","duringits",1,0,0,0,1
"14927","duringthat",1,0,0,0,1
"14928","duringwhich",1,0,0,0,1
"14929","dustthere",1,0,0,0,1
"14930","dutch",1,0,0,0,1
"14931","dutiesas",1,0,0,0,1
"14932","dutyand",1,0,0,0,1
"14933","dwellupon",1,0,0,0,1
"14934","dyer",1,0,0,0,1
"14935","dyingin",1,0,0,0,1
"14936","dynasty",0,1,0,0,1
"14937","e.dickinson",1,0,0,0,1
"14938","eaarth",0,0,0,1,1
"14939","eachmonth",1,0,0,0,1
"14940","eachother’s",1,0,0,0,1
"14941","eachslave",1,0,0,0,1
"14942","eagles",1,0,0,0,1
"14943","eale",0,0,0,1,1
"14944","earilier",0,1,0,0,1
"14945","earle",1,0,0,0,1
"14946","earles",1,0,0,0,1
"14947","early",0,0,0,1,1
"14948","earlyworkers",1,0,0,0,1
"14949","earnestlyendeavoring",1,0,0,0,1
"14950","earnestlytaking",1,0,0,0,1
"14951","earnestsolicitude",1,0,0,0,1
"14952","earsand",1,0,0,0,1
"14953","earsattent",1,0,0,0,1
"14954","earth_",0,1,0,0,1
"14955","earth.but",1,0,0,0,1
"14956","earth’s",1,0,0,0,1
"14957","earthquake.it",1,0,0,0,1
"14958","earthquakes",0,1,0,0,1
"14959","easely",0,0,0,1,1
"14960","easethey",1,0,0,0,1
"14961","easiertriumph",1,0,0,0,1
"14962","easilybe",1,0,0,0,1
"14963","easilybelieved",1,0,0,0,1
"14964","easilydefend",1,0,0,0,1
"14965","easilyretaliate",1,0,0,0,1
"14966","easilystrengthen",1,0,0,0,1
"14967","easterholidays",1,0,0,0,1
"14968","easternshore",1,0,0,0,1
"14969","eastonfor",1,0,0,0,1
"14970","eastside",0,0,0,1,1
"14971","eastward",1,0,0,0,1
"14972","easymatter",1,0,0,0,1
"14973","eather",1,0,0,0,1
"14974","eatit",1,0,0,0,1
"14975","eaves",1,0,0,0,1
"14976","ebenezer",1,0,0,0,1
"14977","ebony",0,1,0,0,1
"14978","ecclesiastics",0,1,0,0,1
"14979","echoed",1,0,0,0,1
"14980","economymay",1,0,0,0,1
"14981","ecstasy",0,0,1,0,1
"14982","ed",1,0,0,0,1
"14983","eden",0,1,0,0,1
"14984","edifice",0,0,0,1,1
"14985","edified",1,0,0,0,1
"14986","editing",0,1,0,0,1
"14987","editor.he",1,0,0,0,1
"14988","editor.my",1,0,0,0,1
"14989","editorialsand",1,0,0,0,1
"14990","editorof",1,0,0,0,1
"14991","edmonia",0,0,0,1,1
"14992","edmunson",0,1,0,0,1
"14993","edna",0,0,0,1,1
"14994","educatedlike",1,0,0,0,1
"14995","educatetheir",1,0,0,0,1
"14996","education.everywhere",1,0,0,0,1
"14997","educationalinstitution",1,0,0,0,1
"14998","educationalinstitutions",1,0,0,0,1
"14999","edward’s",0,1,0,0,1
"15000","effected.their",1,0,0,0,1
"15001","effecting",1,0,0,0,1
"15002","effectivehelper",1,0,0,0,1
"15003","effectively",1,0,0,0,1
"15004","effectivewith",1,0,0,0,1
"15005","effectually",1,0,0,0,1
"15006","effectuallyand",1,0,0,0,1
"15007","efficacious",0,1,0,0,1
"15008","efficacious.the",1,0,0,0,1
"15009","effortsof",1,0,0,0,1
"15010","effortsto",1,0,0,0,1
"15011","effortwithin",1,0,0,0,1
"15012","effusionof",1,0,0,0,1
"15013","egg",0,1,0,0,1
"15014","eggplants",1,0,0,0,1
"15015","eggs",1,0,0,0,1
"15016","eggs.and",1,0,0,0,1
"15017","egpt",0,0,0,1,1
"15018","egregious",0,1,0,0,1
"15019","egress",1,0,0,0,1
"15020","egypt’s",1,0,0,0,1
"15021","eighthundred",1,0,0,0,1
"15022","eightmonths",1,0,0,0,1
"15023","eitherhis",1,0,0,0,1
"15024","eitherwith",1,0,0,0,1
"15025","eject",1,0,0,0,1
"15026","elba",1,0,0,0,1
"15027","eldredge",1,0,0,0,1
"15028","eldredges",1,0,0,0,1
"15029","eldridge",1,0,0,0,1
"15030","electioneeringappliances",1,0,0,0,1
"15031","elections",1,0,0,0,1
"15032","electronic",0,0,1,0,1
"15033","elegantlyfurnished",1,0,0,0,1
"15034","elegantwhite",1,0,0,0,1
"15035","elementon",1,0,0,0,1
"15036","elevation.i",1,0,0,0,1
"15037","elias",1,0,0,0,1
"15038","elicited",0,1,0,0,1
"15039","eliciteddue",1,0,0,0,1
"15040","elijah",1,0,0,0,1
"15041","élite",1,0,0,0,1
"15042","elleson",0,0,0,1,1
"15043","ellis",1,0,0,0,1
"15044","elmira",1,0,0,0,1
"15045","elmiraporter",1,0,0,0,1
"15046","elms",1,0,0,0,1
"15047","eloquencecame",1,0,0,0,1
"15048","elsethan",1,0,0,0,1
"15049","elsewhere.i",1,0,0,0,1
"15050","elsewherecan",1,0,0,0,1
"15051","elucidation",0,1,0,0,1
"15052","elude",1,0,0,0,1
"15053","eludepursuit",1,0,0,0,1
"15054","eluding",0,1,0,0,1
"15055","emaculate",0,0,0,1,1
"15056","emanated",1,0,0,0,1
"15057","emancipatedtheir",1,0,0,0,1
"15058","emancipatehis",1,0,0,0,1
"15059","emancipating",0,1,0,0,1
"15060","emancipation.extract",1,0,0,0,1
"15061","emancipation.it",1,0,0,0,1
"15062","emancipation.men",1,0,0,0,1
"15063","emancipation.this",1,0,0,0,1
"15064","emancipation.whether",1,0,0,0,1
"15065","emancipationof",1,0,0,0,1
"15066","emancipationthat",1,0,0,0,1
"15067","emancipator",1,0,0,0,1
"15068","emancipatorfor",1,0,0,0,1
"15069","embarrassing",0,0,1,0,1
"15070","embattled",0,1,0,0,1
"15071","emblem",0,1,0,0,1
"15072","emblems",1,0,0,0,1
"15073","embody",0,1,0,0,1
"15074","emboldened",1,0,0,0,1
"15075","embruted",0,1,0,0,1
"15076","embryo",0,1,0,0,1
"15077","emenent",0,0,0,1,1
"15078","emergencies",1,0,0,0,1
"15079","emergency.in",1,0,0,0,1
"15080","emerison",0,0,0,1,1
"15081","emerson",1,0,0,0,1
"15082","emerson’s",1,0,0,0,1
"15083","emigrant",1,0,0,0,1
"15084","emily",0,1,0,0,1
"15085","eminentdivines",1,0,0,0,1
"15086","emoluments.to",1,0,0,0,1
"15087","emotion.on",1,0,0,0,1
"15088","emperor",1,0,0,0,1
"15089","emperors",0,0,0,1,1
"15090","empires",0,0,0,1,1
"15091","employees",1,0,0,0,1
"15092","employers",0,1,0,0,1
"15093","employing",0,1,0,0,1
"15094","employingcolored",1,0,0,0,1
"15095","employingnegroes",1,0,0,0,1
"15096","employmentsand",1,0,0,0,1
"15097","employs",0,1,0,0,1
"15098","emptied",1,0,0,0,1
"15099","emptiness",1,0,0,0,1
"15100","emulate",0,1,0,0,1
"15101","enabledme",1,0,0,0,1
"15102","enact",1,0,0,0,1
"15103","enchained",1,0,0,0,1
"15104","enclosed",0,0,1,0,1
"15105","enclosurewere",1,0,0,0,1
"15106","encompassed",1,0,0,0,1
"15107","encounteredelsewhere",1,0,0,0,1
"15108","encounterthe",1,0,0,0,1
"15109","encroach",1,0,0,0,1
"15110","encumbrance",0,1,0,0,1
"15111","endangers",0,1,0,0,1
"15112","endbe",1,0,0,0,1
"15113","endearments",0,1,0,0,1
"15114","ended.i",1,0,0,0,1
"15115","endedthe",1,0,0,0,1
"15116","endhere",1,0,0,0,1
"15117","ending",0,0,0,1,1
"15118","endof",1,0,0,0,1
"15119","endorsed",0,1,0,0,1
"15120","endswell",1,0,0,0,1
"15121","endthrough",1,0,0,0,1
"15122","endurable",1,0,0,0,1
"15123","enduredall",1,0,0,0,1
"15124","endureforever",1,0,0,0,1
"15125","enduremy",1,0,0,0,1
"15126","endures",0,1,0,0,1
"15127","enduringmarble",1,0,0,0,1
"15128","enemies.the",1,0,0,0,1
"15129","enemieshave",1,0,0,0,1
"15130","enemyat",1,0,0,0,1
"15131","enemyshould",1,0,0,0,1
"15132","enemysome",1,0,0,0,1
"15133","energiesfrom",1,0,0,0,1
"15134","enervates",0,1,0,0,1
"15135","enforced.the",1,0,0,0,1
"15136","enforcements",1,0,0,0,1
"15137","enforces",0,1,0,0,1
"15138","enforcing",0,1,0,0,1
"15139","enfranchise",1,0,0,0,1
"15140","enfranchised",1,0,0,0,1
"15141","enfranchised.in",1,0,0,0,1
"15142","enfranchisedclass",1,0,0,0,1
"15143","enfranchisedpeople",1,0,0,0,1
"15144","enfranchisementof",1,0,0,0,1
"15145","enfranchising",1,0,0,0,1
"15146","engagedin",1,0,0,0,1
"15147","engaging",0,1,0,0,1
"15148","engine",1,0,0,0,1
"15149","engine.i",1,0,0,0,1
"15150","england.but",1,0,0,0,1
"15151","england.in",1,0,0,0,1
"15152","englandas",1,0,0,0,1
"15153","englandfull",1,0,0,0,1
"15154","englandindividual",1,0,0,0,1
"15155","englandmould",1,0,0,0,1
"15156","englands",1,0,0,0,1
"15157","englead",0,0,0,1,1
"15158","englieries",0,0,0,1,1
"15159","englishman’s",0,1,0,0,1
"15160","enjoying",0,0,1,0,1
"15161","enjoyments",0,1,0,0,1
"15162","enlarge",1,0,0,0,1
"15163","enlarged",1,0,0,0,1
"15164","enlargedwith",1,0,0,0,1
"15165","enlargethe",1,0,0,0,1
"15166","enlightenedcolored",1,0,0,0,1
"15167","enlightenedmy",1,0,0,0,1
"15168","enlightenedprotestants",1,0,0,0,1
"15169","enlightenme",1,0,0,0,1
"15170","enlistedhim",1,0,0,0,1
"15171","enlistment",1,0,0,0,1
"15172","enlivening",0,1,0,0,1
"15173","ennoble",1,0,0,0,1
"15174","enormousanimals",1,0,0,0,1
"15175","enoughbe",1,0,0,0,1
"15176","enoughin",1,0,0,0,1
"15177","enoughto",1,0,0,0,1
"15178","enslaved.in",1,0,0,0,1
"15179","enslavedand",1,0,0,0,1
"15180","enslavers.we",1,0,0,0,1
"15181","ensue",1,0,0,0,1
"15182","ensued",1,0,0,0,1
"15183","ensure",0,1,0,0,1
"15184","entangling",0,1,0,0,1
"15185","entanglingthemselves",1,0,0,0,1
"15186","enterance",0,0,0,1,1
"15187","enteredinto",1,0,0,0,1
"15188","enterprisehe",1,0,0,0,1
"15189","enterprizing",0,0,0,1,1
"15190","entertained.brought",1,0,0,0,1
"15191","entertaineda",1,0,0,0,1
"15192","entertainments.viewed",1,0,0,0,1
"15193","entertains",0,0,1,0,1
"15194","enterthe",1,0,0,0,1
"15195","enthralled",0,1,0,0,1
"15196","enthusiasmhad",1,0,0,0,1
"15197","enthusiasmthat",1,0,0,0,1
"15198","enthusiasticspirit",1,0,0,0,1
"15199","entilted",0,0,0,1,1
"15200","entirehistory",1,0,0,0,1
"15201","entirelymistaken",1,0,0,0,1
"15202","entireoccupation",1,0,0,0,1
"15203","entireweek",1,0,0,0,1
"15204","entitles",0,1,0,0,1
"15205","entitling",0,1,0,0,1
"15206","entombed",0,1,0,0,1
"15207","entombedat",1,0,0,0,1
"15208","entombs",0,0,1,0,1
"15209","entrap",0,1,0,0,1
"15210","entreat",1,0,0,0,1
"15211","entreatedto",1,0,0,0,1
"15212","entreaty",0,0,1,0,1
"15213","entrusted",1,0,0,0,1
"15214","entwine",0,1,0,0,1
"15215","enumerating",0,1,0,0,1
"15216","enverous",0,0,0,1,1
"15217","environed",0,1,0,0,1
"15218","envy",0,1,0,0,1
"15219","ephemeral",1,0,0,0,1
"15220","ephesian",1,0,0,0,1
"15221","episcopacy",1,0,0,0,1
"15222","episcopalchurch.in",1,0,0,0,1
"15223","epitaph",1,0,0,0,1
"15224","epithet",1,0,0,0,1
"15225","epithetsof",1,0,0,0,1
"15226","epoch",0,0,1,0,1
"15227","equality.my",1,0,0,0,1
"15228","equallyapply",1,0,0,0,1
"15229","equalnon",1,0,0,0,1
"15230","equalsharpness",1,0,0,0,1
"15231","equipage",0,0,1,0,1
"15232","equipages",0,0,0,1,1
"15233","equipments",1,0,0,0,1
"15234","equitable",1,0,0,0,1
"15235","equivocate",0,1,0,0,1
"15236","era_",1,0,0,0,1
"15237","eradication",1,0,0,0,1
"15238","erecting",0,1,0,0,1
"15239","erection",0,1,0,0,1
"15240","errand",0,0,1,0,1
"15241","erring",1,0,0,0,1
"15242","erronious",0,0,0,1,1
"15243","escapedbeing",1,0,0,0,1
"15244","especiallyfor",1,0,0,0,1
"15245","especiallytrue",1,0,0,0,1
"15246","espousal",1,0,0,0,1
"15247","espousing",1,0,0,0,1
"15248","essayed",0,1,0,0,1
"15249","essentialto",1,0,0,0,1
"15250","essexcounty",1,0,0,0,1
"15251","establishedamong",1,0,0,0,1
"15252","establishment.i",1,0,0,0,1
"15253","establishments",0,0,1,0,1
"15254","estate.the",1,0,0,0,1
"15255","estates",1,0,0,0,1
"15256","esteemhim",1,0,0,0,1
"15257","estemate",0,0,0,1,1
"15258","esther’s",0,1,0,0,1
"15259","estheris",1,0,0,0,1
"15260","estimateof",1,0,0,0,1
"15261","estimating",1,0,0,0,1
"15262","estopped",1,0,0,0,1
"15263","estrangement",1,0,0,0,1
"15264","etc.the",1,0,0,0,1
"15265","eternally",0,1,0,0,1
"15266","ethical",0,1,0,0,1
"15267","ethics",1,0,0,0,1
"15268","ethiopia",0,1,0,0,1
"15269","ethiopian",0,1,0,0,1
"15270","ethnological",1,0,0,0,1
"15271","ethnologically",0,1,0,0,1
"15272","ethnologist",1,0,0,0,1
"15273","etiquette.it",1,0,0,0,1
"15274","eulogy",1,0,0,0,1
"15275","evanescent.it",1,0,0,0,1
"15276","evangel",0,1,0,0,1
"15277","evangelist",0,1,0,0,1
"15278","evasion",1,0,0,0,1
"15279","eve",1,0,0,0,1
"15280","evedently",0,0,0,1,1
"15281","evenbefore",1,0,0,0,1
"15282","evencommerce",1,0,0,0,1
"15283","evening.when",1,0,0,0,1
"15284","evenlamented",1,0,0,0,1
"15285","evenlybalanced",1,0,0,0,1
"15286","evenmr",1,0,0,0,1
"15287","event.after",1,0,0,0,1
"15288","event.when",1,0,0,0,1
"15289","eventender",1,0,0,0,1
"15290","eventful",1,0,0,0,1
"15291","eventhat",1,0,0,0,1
"15292","eventhere",1,0,0,0,1
"15293","ever.it",1,0,0,0,1
"15294","everbe",1,0,0,0,1
"15295","everbeen",1,0,0,0,1
"15296","everett",1,0,0,0,1
"15297","everforget",1,0,0,0,1
"15298","everfound",1,0,0,0,1
"15299","evering",0,0,0,1,1
"15300","everliving",1,0,0,0,1
"15301","evermade",1,0,0,0,1
"15302","evermet",1,0,0,0,1
"15303","everreported",1,0,0,0,1
"15304","everspoken",1,0,0,0,1
"15305","everto",1,0,0,0,1
"15306","everwitnessed",1,0,0,0,1
"15307","everyargument",1,0,0,0,1
"15308","everybody",0,0,0,1,1
"15309","everybody.this",1,0,0,0,1
"15310","everyboy",1,0,0,0,1
"15311","everycalm",1,0,0,0,1
"15312","everyday",0,1,0,0,1
"15313","everydoor",1,0,0,0,1
"15314","everyfeeling",1,0,0,0,1
"15315","everymember",1,0,0,0,1
"15316","everynerve",1,0,0,0,1
"15317","everynight",1,0,0,0,1
"15318","everyobject",1,0,0,0,1
"15319","everypossible",1,0,0,0,1
"15320","everyrebuke",1,0,0,0,1
"15321","everyservice",1,0,0,0,1
"15322","everystate",1,0,0,0,1
"15323","everystep",1,0,0,0,1
"15324","everyweek",1,0,0,0,1
"15325","everywherein",1,0,0,0,1
"15326","everywhereseemed",1,0,0,0,1
"15327","evidenceof",1,0,0,0,1
"15328","evidencesof",1,0,0,0,1
"15329","evidentlyconsidered",1,0,0,0,1
"15330","evidentlywas",1,0,0,0,1
"15331","evidentthat",1,0,0,0,1
"15332","evilsfrom",1,0,0,0,1
"15333","evincinggreat",1,0,0,0,1
"15334","ewery",0,0,1,0,1
"15335","exactness",1,0,0,0,1
"15336","exacts",0,1,0,0,1
"15337","exaggerate",0,1,0,0,1
"15338","exaggeration",0,0,1,0,1
"15339","exaltation",1,0,0,0,1
"15340","exaltedperson",1,0,0,0,1
"15341","exalteth",0,1,0,0,1
"15342","exalting",1,0,0,0,1
"15343","exalts",0,0,1,0,1
"15344","examining",1,0,0,0,1
"15345","example",0,0,0,1,1
"15346","example.bishop",1,0,0,0,1
"15347","example.it",1,0,0,0,1
"15348","example.liberty",1,0,0,0,1
"15349","example’s",0,1,0,0,1
"15350","exampleof",1,0,0,0,1
"15351","examples",0,1,0,0,1
"15352","exasperating",0,1,0,0,1
"15353","exasperation",1,0,0,0,1
"15354","exceededmy",1,0,0,0,1
"15355","exceedinglyangry",1,0,0,0,1
"15356","exceeds",1,0,0,0,1
"15357","excellence_",0,1,0,0,1
"15358","excellentpreservation",1,0,0,0,1
"15359","excellentquality.to",1,0,0,0,1
"15360","excels",0,0,1,0,1
"15361","excepting",0,0,1,0,1
"15362","exceptionable",1,0,0,0,1
"15363","exceptionallypoor",1,0,0,0,1
"15364","excersion",0,0,0,1,1
"15365","exchangedbetween",1,0,0,0,1
"15366","excitedhim",1,0,0,0,1
"15367","excitedmaster",1,0,0,0,1
"15368","exclamationon",1,0,0,0,1
"15369","excludedto",1,0,0,0,1
"15370","excluding",1,0,0,0,1
"15371","exclusionof",1,0,0,0,1
"15372","exclusive",0,1,0,0,1
"15373","excoriated",0,1,0,0,1
"15374","excruciating",0,1,0,0,1
"15375","excused.besides",1,0,0,0,1
"15376","execration",0,1,0,0,1
"15377","executed.his",1,0,0,0,1
"15378","executed.on",1,0,0,0,1
"15379","executetheir",1,0,0,0,1
"15380","executethis",1,0,0,0,1
"15381","executing",0,1,0,0,1
"15382","executioncontemplated",1,0,0,0,1
"15383","exemplars",0,1,0,0,1
"15384","exemplify",0,1,0,0,1
"15385","exercisea",1,0,0,0,1
"15386","exercisedto",1,0,0,0,1
"15387","exercising",0,1,0,0,1
"15388","exertion.proposing",1,0,0,0,1
"15389","exertionof",1,0,0,0,1
"15390","exertionsthe",1,0,0,0,1
"15391","exerts",0,1,0,0,1
"15392","exhaust",0,1,0,0,1
"15393","exhausting",0,1,0,0,1
"15394","exhibitedbefore",1,0,0,0,1
"15395","exhibitedby",1,0,0,0,1
"15396","exhibitions",1,0,0,0,1
"15397","exhort.before",1,0,0,0,1
"15398","exhortation",0,1,0,0,1
"15399","exhortationand",1,0,0,0,1
"15400","exhorter.his",1,0,0,0,1
"15401","exhorting",0,1,0,0,1
"15402","exist.it",1,0,0,0,1
"15403","existedin",1,0,0,0,1
"15404","exorcised",1,0,0,0,1
"15405","expectations.while",1,0,0,0,1
"15406","expectedat",1,0,0,0,1
"15407","expectedof",1,0,0,0,1
"15408","expectingopposition",1,0,0,0,1
"15409","expediency",1,0,0,0,1
"15410","expedition",1,0,0,0,1
"15411","expenditures",1,0,0,0,1
"15412","experience.my",1,0,0,0,1
"15413","experience.when",1,0,0,0,1
"15414","experienceawaited",1,0,0,0,1
"15415","experienced.about",1,0,0,0,1
"15416","experiencedsuch",1,0,0,0,1
"15417","experiencein",1,0,0,0,1
"15418","expiration",0,0,1,0,1
"15419","expiring",0,0,1,0,1
"15420","explainedonly",1,0,0,0,1
"15421","explains",1,0,0,0,1
"15422","explainthe",1,0,0,0,1
"15423","explanationof",1,0,0,0,1
"15424","explanatoryletter",1,0,0,0,1
"15425","explicit",0,1,0,0,1
"15426","exploit",0,1,0,0,1
"15427","exploitsin",1,0,0,0,1
"15428","explosive",0,1,0,0,1
"15429","explosiveelements",1,0,0,0,1
"15430","exposedhimself",1,0,0,0,1
"15431","exposes",0,1,0,0,1
"15432","exposition ",0,0,0,1,1
"15433","expostulation",0,0,1,0,1
"15434","exposure.the",1,0,0,0,1
"15435","exposureof",1,0,0,0,1
"15436","expounder",1,0,0,0,1
"15437","expressedher",1,0,0,0,1
"15438","expressedhis",1,0,0,0,1
"15439","expressedthe",1,0,0,0,1
"15440","expresses",1,0,0,0,1
"15441","expression.great",1,0,0,0,1
"15442","expression.one",1,0,0,0,1
"15443","expressit",1,0,0,0,1
"15444","expressthe",1,0,0,0,1
"15445","expulsion",1,0,0,0,1
"15446","extemporaneous",0,1,0,0,1
"15447","extemporaneously",1,0,0,0,1
"15448","extemporized",1,0,0,0,1
"15449","extendor",1,0,0,0,1
"15450","extensionof",1,0,0,0,1
"15451","extensively",1,0,0,0,1
"15452","extensivelyover",1,0,0,0,1
"15453","extentwhich",1,0,0,0,1
"15454","exterminated",0,1,0,0,1
"15455","externally",1,0,0,0,1
"15456","extirpate",0,1,0,0,1
"15457","extirpation",0,1,0,0,1
"15458","extort",1,0,0,0,1
"15459","extortion",0,0,1,0,1
"15460","extraordinaryexertion",1,0,0,0,1
"15461","extravagantly",1,0,0,0,1
"15462","extremedizziness",1,0,0,0,1
"15463","extremestneed",1,0,0,0,1
"15464","exult",0,1,0,0,1
"15465","exulting",1,0,0,0,1
"15466","eyedand",1,0,0,0,1
"15467","eyesenriched",1,0,0,0,1
"15468","eyesresounded",1,0,0,0,1
"15469","eyeswere",1,0,0,0,1
"15470","fable",0,0,1,0,1
"15471","fabrics",0,0,0,1,1
"15472","facad",0,0,0,1,1
"15473","facade",0,0,0,1,1
"15474","face.unusual",1,0,0,0,1
"15475","facecovered",1,0,0,0,1
"15476","facehomeward",1,0,0,0,1
"15477","facemoved",1,0,0,0,1
"15478","faces ",0,0,0,1,1
"15479","fact_",0,1,0,0,1
"15480","fact.in",1,0,0,0,1
"15481","factaccomplished",1,0,0,0,1
"15482","factand",1,0,0,0,1
"15483","factdemonstrating",1,0,0,0,1
"15484","factionof",1,0,0,0,1
"15485","factions",1,0,0,0,1
"15486","factor",1,0,0,0,1
"15487","factought",1,0,0,0,1
"15488","factsand",1,0,0,0,1
"15489","factsconnected",1,0,0,0,1
"15490","fading",1,0,0,0,1
"15491","failedat",1,0,0,0,1
"15492","failto",1,0,0,0,1
"15493","failure.in",1,0,0,0,1
"15494","fain",0,1,0,0,1
"15495","faintest",0,0,0,1,1
"15496","faintly",0,1,0,0,1
"15497","fairbanksand",1,0,0,0,1
"15498","fairest",0,0,1,0,1
"15499","fairestcomplexion",1,0,0,0,1
"15500","fairness",1,0,0,0,1
"15501","fairvote",1,0,0,0,1
"15502","fairway",1,0,0,0,1
"15503","fait",0,0,0,1,1
"15504","faith_",0,1,0,0,1
"15505","faithfulmember",1,0,0,0,1
"15506","faithin",1,0,0,0,1
"15507","fallby",1,0,0,0,1
"15508","falleninto",1,0,0,0,1
"15509","fallenon",1,0,0,0,1
"15510","fallinginto",1,0,0,0,1
"15511","fallof",1,0,0,0,1
"15512","fallthey",1,0,0,0,1
"15513","falter",1,0,0,0,1
"15514","faltered",0,1,0,0,1
"15515","fame.after",1,0,0,0,1
"15516","familiarized",0,1,0,0,1
"15517","familiarly",0,1,0,0,1
"15518","family_",0,1,0,0,1
"15519","familywill",1,0,0,0,1
"15520","famished",0,0,1,0,1
"15521","fan.i",1,0,0,0,1
"15522","fanatical",1,0,0,0,1
"15523","fanciful",1,0,0,0,1
"15524","fancy.no",1,0,0,0,1
"15525","fannedmy",1,0,0,0,1
"15526","fanny",0,0,0,1,1
"15527","fanueil",1,0,0,0,1
"15528","far_",0,1,0,0,1
"15529","farce",0,1,0,0,1
"15530","farexceeded",1,0,0,0,1
"15531","farfrom",1,0,0,0,1
"15532","farity",1,0,0,0,1
"15533","farmers",1,0,0,0,1
"15534","farmsin",1,0,0,0,1
"15535","farmwere",1,0,0,0,1
"15536","farour",1,0,0,0,1
"15537","farrier",0,1,0,0,1
"15538","farrieras",1,0,0,0,1
"15539","farsouth",1,0,0,0,1
"15540","fartherthan",1,0,0,0,1
"15541","fascinate",0,1,0,0,1
"15542","fascinatethe",1,0,0,0,1
"15543","fascinating",1,0,0,0,1
"15544","fascination",0,0,0,1,1
"15545","fashionableand",1,0,0,0,1
"15546","fastening",1,0,0,0,1
"15547","fastenupon",1,0,0,0,1
"15548","fastfriends",1,0,0,0,1
"15549","fastidious",1,0,0,0,1
"15550","fasting",0,0,1,0,1
"15551","fastnesses",1,0,0,0,1
"15552","fastupon",1,0,0,0,1
"15553","fatalto",1,0,0,0,1
"15554","father’skitchen",1,0,0,0,1
"15555","father’sproperty",1,0,0,0,1
"15556","father’ssecond",1,0,0,0,1
"15557","fathers.it",1,0,0,0,1
"15558","fathom",0,1,0,0,1
"15559","fatigued",1,0,0,0,1
"15560","fattening",1,0,0,0,1
"15561","fatting",0,1,0,0,1
"15562","favor_",0,1,0,0,1
"15563","favorablecircumstances",1,0,0,0,1
"15564","favorablecondition",1,0,0,0,1
"15565","favorablefor",1,0,0,0,1
"15566","favorshe",1,0,0,0,1
"15567","favour",0,0,0,1,1
"15568","favourable",0,0,0,1,1
"15569","fayerweathers",1,0,0,0,1
"15570","fealty",0,1,0,0,1
"15571","fear.but",1,0,0,0,1
"15572","fearedi",1,0,0,0,1
"15573","fearedit",1,0,0,0,1
"15574","fearedthey",1,0,0,0,1
"15575","fearof",1,0,0,0,1
"15576","fears.a",1,0,0,0,1
"15577","fearthat",1,0,0,0,1
"15578","feasting.nor",1,0,0,0,1
"15579","feasts",0,0,1,0,1
"15580","feats",0,1,0,0,1
"15581","featured",1,0,0,0,1
"15582","featuresof",1,0,0,0,1
"15583","febrymonday",0,0,0,1,1
"15584","federalgovernment",1,0,0,0,1
"15585","fee_",0,1,0,0,1
"15586","feebleexpression",1,0,0,0,1
"15587","feeling.i",1,0,0,0,1
"15588","feelingabout",1,0,0,0,1
"15589","feelingallied",1,0,0,0,1
"15590","feelingarising",1,0,0,0,1
"15591","feelinghe",1,0,0,0,1
"15592","feelingmingled",1,0,0,0,1
"15593","feelings.at",1,0,0,0,1
"15594","feelings.thoroughly",1,0,0,0,1
"15595","feelingsin",1,0,0,0,1
"15596","feelingthe",1,0,0,0,1
"15597","feelingwas",1,0,0,0,1
"15598","feelthat",1,0,0,0,1
"15599","feelvery",1,0,0,0,1
"15600","feigning",0,1,0,0,1
"15601","feigningsickness",1,0,0,0,1
"15602","feik",0,0,0,1,1
"15603","felicitous",0,0,1,0,1
"15604","fell’spoint",1,0,0,0,1
"15605","fellheavily",1,0,0,0,1
"15606","felling",1,0,0,0,1
"15607","fellowcitizens",1,0,0,0,1
"15608","fellowhad",1,0,0,0,1
"15609","fellowshiping",0,1,0,0,1
"15610","fellowshipping",0,0,1,0,1
"15611","fells",0,0,1,0,1
"15612","felt",0,0,0,1,1
"15613","feltcalled",1,0,0,0,1
"15614","feltglad",1,0,0,0,1
"15615","felther",1,0,0,0,1
"15616","feltin",1,0,0,0,1
"15617","feltmore",1,0,0,0,1
"15618","feltmyself",1,0,0,0,1
"15619","feltshould",1,0,0,0,1
"15620","feltthemselves",1,0,0,0,1
"15621","feltuncomfortable",1,0,0,0,1
"15622","fencecorner",1,0,0,0,1
"15623","fenced",0,1,0,0,1
"15624","fencein",1,0,0,0,1
"15625","fences.as",1,0,0,0,1
"15626","ferguson",0,1,0,0,1
"15627","ferret",0,1,0,0,1
"15628","ferreting",0,1,0,0,1
"15629","ferrettingout",1,0,0,0,1
"15630","ferrisburgh",1,0,0,0,1
"15631","ferryinsurrection",1,0,0,0,1
"15632","ferrywas",1,0,0,0,1
"15633","fertilizer",0,0,0,1,1
"15634","ferventpiety",1,0,0,0,1
"15635","fervid",1,0,0,0,1
"15636","fervor",0,1,0,0,1
"15637","fester",0,1,0,0,1
"15638","festivals",1,0,0,0,1
"15639","fetched",0,1,0,0,1
"15640","fetlocks",0,1,0,0,1
"15641","fetlockshad",1,0,0,0,1
"15642","fettering",0,0,1,0,1
"15643","feudal",0,0,0,1,1
"15644","feuds",1,0,0,0,1
"15645","fewcabmen",1,0,0,0,1
"15646","fewgrains",1,0,0,0,1
"15647","fewshort",1,0,0,0,1
"15648","fewthousand",1,0,0,0,1
"15649","fewwho",1,0,0,0,1
"15650","fezed",0,0,0,1,1
"15651","fiat",0,1,0,0,1
"15652","fibre",0,1,0,0,1
"15653","fiction",1,0,0,0,1
"15654","fictitious",0,1,0,0,1
"15655","field.the",1,0,0,0,1
"15656","fieldas",1,0,0,0,1
"15657","fieldbefore",1,0,0,0,1
"15658","fieldfor",1,0,0,0,1
"15659","fieldfrom",1,0,0,0,1
"15660","fiend.the",1,0,0,0,1
"15661","fiercely",0,1,0,0,1
"15662","fiercer",1,0,0,0,1
"15663","fiercest",1,0,0,0,1
"15664","fieryindignation",1,0,0,0,1
"15665","fifteenminutes",1,0,0,0,1
"15666","fifthly",1,0,0,0,1
"15667","fifths",1,0,0,0,1
"15668","fiftypounds",1,0,0,0,1
"15669","fiftyto",1,0,0,0,1
"15670","fightinghis",1,0,0,0,1
"15671","fightthe",1,0,0,0,1
"15672","figured",1,0,0,0,1
"15673","filial",0,1,0,0,1
"15674","filledme",1,0,0,0,1
"15675","filledother",1,0,0,0,1
"15676","fillibustering",1,0,0,0,1
"15677","fills",0,0,1,0,1
"15678","finallyabolished",1,0,0,0,1
"15679","findhis",1,0,0,0,1
"15680","findingthat",1,0,0,0,1
"15681","findit",1,0,0,0,1
"15682","finds",0,0,0,1,1
"15683","findsomething",1,0,0,0,1
"15684","fineand",1,0,0,0,1
"15685","finefellow",1,0,0,0,1
"15686","finelyillustrated",1,0,0,0,1
"15687","finelyproportioned",1,0,0,0,1
"15688","finer",0,0,1,0,1
"15689","fining",0,1,0,0,1
"15690","finishedtheir",1,0,0,0,1
"15691","fip",1,0,0,0,1
"15692","fip’s",1,0,0,0,1
"15693","fipenny",1,0,0,0,1
"15694","firingupon",1,0,0,0,1
"15695","firmament",1,0,0,0,1
"15696","firmand",1,0,0,0,1
"15697","firmlytied",1,0,0,0,1
"15698","first_",1,0,0,0,1
"15699","firstdark",1,0,0,0,1
"15700","firsteight",1,0,0,0,1
"15701","firstexploit",1,0,0,0,1
"15702","firstfeeling",1,0,0,0,1
"15703","firstinterview",1,0,0,0,1
"15704","firstmeeting",1,0,0,0,1
"15705","firstmoment",1,0,0,0,1
"15706","firston",1,0,0,0,1
"15707","firststep",1,0,0,0,1
"15708","firststeps",1,0,0,0,1
"15709","firstsummer",1,0,0,0,1
"15710","firtile",0,0,0,1,1
"15711","firtility",0,0,0,1,1
"15712","fish.it",1,0,0,0,1
"15713","fisherman",0,0,0,1,1
"15714","fisherman’sluck",1,0,0,0,1
"15715","fishes",0,1,0,0,1
"15716","fishwomen",0,1,0,0,1
"15717","fitful",1,0,0,0,1
"15718","fits",0,1,0,0,1
"15719","five ",0,0,0,1,1
"15720","five_",1,0,0,0,1
"15721","fivecents_",1,0,0,0,1
"15722","fivedollars",1,0,0,0,1
"15723","fivehorses",1,0,0,0,1
"15724","fives",1,0,0,0,1
"15725","fivewell",1,0,0,0,1
"15726","fix",0,1,0,0,1
"15727","flagellation",0,0,1,0,1
"15728","flail",1,0,0,0,1
"15729","flaming",0,1,0,0,1
"15730","flancked",0,0,0,1,1
"15731","flareand",1,0,0,0,1
"15732","flashedthrough",1,0,0,0,1
"15733","flasks",1,0,0,0,1
"15734","flatter",0,1,0,0,1
"15735","flattered",1,0,0,0,1
"15736","fleeing",1,0,0,0,1
"15737","fleetenough",1,0,0,0,1
"15738","fleetest",0,1,0,0,1
"15739","flesh.this",1,0,0,0,1
"15740","fleshand",1,0,0,0,1
"15741","fleshis",1,0,0,0,1
"15742","flies",0,1,0,0,1
"15743","flight.master",1,0,0,0,1
"15744","flintiesthardships",1,0,0,0,1
"15745","flirts",0,0,1,0,1
"15746","flocks",0,1,0,0,1
"15747","floggable",0,1,0,0,1
"15748","floods",0,1,0,0,1
"15749","floors",0,1,0,0,1
"15750","floral",1,0,0,0,1
"15751","florida",0,1,0,0,1
"15752","flourishes",0,1,0,0,1
"15753","flourishesof",1,0,0,0,1
"15754","flows",0,1,0,0,1
"15755","floyd",1,0,0,0,1
"15756","flunkeys",0,1,0,0,1
"15757","flunkies",1,0,0,0,1
"15758","flyaround",1,0,0,0,1
"15759","fodder",0,0,1,0,1
"15760","foliage",1,0,0,0,1
"15761","foliage.the",1,0,0,0,1
"15762","folk",0,0,0,1,1
"15763","followed",0,0,0,1,1
"15764","followed.all",1,0,0,0,1
"15765","followedhis",1,0,0,0,1
"15766","follower",0,1,0,0,1
"15767","following",0,0,0,1,1
"15768","followingletter",1,0,0,0,1
"15769","followthem",1,0,0,0,1
"15770","fondlydo",1,0,0,0,1
"15771","foodwas",1,0,0,0,1
"15772","footof",1,0,0,0,1
"15773","for_him_",1,0,0,0,1
"15774","forall",1,0,0,0,1
"15775","forargument",1,0,0,0,1
"15776","foray",0,1,0,0,1
"15777","forbear",0,1,0,0,1
"15778","forby",1,0,0,0,1
"15779","forcamp",1,0,0,0,1
"15780","forcarrying",1,0,0,0,1
"15781","forceand",1,0,0,0,1
"15782","forcewhich",1,0,0,0,1
"15783","forciblytaken",1,0,0,0,1
"15784","forcing",1,0,0,0,1
"15785","forcolored",1,0,0,0,1
"15786","forcongress",1,0,0,0,1
"15787","forcrossing",1,0,0,0,1
"15788","forcutting",1,0,0,0,1
"15789","forddouglas",1,0,0,0,1
"15790","fords",1,0,0,0,1
"15791","foreboding",0,1,0,0,1
"15792","forebodings",1,0,0,0,1
"15793","foreheads",0,0,0,1,1
"15794","foreignbirth",1,0,0,0,1
"15795","foreigner",0,1,0,0,1
"15796","foreigners",1,0,0,0,1
"15797","foreignor",1,0,0,0,1
"15798","forenoon",0,0,0,1,1
"15799","foreshadow",0,1,0,0,1
"15800","foresight",1,0,0,0,1
"15801","foretop",1,0,0,0,1
"15802","foreverdestroyed.i",1,0,0,0,1
"15803","foreversundered",1,0,0,0,1
"15804","forevery",1,0,0,0,1
"15805","forexpressing",1,0,0,0,1
"15806","forfeit",0,1,0,0,1
"15807","forfeita",1,0,0,0,1
"15808","forfestal",1,0,0,0,1
"15809","forfuture",1,0,0,0,1
"15810","forgaining",1,0,0,0,1
"15811","forgetful",0,1,0,0,1
"15812","forging",1,0,0,0,1
"15813","forgotlen",0,0,0,1,1
"15814","forgotten.those",1,0,0,0,1
"15815","forgottenor",1,0,0,0,1
"15816","forgotthat",1,0,0,0,1
"15817","forher",1,0,0,0,1
"15818","forhim",1,0,0,0,1
"15819","forhimself",1,0,0,0,1
"15820","forits",1,0,0,0,1
"15821","forjustice",1,0,0,0,1
"15822","fork",0,1,0,0,1
"15823","forlife",1,0,0,0,1
"15824","forlittle",1,0,0,0,1
"15825","formally",1,0,0,0,1
"15826","formand",1,0,0,0,1
"15827","formany",1,0,0,0,1
"15828","former",0,0,0,1,1
"15829","former.during",1,0,0,0,1
"15830","former.the",1,0,0,0,1
"15831","formerhopes",1,0,0,0,1
"15832","formerobjects",1,0,0,0,1
"15833","formerpolitical",1,0,0,0,1
"15834","forming",0,1,0,0,1
"15835","formly",0,0,0,1,1
"15836","formulas",0,1,0,0,1
"15837","formulate",1,0,0,0,1
"15838","fornot",1,0,0,0,1
"15839","foron",1,0,0,0,1
"15840","forour",1,0,0,0,1
"15841","forover",1,0,0,0,1
"15842","forphiladelphia",1,0,0,0,1
"15843","forpositions",1,0,0,0,1
"15844","forpreaching",1,0,0,0,1
"15845","forrelief.my",1,0,0,0,1
"15846","forslavery",1,0,0,0,1
"15847","forster",1,0,0,0,1
"15848","forsuccess",1,0,0,0,1
"15849","forthat",1,0,0,0,1
"15850","forthcoming.master",1,0,0,0,1
"15851","forthemselves",1,0,0,0,1
"15852","forthey",1,0,0,0,1
"15853","forthree",1,0,0,0,1
"15854","forthto",1,0,0,0,1
"15855","fortification",1,0,0,0,1
"15856","fortifying",1,0,0,0,1
"15857","fortitude",1,0,0,0,1
"15858","fortoronto",1,0,0,0,1
"15859","fortress",1,0,0,0,1
"15860","fortunate.the",1,0,0,0,1
"15861","fortunateas",1,0,0,0,1
"15862","fortuneto",1,0,0,0,1
"15863","fortwagner",1,0,0,0,1
"15864","fortwenty",1,0,0,0,1
"15865","fortymiles",1,0,0,0,1
"15866","fortyyears",1,0,0,0,1
"15867","forurging",1,0,0,0,1
"15868","forward.i",1,0,0,0,1
"15869","forwardersfrom",1,0,0,0,1
"15870","forwardshould",1,0,0,0,1
"15871","forwhaling",1,0,0,0,1
"15872","forwhat",1,0,0,0,1
"15873","forwhen",1,0,0,0,1
"15874","forwhich",1,0,0,0,1
"15875","forwhom",1,0,0,0,1
"15876","forwork",1,0,0,0,1
"15877","foryoung",1,0,0,0,1
"15878","fosterduring",1,0,0,0,1
"15879","fostered",0,1,0,0,1
"15880","fosteredcoarseness",1,0,0,0,1
"15881","fosters",0,1,0,0,1
"15882","fouleggs",1,0,0,0,1
"15883","foundany",1,0,0,0,1
"15884","foundations",0,1,0,0,1
"15885","foundations.at",1,0,0,0,1
"15886","foundationto",1,0,0,0,1
"15887","foundbefore",1,0,0,0,1
"15888","founded.he",1,0,0,0,1
"15889","foundedupon",1,0,0,0,1
"15890","foundexact",1,0,0,0,1
"15891","foundfor",1,0,0,0,1
"15892","foundimpossible",1,0,0,0,1
"15893","foundin",1,0,0,0,1
"15894","foundmyself",1,0,0,0,1
"15895","foundopportunity",1,0,0,0,1
"15896","foundthat",1,0,0,0,1
"15897","foundway",1,0,0,0,1
"15898","fountain",0,1,0,0,1
"15899","fourdecades",1,0,0,0,1
"15900","fourfoldto",1,0,0,0,1
"15901","fouror",1,0,0,0,1
"15902","fourvoices",1,0,0,0,1
"15903","foward",0,0,0,1,1
"15904","fowellbuxton",1,0,0,0,1
"15905","foxes",1,0,0,0,1
"15906","fraction",0,1,0,0,1
"15907","fragant",0,1,0,0,1
"15908","fragile",0,1,0,0,1
"15909","fragrance",0,1,0,0,1
"15910","frail",0,1,0,0,1
"15911","francisco",1,0,0,0,1
"15912","franklytold",1,0,0,0,1
"15913","frantic",1,0,0,0,1
"15914","fraternization",0,1,0,0,1
"15915","fraternize",1,0,0,0,1
"15916","fraudinstituted",1,0,0,0,1
"15917","fraught",1,0,0,0,1
"15918","freaks",0,1,0,0,1
"15919","freday",0,0,0,1,1
"15920","frederic",1,0,0,0,1
"15921","frederickdouglass",1,0,0,0,1
"15922","frederickhas",1,0,0,0,1
"15923","fredericksburg",1,0,0,0,1
"15924","free_",0,1,0,0,1
"15925","free.all",1,0,0,0,1
"15926","freedman’s",1,0,0,0,1
"15927","freedmen.when",1,0,0,0,1
"15928","freedmen’ssavings",1,0,0,0,1
"15929","freedom.the",1,0,0,0,1
"15930","freedomand",1,0,0,0,1
"15931","freedomgenerally",1,0,0,0,1
"15932","freedomof",1,0,0,0,1
"15933","freedomsaw",1,0,0,0,1
"15934","freedomwhich",1,0,0,0,1
"15935","freeing",1,0,0,0,1
"15936","freeingthe",1,0,0,0,1
"15937","freeman_",0,1,0,0,1
"15938","freeman.chapter",1,0,0,0,1
"15939","freemen.another",1,0,0,0,1
"15940","freespeech",1,0,0,0,1
"15941","freest",0,1,0,0,1
"15942","freestate.there",1,0,0,0,1
"15943","freestates",1,0,0,0,1
"15944","freezing",1,0,0,0,1
"15945","freighted",0,1,0,0,1
"15946","freightedwith",1,0,0,0,1
"15947","frémont",1,0,0,0,1
"15948","fremont’s",1,0,0,0,1
"15949","frenchman",1,0,0,0,1
"15950","frenzied",0,1,0,0,1
"15951","frequentin",1,0,0,0,1
"15952","freshbeef",1,0,0,0,1
"15953","freshcan",1,0,0,0,1
"15954","freshfrom",1,0,0,0,1
"15955","freshly",1,0,0,0,1
"15956","freshness",0,1,0,0,1
"15957","fresored",0,0,0,1,1
"15958","fretted",0,1,0,0,1
"15959","friendbuffum",1,0,0,0,1
"15960","frienddoctor",1,0,0,0,1
"15961","friendjohnson",1,0,0,0,1
"15962","friendless.mrs",1,0,0,0,1
"15963","friendliness",0,0,1,0,1
"15964","friendlydisposition",1,0,0,0,1
"15965","friendlytalk",1,0,0,0,1
"15966","friendlyto",1,0,0,0,1
"15967","friends.my",1,0,0,0,1
"15968","friends.nothing",1,0,0,0,1
"15969","friendsand",1,0,0,0,1
"15970","friendsattended",1,0,0,0,1
"15971","friendsin",1,0,0,0,1
"15972","frigate",1,0,0,0,1
"15973","frighten",0,1,0,0,1
"15974","frivolity",0,1,0,0,1
"15975","fro",1,0,0,0,1
"15976","frocked",0,0,0,1,1
"15977","from_slavery_",1,0,0,0,1
"15978","from‘dem",1,0,0,0,1
"15979","froma",1,0,0,0,1
"15980","fromage",0,0,0,1,1
"15981","fromalabama",1,0,0,0,1
"15982","fromany",1,0,0,0,1
"15983","fromasserting",1,0,0,0,1
"15984","fromback",1,0,0,0,1
"15985","frombaltimore",1,0,0,0,1
"15986","frombeing",1,0,0,0,1
"15987","frombetween",1,0,0,0,1
"15988","frombondage",1,0,0,0,1
"15989","fromcol",1,0,0,0,1
"15990","fromcuriosity",1,0,0,0,1
"15991","fromdismemberment",1,0,0,0,1
"15992","fromdismemberment.it",1,0,0,0,1
"15993","fromeaston",1,0,0,0,1
"15994","fromgeorgia",1,0,0,0,1
"15995","fromgoing",1,0,0,0,1
"15996","fromgreenfield",1,0,0,0,1
"15997","fromhumane",1,0,0,0,1
"15998","fromknowing",1,0,0,0,1
"15999","fromme",1,0,0,0,1
"16000","frommissouri",1,0,0,0,1
"16001","frommy",1,0,0,0,1
"16002","fromone",1,0,0,0,1
"16003","fromother",1,0,0,0,1
"16004","fromothers",1,0,0,0,1
"16005","frompositions",1,0,0,0,1
"16006","frompresident",1,0,0,0,1
"16007","fromslavery.chapter",1,0,0,0,1
"16008","fromthat",1,0,0,0,1
"16009","fromtheir",1,0,0,0,1
"16010","fromtuckahoe",1,0,0,0,1
"16011","fromvoting",1,0,0,0,1
"16012","fromwhat",1,0,0,0,1
"16013","fromwhich",1,0,0,0,1
"16014","fromwhom",1,0,0,0,1
"16015","fromyouth",1,0,0,0,1
"16016","fronta",1,0,0,0,1
"16017","frontier",1,0,0,0,1
"16018","fronts",1,0,0,0,1
"16019","frostiest",1,0,0,0,1
"16020","frosts",1,0,0,0,1
"16021","frownedupon",1,0,0,0,1
"16022","frowning",0,0,0,1,1
"16023","frownof",1,0,0,0,1
"16024","frowns",0,1,0,0,1
"16025","fruitful",1,0,0,0,1
"16026","fry",0,0,0,1,1
"16027","fugitiveslave",1,0,0,0,1
"16028","fugitiveswho",1,0,0,0,1
"16029","fulfilment",1,0,0,0,1
"16030","fullgush",1,0,0,0,1
"16031","fullnessof",1,0,0,0,1
"16032","fullof",1,0,0,0,1
"16033","fullrestraints",1,0,0,0,1
"16034","fully",0,0,0,1,1
"16035","fullycommitted",1,0,0,0,1
"16036","fullyup",1,0,0,0,1
"16037","fulness",0,0,1,0,1
"16038","fundamentaland",1,0,0,0,1
"16039","fundsfor",1,0,0,0,1
"16040","furnishedan",1,0,0,0,1
"16041","furnishedwith",1,0,0,0,1
"16042","furnishshade",1,0,0,0,1
"16043","furthereffort",1,0,0,0,1
"16044","furtherproposed",1,0,0,0,1
"16045","fussell",1,0,0,0,1
"16046","futile",1,0,0,0,1
"16047","future.it",1,0,0,0,1
"16048","future.the",1,0,0,0,1
"16049","g.warner",1,0,0,0,1
"16050","gage",1,0,0,0,1
"16051","gags",0,1,0,0,1
"16052","gain.slaves",1,0,0,0,1
"16053","gained.chapter",1,0,0,0,1
"16054","gained.patrick",1,0,0,0,1
"16055","gainedmore",1,0,0,0,1
"16056","gainingmy",1,0,0,0,1
"16057","gainingstrength",1,0,0,0,1
"16058","gainsay",0,1,0,0,1
"16059","gaintheir",1,0,0,0,1
"16060","gales",0,1,0,0,1
"16061","galion",0,0,0,1,1
"16062","gallileo",0,0,0,1,1
"16063","gamble",0,1,0,0,1
"16064","gambler",1,0,0,0,1
"16065","gamblers",0,1,0,0,1
"16066","games",0,1,0,0,1
"16067","gangs",0,1,0,0,1
"16068","garb",0,0,1,0,1
"16069","gardiner.the",1,0,0,0,1
"16070","garnered",1,0,0,0,1
"16071","garnetts",1,0,0,0,1
"16072","garret",0,1,0,0,1
"16073","garrison_",1,0,0,0,1
"16074","garrisoning",1,0,0,0,1
"16075","garrisonism",0,1,0,0,1
"16076","garrisonthrough",1,0,0,0,1
"16077","gate.successful",1,0,0,0,1
"16078","gates.the",1,0,0,0,1
"16079","gathers",0,0,1,0,1
"16080","gauge",0,0,1,0,1
"16081","gauntsided",1,0,0,0,1
"16082","gavea",1,0,0,0,1
"16083","gavehim",1,0,0,0,1
"16084","gaveto",1,0,0,0,1
"16085","gazes",0,1,0,0,1
"16086","gazingmy",1,0,0,0,1
"16087","gear",0,0,0,1,1
"16088","gehezeh",0,0,0,1,1
"16089","gem",0,1,0,0,1
"16090","gemof",1,0,0,0,1
"16091","genealogicaltrees",1,0,0,0,1
"16092","generalbutler",1,0,0,0,1
"16093","generalcurrent",1,0,0,0,1
"16094","generaldescription",1,0,0,0,1
"16095","generaled",1,0,0,0,1
"16096","generalexcitement",1,0,0,0,1
"16097","generalities.i",1,0,0,0,1
"16098","generalization",0,1,0,0,1
"16099","generalizations",0,1,0,0,1
"16100","generallee",1,0,0,0,1
"16101","generally.a",1,0,0,0,1
"16102","generally.it",1,0,0,0,1
"16103","generallya",1,0,0,0,1
"16104","generallychurch",1,0,0,0,1
"16105","generallyreceived",1,0,0,0,1
"16106","generallyvindicated",1,0,0,0,1
"16107","generals",1,0,0,0,1
"16108","generalship",1,0,0,0,1
"16109","generalthomas",1,0,0,0,1
"16110","generalties",0,1,0,0,1
"16111","generators",1,0,0,0,1
"16112","generosityof",1,0,0,0,1
"16113","generouslycontributed",1,0,0,0,1
"16114","generousrecognition",1,0,0,0,1
"16115","geneva",1,0,0,0,1
"16116","genoa",0,1,0,0,1
"16117","genova",0,0,0,1,1
"16118","gentleman.though",1,0,0,0,1
"16119","gentleman’s",1,0,0,0,1
"16120","gentlemanapproached",1,0,0,0,1
"16121","gentlemanimpressed",1,0,0,0,1
"16122","gentlemanopposite",1,0,0,0,1
"16123","gentlemen_",1,0,0,0,1
"16124","gentlementhere",1,0,0,0,1
"16125","gentlemenwho",1,0,0,0,1
"16126","gentler",0,1,0,0,1
"16127","gentlerbreezes",1,0,0,0,1
"16128","gentlest",0,1,0,0,1
"16129","gentlewomen",0,1,0,0,1
"16130","genuene",0,0,0,1,1
"16131","genuineconversion",1,0,0,0,1
"16132","genuinefugitive",1,0,0,0,1
"16133","genuinegoodness",1,0,0,0,1
"16134","genus",0,0,0,1,1
"16135","geometry",0,1,0,0,1
"16136","georgecombe",1,0,0,0,1
"16137","georgehowland",1,0,0,0,1
"16138","georgel",1,0,0,0,1
"16139","georgem",1,0,0,0,1
"16140","georges",0,0,0,1,1
"16141","geoti",0,0,0,1,1
"16142","germany",0,1,0,0,1
"16143","germs",0,1,0,0,1
"16144","gerritsmith",1,0,0,0,1
"16145","gerritt",1,0,0,0,1
"16146","get.mr",1,0,0,0,1
"16147","get.this",1,0,0,0,1
"16148","getclear",1,0,0,0,1
"16149","getcredit",1,0,0,0,1
"16150","gether",0,0,0,1,1
"16151","getin",1,0,0,0,1
"16152","getoff",1,0,0,0,1
"16153","getone",1,0,0,0,1
"16154","getout",1,0,0,0,1
"16155","getrid",1,0,0,0,1
"16156","getthe",1,0,0,0,1
"16157","getthere",1,0,0,0,1
"16158","gewgaws",0,0,1,0,1
"16159","ghezireh",0,0,0,1,1
"16160","ghost",1,0,0,0,1
"16161","giant",0,1,0,0,1
"16162","gibberish",0,0,1,0,1
"16163","gibsons",1,0,0,0,1
"16164","gid",1,0,0,0,1
"16165","gideon",1,0,0,0,1
"16166","gidion",0,0,0,1,1
"16167","gifford",1,0,0,0,1
"16168","giganticrebellion",1,0,0,0,1
"16169","gilds",0,1,0,0,1
"16170","gipsons",0,1,0,0,1
"16171","givemy",1,0,0,0,1
"16172","givenas",1,0,0,0,1
"16173","givenby",1,0,0,0,1
"16174","givenplace",1,0,0,0,1
"16175","giventhe",1,0,0,0,1
"16176","givento",1,0,0,0,1
"16177","giveup",1,0,0,0,1
"16178","giveus",1,0,0,0,1
"16179","givingto",1,0,0,0,1
"16180","gizeh",0,0,0,1,1
"16181","gladdened",0,0,1,0,1
"16182","gladdens",0,0,0,1,1
"16183","gladnessexhausted",1,0,0,0,1
"16184","gladto",1,0,0,0,1
"16185","gladwhen",1,0,0,0,1
"16186","gladyou",1,0,0,0,1
"16187","glanceof",1,0,0,0,1
"16188","glancesof",1,0,0,0,1
"16189","glared",1,0,0,0,1
"16190","glasses",1,0,0,0,1
"16191","glazed",0,1,0,0,1
"16192","gleams",1,0,0,0,1
"16193","gleaned",1,0,0,0,1
"16194","gleefulchildren",1,0,0,0,1
"16195","glib",0,1,0,0,1
"16196","glidden",1,0,0,0,1
"16197","glided",0,1,0,0,1
"16198","glides",0,0,0,1,1
"16199","glimmer",1,0,0,0,1
"16200","glimps",0,0,0,1,1
"16201","glitteringgeneralities",1,0,0,0,1
"16202","glorifying",0,1,0,0,1
"16203","glorious.the",1,0,0,0,1
"16204","gloriouschange",1,0,0,0,1
"16205","gloriousthe",1,0,0,0,1
"16206","glory.our",1,0,0,0,1
"16207","gloves",1,0,0,0,1
"16208","glowing",0,1,0,0,1
"16209","gluts",1,0,0,0,1
"16210","go_",0,1,0,0,1
"16211","go_nowhere_",1,0,0,0,1
"16212","go.the",1,0,0,0,1
"16213","goads_",1,0,0,0,1
"16214","goat",0,1,0,0,1
"16215","goats",0,0,1,0,1
"16216","gobeyond",1,0,0,0,1
"16217","godbless",1,0,0,0,1
"16218","godown",1,0,0,0,1
"16219","goes",0,0,0,1,1
"16220","going ",0,0,0,1,1
"16221","goingon",1,0,0,0,1
"16222","goingthe",1,0,0,0,1
"16223","goingup",1,0,0,0,1
"16224","goinside",1,0,0,0,1
"16225","golconda",1,0,0,0,1
"16226","goldboroughs",1,0,0,0,1
"16227","goldwatch",1,0,0,0,1
"16228","gondolas",0,0,0,1,1
"16229","gone.with",1,0,0,0,1
"16230","goneinto",1,0,0,0,1
"16231","gonewith",1,0,0,0,1
"16232","goodbut",1,0,0,0,1
"16233","goodmen",1,0,0,0,1
"16234","goodmrs",1,0,0,0,1
"16235","goodnature",1,0,0,0,1
"16236","goodold",1,0,0,0,1
"16237","goodpaymaster",1,0,0,0,1
"16238","goodsbrought",1,0,0,0,1
"16239","goodsoldiers",1,0,0,0,1
"16240","goodto",1,0,0,0,1
"16241","goold",1,0,0,0,1
"16242","goolds",1,0,0,0,1
"16243","gorge",0,0,1,0,1
"16244","gorges",0,0,0,1,1
"16245","gorgiousness",0,0,0,1,1
"16246","gormandizers",0,1,0,0,1
"16247","goshen",0,0,0,1,1
"16248","goslin",1,0,0,0,1
"16249","gota",1,0,0,0,1
"16250","gothere",1,0,0,0,1
"16251","gotoff",1,0,0,0,1
"16252","goton",1,0,0,0,1
"16253","gottenitself",1,0,0,0,1
"16254","gotthe",1,0,0,0,1
"16255","gough",1,0,0,0,1
"16256","gourmandizer",1,0,0,0,1
"16257","government.i",1,0,0,0,1
"16258","government.the",1,0,0,0,1
"16259","government.upon",1,0,0,0,1
"16260","governmentdid",1,0,0,0,1
"16261","governmentfrom",1,0,0,0,1
"16262","governmenthad",1,0,0,0,1
"16263","governmentof",1,0,0,0,1
"16264","governmentproperty",1,0,0,0,1
"16265","governmentwas",1,0,0,0,1
"16266","governmentwhich",1,0,0,0,1
"16267","governorandrew",1,0,0,0,1
"16268","governthe",1,0,0,0,1
"16269","gowned",0,0,0,1,1
"16270","gradation",0,1,0,0,1
"16271","gradations",1,0,0,0,1
"16272","grades",1,0,0,0,1
"16273","gradual",1,0,0,0,1
"16274","graduallyopening",1,0,0,0,1
"16275","grafting",0,1,0,0,1
"16276","grained",0,1,0,0,1
"16277","grammar",1,0,0,0,1
"16278","grandaim",1,0,0,0,1
"16279","grandeurs",1,0,0,0,1
"16280","grandmammaplaced",1,0,0,0,1
"16281","grandmammy’s",0,1,0,0,1
"16282","grandmother.it",1,0,0,0,1
"16283","grandmother.my",1,0,0,0,1
"16284","grandmotherand",1,0,0,0,1
"16285","grandmotherhad",1,0,0,0,1
"16286","grandmotherin",1,0,0,0,1
"16287","grandmothernow",1,0,0,0,1
"16288","grandoccasion",1,0,0,0,1
"16289","granitewall",1,0,0,0,1
"16290","grantedme",1,0,0,0,1
"16291","grantpresidential",1,0,0,0,1
"16292","grantwhen",1,0,0,0,1
"16293","granvillesharpe",1,0,0,0,1
"16294","grappling",1,0,0,0,1
"16295","grasps",0,1,0,0,1
"16296","grass",0,0,0,1,1
"16297","gratefullyfound",1,0,0,0,1
"16298","gratifyingcontrast",1,0,0,0,1
"16299","gratings",1,0,0,0,1
"16300","gratitude.pleased",1,0,0,0,1
"16301","gratuitousassumption",1,0,0,0,1
"16302","gratulation",1,0,0,0,1
"16303","grave.some",1,0,0,0,1
"16304","gravesof",1,0,0,0,1
"16305","graveyard",0,1,0,0,1
"16306","gravitation",0,1,0,0,1
"16307","gravity.the",1,0,0,0,1
"16308","grays",0,1,0,0,1
"16309","greatcity",1,0,0,0,1
"16310","greatdanger",1,0,0,0,1
"16311","greatease",1,0,0,0,1
"16312","greated",0,0,0,1,1
"16313","greately",0,0,0,1,1
"16314","greathouse",1,0,0,0,1
"16315","greatlabor",1,0,0,0,1
"16316","greatlysaddened",1,0,0,0,1
"16317","greatlyshook",1,0,0,0,1
"16318","greatlyto",1,0,0,0,1
"16319","greatmen",1,0,0,0,1
"16320","greatmercy",1,0,0,0,1
"16321","greatmovement",1,0,0,0,1
"16322","greatmultitude",1,0,0,0,1
"16323","greatoffense",1,0,0,0,1
"16324","greatqualities",1,0,0,0,1
"16325","greatship",1,0,0,0,1
"16326","greatto",1,0,0,0,1
"16327","greattreachery",1,0,0,0,1
"16328","greatvalue",1,0,0,0,1
"16329","greatwrestler",1,0,0,0,1
"16330","greed",0,1,0,0,1
"16331","greediness",0,0,1,0,1
"16332","greek",0,0,0,1,1
"16333","greek.after",1,0,0,0,1
"16334","greeley.happily",1,0,0,0,1
"16335","greenwich",1,0,0,0,1
"16336","greided",0,0,0,1,1
"16337","gret",0,0,0,1,1
"16338","grey",0,1,0,0,1
"16339","grief.living",1,0,0,0,1
"16340","grievances",0,1,0,0,1
"16341","grievousand",1,0,0,0,1
"16342","grievousdisasters",1,0,0,0,1
"16343","griffiths",1,0,0,0,1
"16344","grinnells",1,0,0,0,1
"16345","groaning",0,0,1,0,1
"16346","grope",0,1,0,0,1
"16347","grosserand",1,0,0,0,1
"16348","ground.i",1,0,0,0,1
"16349","ground.while",1,0,0,0,1
"16350","grounded",0,1,0,0,1
"16351","groundlings",1,0,0,0,1
"16352","groundof",1,0,0,0,1
"16353","groundso",1,0,0,0,1
"16354","groundwas",1,0,0,0,1
"16355","groups",0,0,0,1,1
"16356","grovelling",0,0,0,1,1
"16357","growingimpatience",1,0,0,0,1
"16358","grownand",1,0,0,0,1
"16359","grudgingly",0,1,0,0,1
"16360","guardedas",1,0,0,0,1
"16361","guess",1,0,0,0,1
"16362","guestat",1,0,0,0,1
"16363","guests.many",1,0,0,0,1
"16364","guides",0,0,1,0,1
"16365","guiltiest",1,0,0,0,1
"16366","guiltymaster",1,0,0,0,1
"16367","gunthe",1,0,0,0,1
"16368","gush",0,1,0,0,1
"16369","gustavusdorgan",1,0,0,0,1
"16370","h.clifford",1,0,0,0,1
"16371","h.hawes",1,0,0,0,1
"16372","habitableglobe",1,0,0,0,1
"16373","habitual",1,0,0,0,1
"16374","hacked",1,0,0,0,1
"16375","hackman",1,0,0,0,1
"16376","had.my",1,0,0,0,1
"16377","hada",1,0,0,0,1
"16378","hadaffected",1,0,0,0,1
"16379","hadalready",1,0,0,0,1
"16380","hadanticipated",1,0,0,0,1
"16381","hadanything",1,0,0,0,1
"16382","hadarranged",1,0,0,0,1
"16383","hadassistants",1,0,0,0,1
"16384","hadaway",0,1,0,0,1
"16385","hadbetrayed",1,0,0,0,1
"16386","hadbetter",1,0,0,0,1
"16387","hadcontrol",1,0,0,0,1
"16388","haddawned",1,0,0,0,1
"16389","haddenounced",1,0,0,0,1
"16390","hadever",1,0,0,0,1
"16391","hadevidently",1,0,0,0,1
"16392","hadfailed",1,0,0,0,1
"16393","hadfar",1,0,0,0,1
"16394","hadforfeited",1,0,0,0,1
"16395","hadformerly",1,0,0,0,1
"16396","hadgiven",1,0,0,0,1
"16397","hadgood",1,0,0,0,1
"16398","hadgot",1,0,0,0,1
"16399","hadgrown",1,0,0,0,1
"16400","hadhappened",1,0,0,0,1
"16401","hadhe",1,0,0,0,1
"16402","hadheard",1,0,0,0,1
"16403","hadits",1,0,0,0,1
"16404","hadlarger",1,0,0,0,1
"16405","hadmerely",1,0,0,0,1
"16406","hadmoney",1,0,0,0,1
"16407","hadmortgaged",1,0,0,0,1
"16408","hadmy",1,0,0,0,1
"16409","hadnearly",1,0,0,0,1
"16410","hadnothing",1,0,0,0,1
"16411","hadobtained",1,0,0,0,1
"16412","hadone",1,0,0,0,1
"16413","hadonly",1,0,0,0,1
"16414","hadour",1,0,0,0,1
"16415","hadpeopled",1,0,0,0,1
"16416","hadpersisted",1,0,0,0,1
"16417","hadpractically",1,0,0,0,1
"16418","hadreached",1,0,0,0,1
"16419","hadreason",1,0,0,0,1
"16420","hadresisted",1,0,0,0,1
"16421","hadsaid",1,0,0,0,1
"16422","hadsecured",1,0,0,0,1
"16423","hadseemed",1,0,0,0,1
"16424","hadseen",1,0,0,0,1
"16425","hadselected",1,0,0,0,1
"16426","hadsent",1,0,0,0,1
"16427","hadshown",1,0,0,0,1
"16428","hadso",1,0,0,0,1
"16429","hadsold",1,0,0,0,1
"16430","hadstruck",1,0,0,0,1
"16431","hadsuch",1,0,0,0,1
"16432","hadsuffered.my",1,0,0,0,1
"16433","hadsupposed",1,0,0,0,1
"16434","hadtaken",1,0,0,0,1
"16435","hadthat",1,0,0,0,1
"16436","hadtheir",1,0,0,0,1
"16437","hadthese",1,0,0,0,1
"16438","hadto",1,0,0,0,1
"16439","hadtwo",1,0,0,0,1
"16440","hailing",0,0,1,0,1
"16441","hairdisheveled",1,0,0,0,1
"16442","hairwas",1,0,0,0,1
"16443","haiti",0,0,1,0,1
"16444","halfdollars",1,0,0,0,1
"16445","halfness",1,0,0,0,1
"16446","halfof",1,0,0,0,1
"16447","halfway",0,1,0,0,1
"16448","hallelujahs",0,1,0,0,1
"16449","hallooing",1,0,0,0,1
"16450","hallowed",0,1,0,0,1
"16451","haltingon",1,0,0,0,1
"16452","hamilton’scook",1,0,0,0,1
"16453","hamlet",1,0,0,0,1
"16454","hammered",1,0,0,0,1
"16455","hampshire",1,0,0,0,1
"16456","hams",0,1,0,0,1
"16457","hand.it",1,0,0,0,1
"16458","hand.taken",1,0,0,0,1
"16459","handcuffs",1,0,0,0,1
"16460","handedhim",1,0,0,0,1
"16461","handedwith",1,0,0,0,1
"16462","handicraftsmen",0,1,0,0,1
"16463","handledby",1,0,0,0,1
"16464","handleto",1,0,0,0,1
"16465","handpocket.this",1,0,0,0,1
"16466","handsfound",1,0,0,0,1
"16467","handshe",1,0,0,0,1
"16468","handsome",0,1,0,0,1
"16469","handspikes",0,0,1,0,1
"16470","handsso",1,0,0,0,1
"16471","handsthey",1,0,0,0,1
"16472","handswith",1,0,0,0,1
"16473","handwhen",1,0,0,0,1
"16474","hangedjohn",1,0,0,0,1
"16475","hans",1,0,0,0,1
"16476","hapless",0,1,0,0,1
"16477","happenedthat",1,0,0,0,1
"16478","happy.one",1,0,0,0,1
"16479","happyabode",1,0,0,0,1
"16480","happydwelling",1,0,0,0,1
"16481","happyfor",1,0,0,0,1
"16482","happymoments",1,0,0,0,1
"16483","harass",1,0,0,0,1
"16484","harbinger",0,1,0,0,1
"16485","harboring",1,0,0,0,1
"16486","hardearnings",1,0,0,0,1
"16487","hardearnings.the",1,0,0,0,1
"16488","hardenedruffians",1,0,0,0,1
"16489","hardestcuffs",1,0,0,0,1
"16490","hardhands",1,0,0,0,1
"16491","hardif",1,0,0,0,1
"16492","hardlynecessary",1,0,0,0,1
"16493","hardlyunderstand",1,0,0,0,1
"16494","hardweapon",1,0,0,0,1
"16495","hares",0,0,1,0,1
"16496","harmful",1,0,0,0,1
"16497","harmonious",0,1,0,0,1
"16498","harps",0,1,0,0,1
"16499","harrisburgh",0,1,0,0,1
"16500","harrowed",0,1,0,0,1
"16501","harry’s",0,1,0,0,1
"16502","harrythe",1,0,0,0,1
"16503","harshly.chapter",1,0,0,0,1
"16504","harshness",1,0,0,0,1
"16505","hart",0,1,0,0,1
"16506","hartford",1,0,0,0,1
"16507","harvard",1,0,0,0,1
"16508","harvest.whether",1,0,0,0,1
"16509","hasbeen",1,0,0,0,1
"16510","hascaused",1,0,0,0,1
"16511","hasfilled",1,0,0,0,1
"16512","hashimself",1,0,0,0,1
"16513","hasjust",1,0,0,0,1
"16514","hasnever",1,0,0,0,1
"16515","hasno",1,0,0,0,1
"16516","hassen",0,0,0,1,1
"16517","hassince",1,0,0,0,1
"16518","hastening",0,0,1,0,1
"16519","hastold",1,0,0,0,1
"16520","hatch",0,1,0,0,1
"16521","hatched",1,0,0,0,1
"16522","hatchway",0,1,0,0,1
"16523","hatebreaks",1,0,0,0,1
"16524","hatedand",1,0,0,0,1
"16525","hatedbecause",1,0,0,0,1
"16526","hatefulness",0,1,0,0,1
"16527","hater",1,0,0,0,1
"16528","hateth",0,1,0,0,1
"16529","hating",0,1,0,0,1
"16530","haul",1,0,0,0,1
"16531","hauled",1,0,0,0,1
"16532","haunt",1,0,0,0,1
"16533","haunts",0,1,0,0,1
"16534","hav",0,0,0,1,1
"16535","haveaccomplished",1,0,0,0,1
"16536","haveall",1,0,0,0,1
"16537","haveattended",1,0,0,0,1
"16538","havebefore",1,0,0,0,1
"16539","haveburst",1,0,0,0,1
"16540","havecome",1,0,0,0,1
"16541","havecommanded",1,0,0,0,1
"16542","haveconcerning",1,0,0,0,1
"16543","havedepressed",1,0,0,0,1
"16544","havedetected",1,0,0,0,1
"16545","havedetermined",1,0,0,0,1
"16546","havedone",1,0,0,0,1
"16547","haveelsewhere",1,0,0,0,1
"16548","haveendeavored",1,0,0,0,1
"16549","haveendured",1,0,0,0,1
"16550","haveequally",1,0,0,0,1
"16551","haveerected",1,0,0,0,1
"16552","haveeven",1,0,0,0,1
"16553","havefree",1,0,0,0,1
"16554","havefrom",1,0,0,0,1
"16555","havegiven",1,0,0,0,1
"16556","havegladly",1,0,0,0,1
"16557","havegone",1,0,0,0,1
"16558","havehappened",1,0,0,0,1
"16559","havehis",1,0,0,0,1
"16560","haveindividuals",1,0,0,0,1
"16561","havejust",1,0,0,0,1
"16562","havelaid",1,0,0,0,1
"16563","havelived",1,0,0,0,1
"16564","havelost",1,0,0,0,1
"16565","havemade",1,0,0,0,1
"16566","havemastered",1,0,0,0,1
"16567","haveme",1,0,0,0,1
"16568","havemercy",1,0,0,0,1
"16569","havenests",1,0,0,0,1
"16570","havenever",1,0,0,0,1
"16571","havenow",1,0,0,0,1
"16572","haveoften",1,0,0,0,1
"16573","haveonly",1,0,0,0,1
"16574","haveproved",1,0,0,0,1
"16575","havereason",1,0,0,0,1
"16576","havereferred",1,0,0,0,1
"16577","haveremained",1,0,0,0,1
"16578","havesaid",1,0,0,0,1
"16579","havesatisfaction",1,0,0,0,1
"16580","havesecured",1,0,0,0,1
"16581","haveseldom",1,0,0,0,1
"16582","havesent",1,0,0,0,1
"16583","haveshared",1,0,0,0,1
"16584","haveshares",1,0,0,0,1
"16585","haveshown",1,0,0,0,1
"16586","havesince",1,0,0,0,1
"16587","havespecial",1,0,0,0,1
"16588","havesprung",1,0,0,0,1
"16589","havethe",1,0,0,0,1
"16590","havethese",1,0,0,0,1
"16591","havethose",1,0,0,0,1
"16592","haveunder",1,0,0,0,1
"16593","havewhat",1,0,0,0,1
"16594","haveyielded",1,0,0,0,1
"16595","havingas",1,0,0,0,1
"16596","havingcompleted",1,0,0,0,1
"16597","havingenjoyed",1,0,0,0,1
"16598","havingled",1,0,0,0,1
"16599","havingmade",1,0,0,0,1
"16600","havingme",1,0,0,0,1
"16601","havingsucceeded",1,0,0,0,1
"16602","havingtaken",1,0,0,0,1
"16603","havingthe",1,0,0,0,1
"16604","havn’t",0,1,0,0,1
"16605","hawes",1,0,0,0,1
"16606","hayes.i",1,0,0,0,1
"16607","haymow",0,1,0,0,1
"16608","haywood’s",0,1,0,0,1
"16609","haze",1,0,0,0,1
"16610","he’d",0,1,0,0,1
"16611","heacted",1,0,0,0,1
"16612","head.bright",1,0,0,0,1
"16613","headed.her",1,0,0,0,1
"16614","heading",0,1,0,0,1
"16615","headlong",0,0,0,1,1
"16616","headship",1,0,0,0,1
"16617","headsof",1,0,0,0,1
"16618","headstone",0,0,0,1,1
"16619","headstrong",1,0,0,0,1
"16620","headwhich",1,0,0,0,1
"16621","healthier",0,0,1,0,1
"16622","heap",0,1,0,0,1
"16623","heardof",1,0,0,0,1
"16624","heards",0,0,0,1,1
"16625","heardthe",1,0,0,0,1
"16626","hearer",1,0,0,0,1
"16627","hearingmany",1,0,0,0,1
"16628","hearingof",1,0,0,0,1
"16629","hearingsome",1,0,0,0,1
"16630","hearraigned",1,0,0,0,1
"16631","heart.chapter",1,0,0,0,1
"16632","heart.it",1,0,0,0,1
"16633","heartbounding",1,0,0,0,1
"16634","heartbreaking",0,0,0,1,1
"16635","heartbroken",0,0,0,1,1
"16636","heartedmourner",1,0,0,0,1
"16637","heartedpeople",1,0,0,0,1
"16638","heartedwoman",1,0,0,0,1
"16639","hearthstone",1,0,0,0,1
"16640","hearthstones",1,0,0,0,1
"16641","heartily",1,0,0,0,1
"16642","heartlessness",0,1,0,0,1
"16643","heartrending",1,0,0,0,1
"16644","heartsbelieved",1,0,0,0,1
"16645","heave",0,1,0,0,1
"16646","heaviest",0,1,0,0,1
"16647","heavylocks",1,0,0,0,1
"16648","heavyweights",1,0,0,0,1
"16649","hebelong",1,0,0,0,1
"16650","hebought",1,0,0,0,1
"16651","hebrews",1,0,0,0,1
"16652","hecame",1,0,0,0,1
"16653","hecertainly",1,0,0,0,1
"16654","hecombined",1,0,0,0,1
"16655","heconsulted",1,0,0,0,1
"16656","hecontinued",1,0,0,0,1
"16657","hectoring",0,0,1,0,1
"16658","hedeclined",1,0,0,0,1
"16659","hedge",0,1,0,0,1
"16660","hedged",1,0,0,0,1
"16661","hedges",1,0,0,0,1
"16662","heenquired",1,0,0,0,1
"16663","heevidently",1,0,0,0,1
"16664","hefiercely",1,0,0,0,1
"16665","hefor",1,0,0,0,1
"16666","hefulfilled",1,0,0,0,1
"16667","hegot",1,0,0,0,1
"16668","hehated",1,0,0,0,1
"16669","hehesitated",1,0,0,0,1
"16670","heinquired",1,0,0,0,1
"16671","heir",1,0,0,0,1
"16672","heknew",1,0,0,0,1
"16673","helda",1,0,0,0,1
"16674","heldboth",1,0,0,0,1
"16675","heldfirmly",1,0,0,0,1
"16676","heldthe",1,0,0,0,1
"16677","helived",1,0,0,0,1
"16678","hellof",1,0,0,0,1
"16679","help",0,0,0,1,1
"16680","helpedus",1,0,0,0,1
"16681","helplessbehind",1,0,0,0,1
"16682","helpmate",0,1,0,0,1
"16683","helps",1,0,0,0,1
"16684","helpthinking",1,0,0,0,1
"16685","hemight",1,0,0,0,1
"16686","hemisphere",0,1,0,0,1
"16687","hemmedin",1,0,0,0,1
"16688","hemsley’s",0,1,0,0,1
"16689","hemust",1,0,0,0,1
"16690","hence",0,0,0,1,1
"16691","hendricks",1,0,0,0,1
"16692","hendricksdeplored",1,0,0,0,1
"16693","henever",1,0,0,0,1
"16694","henot",1,0,0,0,1
"16695","henryand",1,0,0,0,1
"16696","henryharris",1,0,0,0,1
"16697","henrys",0,0,1,0,1
"16698","henrywilson",1,0,0,0,1
"16699","henshaws",1,0,0,0,1
"16700","heovertake",1,0,0,0,1
"16701","heplayfully",1,0,0,0,1
"16702","hepresented",1,0,0,0,1
"16703","heprofessed",1,0,0,0,1
"16704","heproposed",1,0,0,0,1
"16705","hequite",1,0,0,0,1
"16706","her.could",1,0,0,0,1
"16707","her’s",0,1,0,0,1
"16708","hera",1,0,0,0,1
"16709","heradmission",1,0,0,0,1
"16710","herald",0,1,0,0,1
"16711","heralded",1,0,0,0,1
"16712","herand",1,0,0,0,1
"16713","herassailants",1,0,0,0,1
"16714","herback",1,0,0,0,1
"16715","herbenevolent",1,0,0,0,1
"16716","herborders",1,0,0,0,1
"16717","herbrutality",1,0,0,0,1
"16718","herculanium",0,0,0,1,1
"16719","herdeath",1,0,0,0,1
"16720","herdown",1,0,0,0,1
"16721","here.a",1,0,0,0,1
"16722","here.to",1,0,0,0,1
"16723","here.we",1,0,0,0,1
"16724","here.when",1,0,0,0,1
"16725","hereand",1,0,0,0,1
"16726","hereceived",1,0,0,0,1
"16727","heredependent",1,0,0,0,1
"16728","heredescribed",1,0,0,0,1
"16729","hereenumerate",1,0,0,0,1
"16730","hereford",0,0,0,1,1
"16731","heregarded",1,0,0,0,1
"16732","herei",1,0,0,0,1
"16733","heresies",1,0,0,0,1
"16734","heresy",1,0,0,0,1
"16735","herewere",1,0,0,0,1
"16736","herewhere",1,0,0,0,1
"16737","hergirlhood",1,0,0,0,1
"16738","herhonored",1,0,0,0,1
"16739","herhusband",1,0,0,0,1
"16740","heritage",1,0,0,0,1
"16741","herleader",1,0,0,0,1
"16742","hermarriage",1,0,0,0,1
"16743","hermoney",1,0,0,0,1
"16744","hermore",1,0,0,0,1
"16745","hermother",1,0,0,0,1
"16746","hern",1,0,0,0,1
"16747","hername",1,0,0,0,1
"16748","hernature",1,0,0,0,1
"16749","hero.the",1,0,0,0,1
"16750","heroically",1,0,0,0,1
"16751","heroism",0,0,0,1,1
"16752","herplanting",1,0,0,0,1
"16753","herpresent",1,0,0,0,1
"16754","herpupil",1,0,0,0,1
"16755","herrculeesium",0,0,0,1,1
"16756","herresources",1,0,0,0,1
"16757","herseveral",1,0,0,0,1
"16758","herunfriendly",1,0,0,0,1
"16759","hervictim",1,0,0,0,1
"16760","herwritings",1,0,0,0,1
"16761","heryouth",1,0,0,0,1
"16762","heseemed",1,0,0,0,1
"16763","heshould",1,0,0,0,1
"16764","hesitancy",0,0,1,0,1
"16765","hesitatingbehavior",1,0,0,0,1
"16766","hesitatingly",1,0,0,0,1
"16767","hesitatingto",1,0,0,0,1
"16768","hesitation:nevertheless",1,0,0,0,1
"16769","hesoon",1,0,0,0,1
"16770","hesought",1,0,0,0,1
"16771","hespoke",1,0,0,0,1
"16772","hestayed",1,0,0,0,1
"16773","hestole",1,0,0,0,1
"16774","hestruck",1,0,0,0,1
"16775","hethought",1,0,0,0,1
"16776","hetrembled",1,0,0,0,1
"16777","hevociferated",1,0,0,0,1
"16778","hewalked",1,0,0,0,1
"16779","hewers",1,0,0,0,1
"16780","hewore",1,0,0,0,1
"16781","hidesin",1,0,0,0,1
"16782","highconceit",1,0,0,0,1
"16783","higher",0,0,0,1,1
"16784","highest",0,0,0,1,1
"16785","highin",1,0,0,0,1
"16786","highlandgarnet",1,0,0,0,1
"16787","highlife",1,0,0,0,1
"16788","highligted",0,0,0,1,1
"16789","highlycivilized",1,0,0,0,1
"16790","highlyprized",1,0,0,0,1
"16791","highlythan",1,0,0,0,1
"16792","highrate",1,0,0,0,1
"16793","highrespect",1,0,0,0,1
"16794","hight",0,0,0,1,1
"16795","hileopolis",0,0,0,1,1
"16796","hilles.i",1,0,0,0,1
"16797","hilles’kindness",1,0,0,0,1
"16798","hillsboro",0,1,0,0,1
"16799","hillside",0,1,0,0,1
"16800","hilping",0,0,0,1,1
"16801","him_",0,1,0,0,1
"16802","him.a",1,0,0,0,1
"16803","him.all",1,0,0,0,1
"16804","him.his",1,0,0,0,1
"16805","him.one",1,0,0,0,1
"16806","himafter",1,0,0,0,1
"16807","himall",1,0,0,0,1
"16808","himchief",1,0,0,0,1
"16809","himdown",1,0,0,0,1
"16810","himfeel",1,0,0,0,1
"16811","himfrom",1,0,0,0,1
"16812","himhis",1,0,0,0,1
"16813","himhomely",1,0,0,0,1
"16814","himhungry",1,0,0,0,1
"16815","himinto",1,0,0,0,1
"16816","himmore",1,0,0,0,1
"16817","himmust",1,0,0,0,1
"16818","himnearly",1,0,0,0,1
"16819","himotherwise",1,0,0,0,1
"16820","himquite",1,0,0,0,1
"16821","himself.what",1,0,0,0,1
"16822","himselfa",1,0,0,0,1
"16823","himselfburied",1,0,0,0,1
"16824","himselfof",1,0,0,0,1
"16825","himthat",1,0,0,0,1
"16826","himtwo",1,0,0,0,1
"16827","hindermost",0,1,0,0,1
"16828","hindrances",1,0,0,0,1
"16829","hinted",1,0,0,0,1
"16830","hintof",1,0,0,0,1
"16831","hiredkidnappers",1,0,0,0,1
"16832","hiredman",0,1,0,0,1
"16833","hiredthemselves",1,0,0,0,1
"16834","hisage",1,0,0,0,1
"16835","hisamiable",1,0,0,0,1
"16836","hisanxiety",1,0,0,0,1
"16837","hisaristocratic",1,0,0,0,1
"16838","hisarms",1,0,0,0,1
"16839","hisassociations",1,0,0,0,1
"16840","hisassumed",1,0,0,0,1
"16841","hisbadge",1,0,0,0,1
"16842","hisbearing",1,0,0,0,1
"16843","hisbehalf.others",1,0,0,0,1
"16844","hischild",1,0,0,0,1
"16845","hiscommands",1,0,0,0,1
"16846","hiscompanion.i",1,0,0,0,1
"16847","hisconduct",1,0,0,0,1
"16848","hiscoolly",1,0,0,0,1
"16849","hiscountenance",1,0,0,0,1
"16850","hiscountrymen",1,0,0,0,1
"16851","hiscruel",1,0,0,0,1
"16852","hiscruelty",1,0,0,0,1
"16853","hiscrutches",1,0,0,0,1
"16854","hisdaughter",1,0,0,0,1
"16855","hisdefeat",1,0,0,0,1
"16856","hisdefection",1,0,0,0,1
"16857","hisdispleasure",1,0,0,0,1
"16858","hiselegant",1,0,0,0,1
"16859","hisenslavement",1,0,0,0,1
"16860","hisescape",1,0,0,0,1
"16861","hisexample",1,0,0,0,1
"16862","hisexile",1,0,0,0,1
"16863","hisfamily",1,0,0,0,1
"16864","hisfather",1,0,0,0,1
"16865","hisfeet",1,0,0,0,1
"16866","hisfiendish",1,0,0,0,1
"16867","hisfierce",1,0,0,0,1
"16868","hisfirst",1,0,0,0,1
"16869","hisfrequent",1,0,0,0,1
"16870","hisfriends",1,0,0,0,1
"16871","hisgiving",1,0,0,0,1
"16872","hisground",1,0,0,0,1
"16873","hishand",1,0,0,0,1
"16874","hishigh",1,0,0,0,1
"16875","hisholy",1,0,0,0,1
"16876","hishorse",1,0,0,0,1
"16877","hishouse",1,0,0,0,1
"16878","hishumble",1,0,0,0,1
"16879","hishunger",1,0,0,0,1
"16880","hisideas",1,0,0,0,1
"16881","hiskind",1,0,0,0,1
"16882","hisland",1,0,0,0,1
"16883","hislectures",1,0,0,0,1
"16884","hismanagement",1,0,0,0,1
"16885","hismane",1,0,0,0,1
"16886","hismanhood",1,0,0,0,1
"16887","hismanner",1,0,0,0,1
"16888","hismaster’s",1,0,0,0,1
"16889","hismiddle",1,0,0,0,1
"16890","hismind",1,0,0,0,1
"16891","hismodest",1,0,0,0,1
"16892","hismoral",1,0,0,0,1
"16893","hisnative",1,0,0,0,1
"16894","hisoffer",1,0,0,0,1
"16895","hisold",1,0,0,0,1
"16896","hisoverseer",1,0,0,0,1
"16897","hispaper",1,0,0,0,1
"16898","hisperson",1,0,0,0,1
"16899","hispicture",1,0,0,0,1
"16900","hispiercing",1,0,0,0,1
"16901","hisplan",1,0,0,0,1
"16902","hispossession",1,0,0,0,1
"16903","hispresence",1,0,0,0,1
"16904","hisproclamation",1,0,0,0,1
"16905","hisprofanity",1,0,0,0,1
"16906","hisprofession",1,0,0,0,1
"16907","hisprompt",1,0,0,0,1
"16908","hisproperty",1,0,0,0,1
"16909","hispurchasers",1,0,0,0,1
"16910","hisreal",1,0,0,0,1
"16911","hisreligious",1,0,0,0,1
"16912","hisremedial",1,0,0,0,1
"16913","hisreproofs",1,0,0,0,1
"16914","hissecond",1,0,0,0,1
"16915","hissecretary",1,0,0,0,1
"16916","hisshoulders",1,0,0,0,1
"16917","hissight",1,0,0,0,1
"16918","hissing",1,0,0,0,1
"16919","hissister",1,0,0,0,1
"16920","hisslave",1,0,0,0,1
"16921","hisslaves",1,0,0,0,1
"16922","hissnakish",1,0,0,0,1
"16923","hissons",1,0,0,0,1
"16924","hisspeech",1,0,0,0,1
"16925","hisstatues",1,0,0,0,1
"16926","hissubject",1,0,0,0,1
"16927","histable",1,0,0,0,1
"16928","histeeth",1,0,0,0,1
"16929","histhen",1,0,0,0,1
"16930","histhreats",1,0,0,0,1
"16931","historic",1,0,0,0,1
"16932","historyis",1,0,0,0,1
"16933","histrail",1,0,0,0,1
"16934","histruth",1,0,0,0,1
"16935","hisutterances",1,0,0,0,1
"16936","hisweaknesses",1,0,0,0,1
"16937","hiswife",1,0,0,0,1
"16938","hiswisdom",1,0,0,0,1
"16939","hithertobeen",1,0,0,0,1
"16940","hitting",1,0,0,0,1
"16941","hitupon",1,0,0,0,1
"16942","hive",1,0,0,0,1
"16943","hoary",0,0,0,1,1
"16944","hodges",1,0,0,0,1
"16945","hoe_",0,1,0,0,1
"16946","hoeded",0,0,0,1,1
"16947","holda",1,0,0,0,1
"16948","holders",0,1,0,0,1
"16949","holdingthe",1,0,0,0,1
"16950","holdof",1,0,0,0,1
"16951","holdour",1,0,0,0,1
"16952","holdthem",1,0,0,0,1
"16953","holdthrough",1,0,0,0,1
"16954","holdupon",1,0,0,0,1
"16955","holeso",1,0,0,0,1
"16956","holiday’s",0,1,0,0,1
"16957","holidayswere",1,0,0,0,1
"16958","hollowness",0,0,0,1,1
"16959","hols",0,0,0,1,1
"16960","home.how",1,0,0,0,1
"16961","home.not",1,0,0,0,1
"16962","home.the",1,0,0,0,1
"16963","home.we",1,0,0,0,1
"16964","homeand",1,0,0,0,1
"16965","homeas",1,0,0,0,1
"16966","homeelsewhere",1,0,0,0,1
"16967","homein",1,0,0,0,1
"16968","homeliness",1,0,0,0,1
"16969","homely",1,0,0,0,1
"16970","homeof",1,0,0,0,1
"16971","homes.i",1,0,0,0,1
"16972","homes.my",1,0,0,0,1
"16973","homesaround",1,0,0,0,1
"16974","homewith",1,0,0,0,1
"16975","hominy.influenced",1,0,0,0,1
"16976","hon.gerrit",1,0,0,0,1
"16977","honestand",1,0,0,0,1
"16978","honestreasons",1,0,0,0,1
"16979","honorableas",1,0,0,0,1
"16980","honorablecharacter",1,0,0,0,1
"16981","honorably",1,0,0,0,1
"16982","honordone",1,0,0,0,1
"16983","honorto",1,0,0,0,1
"16984","hood’s",0,1,0,0,1
"16985","hooded",0,0,0,1,1
"16986","hopeand",1,0,0,0,1
"16987","hopei",1,0,0,0,1
"16988","hopenever",1,0,0,0,1
"16989","hopeto",1,0,0,0,1
"16990","hopkinsi",1,0,0,0,1
"16991","horacemann",1,0,0,0,1
"16992","horizon.i",1,0,0,0,1
"16993","horridoaths",1,0,0,0,1
"16994","horrorswrought",1,0,0,0,1
"16995","hospitable",1,0,0,0,1
"16996","hospitalitypracticed",1,0,0,0,1
"16997","hostages",1,0,0,0,1
"16998","hostagessky",1,0,0,0,1
"16999","hostileboys",1,0,0,0,1
"17000","hostilitytowards",1,0,0,0,1
"17001","hotashes",1,0,0,0,1
"17002","hotelin",1,0,0,0,1
"17003","hottestsummer",1,0,0,0,1
"17004","hour.friends",1,0,0,0,1
"17005","hour.its",1,0,0,0,1
"17006","hour.this",1,0,0,0,1
"17007","hourand",1,0,0,0,1
"17008","hourhad",1,0,0,0,1
"17009","house.especially",1,0,0,0,1
"17010","house.he",1,0,0,0,1
"17011","house.my",1,0,0,0,1
"17012","house.over",1,0,0,0,1
"17013","house.the",1,0,0,0,1
"17014","house.very",1,0,0,0,1
"17015","house.well",1,0,0,0,1
"17016","housea",1,0,0,0,1
"17017","housefarm",1,0,0,0,1
"17018","houseless",0,0,1,0,1
"17019","housenight",1,0,0,0,1
"17020","houseto",1,0,0,0,1
"17021","hovel",0,1,0,0,1
"17022","hovels",0,1,0,0,1
"17023","hover",0,0,1,0,1
"17024","howevergroundless",1,0,0,0,1
"17025","howeverwatched",1,0,0,0,1
"17026","howi",1,0,0,0,1
"17027","howittshad",1,0,0,0,1
"17028","howittwere",1,0,0,0,1
"17029","howl",1,0,0,0,1
"17030","howland’s",1,0,0,0,1
"17031","howled",1,0,0,0,1
"17032","howlingmob",1,0,0,0,1
"17033","howsoever",0,1,0,0,1
"17034","howunwillingly",1,0,0,0,1
"17035","hudsonriver",1,0,0,0,1
"17036","hug",0,0,1,0,1
"17037","hugethree",1,0,0,0,1
"17038","hughhave",1,0,0,0,1
"17039","hughnine",1,0,0,0,1
"17040","hughonly",1,0,0,0,1
"17041","hughreceived",1,0,0,0,1
"17042","hulda",1,0,0,0,1
"17043","hullo",1,0,0,0,1
"17044","humanchattels",1,0,0,0,1
"17045","humanethan",1,0,0,0,1
"17046","humanflesh",1,0,0,0,1
"17047","humanity.whilst",1,0,0,0,1
"17048","humanityin",1,0,0,0,1
"17049","humanizing",0,0,1,0,1
"17050","humbert",0,0,0,1,1
"17051","humblykneeling",1,0,0,0,1
"17052","humiliated",1,0,0,0,1
"17053","humiliatingterms",1,0,0,0,1
"17054","humiliatingto",1,0,0,0,1
"17055","humiliation",1,0,0,0,1
"17056","humiliation.it",1,0,0,0,1
"17057","humiliationthat",1,0,0,0,1
"17058","humorous",1,0,0,0,1
"17059","humphry",0,0,1,0,1
"17060","hundredbullets",1,0,0,0,1
"17061","hundredguests",1,0,0,0,1
"17062","hundredmen",1,0,0,0,1
"17063","hundredmiles",1,0,0,0,1
"17064","hungarian",0,1,0,0,1
"17065","hunger.sandy’s",1,0,0,0,1
"17066","hungerand",1,0,0,0,1
"17067","hunkers",0,1,0,0,1
"17068","hunter.the",1,0,0,0,1
"17069","huntersall",1,0,0,0,1
"17070","hunting.my",1,0,0,0,1
"17071","hurlburt",1,0,0,0,1
"17072","hurriedhim",1,0,0,0,1
"17073","hurries",0,1,0,0,1
"17074","hurtful",1,0,0,0,1
"17075","husband.before",1,0,0,0,1
"17076","husband’s",0,0,1,0,1
"17077","hutchinsonfamily",1,0,0,0,1
"17078","hutchinsons",1,0,0,0,1
"17079","hyatt",1,0,0,0,1
"17080","hyde",0,0,0,1,1
"17081","hydra",0,1,0,0,1
"17082","hydropathy",0,1,0,0,1
"17083","hyper",0,1,0,0,1
"17084","i.author’s",1,0,0,0,1
"17085","i.escape",1,0,0,0,1
"17086","i’llwarrant",1,0,0,0,1
"17087","i’ve",1,0,0,0,1
"17088","iaccompanied",1,0,0,0,1
"17089","iagain",1,0,0,0,1
"17090","ianswered",1,0,0,0,1
"17091","iargued",1,0,0,0,1
"17092","iasked",1,0,0,0,1
"17093","ibelieve",1,0,0,0,1
"17094","iborn",1,0,0,0,1
"17095","icannot",1,0,0,0,1
"17096","ice",0,1,0,0,1
"17097","iches",0,0,0,1,1
"17098","iconfess",1,0,0,0,1
"17099","iconsulted",1,0,0,0,1
"17100","idare",1,0,0,0,1
"17101","ideaof",1,0,0,0,1
"17102","ideemed",1,0,0,0,1
"17103","identical",0,1,0,0,1
"17104","identification",1,0,0,0,1
"17105","identifying",0,1,0,0,1
"17106","idler",0,1,0,0,1
"17107","idlers",0,0,0,1,1
"17108","idly",0,0,1,0,1
"17109","idols",0,1,0,0,1
"17110","ientered",1,0,0,0,1
"17111","iexpected",1,0,0,0,1
"17112","ifany",1,0,0,0,1
"17113","ifdefying",1,0,0,0,1
"17114","ifear",1,0,0,0,1
"17115","ifgoing",1,0,0,0,1
"17116","ifhe",1,0,0,0,1
"17117","ifi",1,0,0,0,1
"17118","ifin",1,0,0,0,1
"17119","ifit",1,0,0,0,1
"17120","ifmy",1,0,0,0,1
"17121","ifnot",1,0,0,0,1
"17122","ifonce",1,0,0,0,1
"17123","ifotherwise",1,0,0,0,1
"17124","ifreligion",1,0,0,0,1
"17125","ifthey",1,0,0,0,1
"17126","ifthis",1,0,0,0,1
"17127","ifwe",1,0,0,0,1
"17128","ifworse",1,0,0,0,1
"17129","igave",1,0,0,0,1
"17130","iget",1,0,0,0,1
"17131","ignoramus",1,0,0,0,1
"17132","ignorance.chapter",1,0,0,0,1
"17133","ignoranceand",1,0,0,0,1
"17134","ignorant.intelligence",1,0,0,0,1
"17135","ignoring",1,0,0,0,1
"17136","igo",1,0,0,0,1
"17137","igot",1,0,0,0,1
"17138","ihappened",1,0,0,0,1
"17139","ihold",1,0,0,0,1
"17140","ii.life",1,0,0,0,1
"17141","ii.removal",1,0,0,0,1
"17142","iii.introduced",1,0,0,0,1
"17143","iii.troubles",1,0,0,0,1
"17144","iinstantly",1,0,0,0,1
"17145","iintensely",1,0,0,0,1
"17146","ilaid",1,0,0,0,1
"17147","ileft",1,0,0,0,1
"17148","ilet",1,0,0,0,1
"17149","illegal",0,0,1,0,1
"17150","illegality",0,1,0,0,1
"17151","illiberality",0,0,1,0,1
"17152","illimitable",0,1,0,0,1
"17153","illiterate",0,1,0,0,1
"17154","illogical",1,0,0,0,1
"17155","illthe",1,0,0,0,1
"17156","illuminated",0,1,0,0,1
"17157","illumined",1,0,0,0,1
"17158","illusions",1,0,0,0,1
"17159","illustratethe",1,0,0,0,1
"17160","illustrative",0,1,0,0,1
"17161","illustrious.i",1,0,0,0,1
"17162","ilooked",1,0,0,0,1
"17163","ilost",1,0,0,0,1
"17164","iloved",1,0,0,0,1
"17165","imagenation",0,0,0,1,1
"17166","imagery",0,1,0,0,1
"17167","images",0,0,0,1,1
"17168","imaginewhat",1,0,0,0,1
"17169","imagining",0,1,0,0,1
"17170","imaginingof",1,0,0,0,1
"17171","imainly",1,0,0,0,1
"17172","imay",1,0,0,0,1
"17173","imbrute",0,1,0,0,1
"17174","imet",1,0,0,0,1
"17175","imight",1,0,0,0,1
"17176","imitatedthe",1,0,0,0,1
"17177","imitates",0,1,0,0,1
"17178","imitator",0,0,1,0,1
"17179","immediatelysummoned",1,0,0,0,1
"17180","immediatelyto",1,0,0,0,1
"17181","immediateuse",1,0,0,0,1
"17182","immense.during",1,0,0,0,1
"17183","immense.in",1,0,0,0,1
"17184","immense.it",1,0,0,0,1
"17185","immensegain",1,0,0,0,1
"17186","immensely",0,1,0,0,1
"17187","immensily",0,0,0,1,1
"17188","imminentperil",1,0,0,0,1
"17189","immortality",0,1,0,0,1
"17190","immortalize",0,1,0,0,1
"17191","immovable.i",1,0,0,0,1
"17192","immoveable",0,1,0,0,1
"17193","immutable",0,0,1,0,1
"17194","imost",1,0,0,0,1
"17195","impared",0,0,0,1,1
"17196","impart.nor",1,0,0,0,1
"17197","impartment",0,1,0,0,1
"17198","impassioned",0,1,0,0,1
"17199","impatient",0,1,0,0,1
"17200","impeachment",1,0,0,0,1
"17201","impelled",0,1,0,0,1
"17202","impels",0,0,1,0,1
"17203","impenetrable",1,0,0,0,1
"17204","imperatively",1,0,0,0,1
"17205","imperfections",0,1,0,0,1
"17206","imperial",0,1,0,0,1
"17207","imperil",1,0,0,0,1
"17208","imperishable",1,0,0,0,1
"17209","impertinent",0,0,1,0,1
"17210","impiety",0,1,0,0,1
"17211","implement",0,1,0,0,1
"17212","implicate",0,1,0,0,1
"17213","implicated",1,0,0,0,1
"17214","implicitly",0,1,0,0,1
"17215","impliedly",1,0,0,0,1
"17216","implies",1,0,0,0,1
"17217","implore",0,1,0,0,1
"17218","implored",1,0,0,0,1
"17219","imploreprotection",1,0,0,0,1
"17220","imploring",1,0,0,0,1
"17221","imploringly",0,1,0,0,1
"17222","imployed",0,0,0,1,1
"17223","importanttruth",1,0,0,0,1
"17224","importunate",0,0,0,1,1
"17225","imposing.i",1,0,0,0,1
"17226","imposingan",1,0,0,0,1
"17227","imposingly",0,0,0,1,1
"17228","impossibility",0,0,1,0,1
"17229","impossible.a",1,0,0,0,1
"17230","impossible.he",1,0,0,0,1
"17231","impossible.the",1,0,0,0,1
"17232","impossiblethat",1,0,0,0,1
"17233","impotency",1,0,0,0,1
"17234","impotent",0,1,0,0,1
"17235","impracticability",1,0,0,0,1
"17236","impregnate",0,1,0,0,1
"17237","impressions.speaking",1,0,0,0,1
"17238","impressiveadvocates",1,0,0,0,1
"17239","impressivecircumstances",1,0,0,0,1
"17240","impressme",1,0,0,0,1
"17241","impressthe",1,0,0,0,1
"17242","imprints",0,1,0,0,1
"17243","improper",0,0,1,0,1
"17244","improvedcondition",1,0,0,0,1
"17245","improvement.hard",1,0,0,0,1
"17246","improvementand",1,0,0,0,1
"17247","improvements",0,0,0,1,1
"17248","improvements.the",1,0,0,0,1
"17249","improvementsas",1,0,0,0,1
"17250","improvisedas",1,0,0,0,1
"17251","improvises",0,1,0,0,1
"17252","improvising",0,1,0,0,1
"17253","imprudence",1,0,0,0,1
"17254","imprudent",0,0,1,0,1
"17255","impsin",1,0,0,0,1
"17256","impudentlyasking",1,0,0,0,1
"17257","impulses",1,0,0,0,1
"17258","imputed",1,0,0,0,1
"17259","imust",1,0,0,0,1
"17260","in_fact_",1,0,0,0,1
"17261","inabhorring",1,0,0,0,1
"17262","inaccord",1,0,0,0,1
"17263","inactionand",1,0,0,0,1
"17264","inactivity",1,0,0,0,1
"17265","inadmissible",1,0,0,0,1
"17266","inalabama",1,0,0,0,1
"17267","inalienable",0,1,0,0,1
"17268","inamazement",1,0,0,0,1
"17269","inanimate",0,0,1,0,1
"17270","inapplicable",0,1,0,0,1
"17271","inaptly",1,0,0,0,1
"17272","inattaining",1,0,0,0,1
"17273","inauguraladdress",1,0,0,0,1
"17274","inaugurate",0,1,0,0,1
"17275","inauguratedchief",1,0,0,0,1
"17276","inaugurationin",1,0,0,0,1
"17277","inbed",1,0,0,0,1
"17278","inboston",1,0,0,0,1
"17279","inbrutal",1,0,0,0,1
"17280","incantations",0,0,0,1,1
"17281","incapacity",1,0,0,0,1
"17282","incaptain",1,0,0,0,1
"17283","incarnation",0,1,0,0,1
"17284","incarrying",1,0,0,0,1
"17285","incash",1,0,0,0,1
"17286","incensedagainst",1,0,0,0,1
"17287","incentivewhich",1,0,0,0,1
"17288","incessantly",0,1,0,0,1
"17289","incest",0,0,1,0,1
"17290","incidentapparently",1,0,0,0,1
"17291","incidents.in",1,0,0,0,1
"17292","incidents.prepared",1,0,0,0,1
"17293","incidentsconnected",1,0,0,0,1
"17294","inciting",1,0,0,0,1
"17295","inclinations",1,0,0,0,1
"17296","inclinedto",1,0,0,0,1
"17297","inclosure",0,1,0,0,1
"17298","include",0,1,0,0,1
"17299","incollecting",1,0,0,0,1
"17300","incommand",1,0,0,0,1
"17301","incommon",1,0,0,0,1
"17302","incomparable",0,1,0,0,1
"17303","incomprehensibility",1,0,0,0,1
"17304","incomprehensible",0,1,0,0,1
"17305","inconclusion",1,0,0,0,1
"17306","incongress",1,0,0,0,1
"17307","incongruities",0,1,0,0,1
"17308","incongruous",0,1,0,0,1
"17309","inconsequence",1,0,0,0,1
"17310","inconsistency",0,0,1,0,1
"17311","inconsulting",1,0,0,0,1
"17312","incontemplating",1,0,0,0,1
"17313","incontinently",0,1,0,0,1
"17314","inconvenience",1,0,0,0,1
"17315","inconvenient",0,1,0,0,1
"17316","inconveniently",0,1,0,0,1
"17317","incredibly",1,0,0,0,1
"17318","incredulity",0,0,1,0,1
"17319","incredulous",0,0,1,0,1
"17320","incrustation",0,1,0,0,1
"17321","inculpating",1,0,0,0,1
"17322","incurable",1,0,0,0,1
"17323","ind",0,0,0,1,1
"17324","indealing",1,0,0,0,1
"17325","indeed.so",1,0,0,0,1
"17326","indeeda",1,0,0,0,1
"17327","indeedall",1,0,0,0,1
"17328","indeepening",1,0,0,0,1
"17329","indefinite",0,1,0,0,1
"17330","indefinitely",0,0,0,1,1
"17331","indelicacy",1,0,0,0,1
"17332","indenunciation",1,0,0,0,1
"17333","independenceon",1,0,0,0,1
"17334","indescribably",0,1,0,0,1
"17335","index",1,0,0,0,1
"17336","indieswas",1,0,0,0,1
"17337","indifferent.of",1,0,0,0,1
"17338","indifferentto",1,0,0,0,1
"17339","indignatory",0,1,0,0,1
"17340","indignity.this",1,0,0,0,1
"17341","indirectly",0,1,0,0,1
"17342","indiscretion",1,0,0,0,1
"17343","indiscriminate",1,0,0,0,1
"17344","indispensably",0,1,0,0,1
"17345","indisposition",1,0,0,0,1
"17346","indisputable",1,0,0,0,1
"17347","individuallyand",1,0,0,0,1
"17348","individualproperty",1,0,0,0,1
"17349","indrawing",1,0,0,0,1
"17350","inducedby",1,0,0,0,1
"17351","inducedto",1,0,0,0,1
"17352","inducements",1,0,0,0,1
"17353","inducethe",1,0,0,0,1
"17354","inducing",0,1,0,0,1
"17355","induction",0,1,0,0,1
"17356","industrialschool",1,0,0,0,1
"17357","industries",1,0,0,0,1
"17358","industrious.she",1,0,0,0,1
"17359","ineffaceable",0,1,0,0,1
"17360","ineffaceablystamped",1,0,0,0,1
"17361","inefficient",0,1,0,0,1
"17362","inemphatic",1,0,0,0,1
"17363","inequality",0,1,0,0,1
"17364","inequalitywas",1,0,0,0,1
"17365","ineurope",1,0,0,0,1
"17366","inevery",1,0,0,0,1
"17367","inexcusable",0,1,0,0,1
"17368","inexhaustible",1,0,0,0,1
"17369","inexorable",0,1,0,0,1
"17370","inextricable",0,1,0,0,1
"17371","infact",1,0,0,0,1
"17372","infallible",0,1,0,0,1
"17373","infamously",1,0,0,0,1
"17374","infatuation",1,0,0,0,1
"17375","infected",1,0,0,0,1
"17376","inference",1,0,0,0,1
"17377","inferiors",0,1,0,0,1
"17378","infest",0,1,0,0,1
"17379","infidelity",0,1,0,0,1
"17380","infidels",0,1,0,0,1
"17381","infinding",1,0,0,0,1
"17382","infirmities",0,1,0,0,1
"17383","inflame",1,0,0,0,1
"17384","inflated",1,0,0,0,1
"17385","inflictan",1,0,0,0,1
"17386","influence.for",1,0,0,0,1
"17387","influencemet",1,0,0,0,1
"17388","influenceof",1,0,0,0,1
"17389","influencewas",1,0,0,0,1
"17390","influencewhich",1,0,0,0,1
"17391","inforce",1,0,0,0,1
"17392","informer",1,0,0,0,1
"17393","infriendly",1,0,0,0,1
"17394","infront",1,0,0,0,1
"17395","infusea",1,0,0,0,1
"17396","ingardiner’s",1,0,0,0,1
"17397","ingold",1,0,0,0,1
"17398","ingood",1,0,0,0,1
"17399","ingorsol",0,0,0,1,1
"17400","ingreat",1,0,0,0,1
"17401","inhabit",0,1,0,0,1
"17402","inhabitant",1,0,0,0,1
"17403","inhabiting",0,1,0,0,1
"17404","inhale",0,1,0,0,1
"17405","inharnessing",1,0,0,0,1
"17406","inhaving",1,0,0,0,1
"17407","inher",1,0,0,0,1
"17408","inhim",1,0,0,0,1
"17409","inholding",1,0,0,0,1
"17410","inhumanenactment",1,0,0,0,1
"17411","inhumanityof",1,0,0,0,1
"17412","inimical",1,0,0,0,1
"17413","inindiana",1,0,0,0,1
"17414","ininducing",1,0,0,0,1
"17415","ininfluential",1,0,0,0,1
"17416","initiate",1,0,0,0,1
"17417","injured.but",1,0,0,0,1
"17418","injuringhim",1,0,0,0,1
"17419","injury",1,0,0,0,1
"17420","injuryof",1,0,0,0,1
"17421","injustice.eight",1,0,0,0,1
"17422","inkansas",1,0,0,0,1
"17423","inkeeping",1,0,0,0,1
"17424","inlarge",1,0,0,0,1
"17425","inlearning",1,0,0,0,1
"17426","inlondon",1,0,0,0,1
"17427","inlooking",1,0,0,0,1
"17428","inmaking",1,0,0,0,1
"17429","inmaryland",1,0,0,0,1
"17430","inmassachusetts",1,0,0,0,1
"17431","inme",1,0,0,0,1
"17432","inmeeting",1,0,0,0,1
"17433","inmilitary",1,0,0,0,1
"17434","inmotion",1,0,0,0,1
"17435","innantucket",1,0,0,0,1
"17436","innecessary",1,0,0,0,1
"17437","innew",1,0,0,0,1
"17438","inno",1,0,0,0,1
"17439","innocentjoy",1,0,0,0,1
"17440","innovation",1,0,0,0,1
"17441","inofficial",1,0,0,0,1
"17442","inon",1,0,0,0,1
"17443","inone",1,0,0,0,1
"17444","inopportune",1,0,0,0,1
"17445","inow",1,0,0,0,1
"17446","inox",1,0,0,0,1
"17447","inparker",1,0,0,0,1
"17448","inperceiving",1,0,0,0,1
"17449","inplace",1,0,0,0,1
"17450","inpork",1,0,0,0,1
"17451","inpractice",1,0,0,0,1
"17452","inprestige",1,0,0,0,1
"17453","inprocuring",1,0,0,0,1
"17454","inprofusion",1,0,0,0,1
"17455","inquiriesas",1,0,0,0,1
"17456","inquistion",0,0,0,1,1
"17457","inrebellion",1,0,0,0,1
"17458","inreligious",1,0,0,0,1
"17459","inreserve",1,0,0,0,1
"17460","inrespect",1,0,0,0,1
"17461","inreturn",1,0,0,0,1
"17462","inroasting",1,0,0,0,1
"17463","insatiable",1,0,0,0,1
"17464","inscribe",0,0,1,0,1
"17465","insect.happily",1,0,0,0,1
"17466","insensibleto",1,0,0,0,1
"17467","insincere",0,0,0,1,1
"17468","insinuations",1,0,0,0,1
"17469","insist",0,0,1,0,1
"17470","insistedthat",1,0,0,0,1
"17471","insisting",1,0,0,0,1
"17472","insolence",0,1,0,0,1
"17473","insolentnegro",1,0,0,0,1
"17474","insolvency",1,0,0,0,1
"17475","insolvent",1,0,0,0,1
"17476","insome",1,0,0,0,1
"17477","inst",1,0,0,0,1
"17478","instanti",1,0,0,0,1
"17479","instead",0,0,0,1,1
"17480","insteadof",1,0,0,0,1
"17481","instigatorof",1,0,0,0,1
"17482","instigators",1,0,0,0,1
"17483","instinctsor",1,0,0,0,1
"17484","instituted.war",1,0,0,0,1
"17485","institution_",0,0,1,0,1
"17486","institutionhad",1,0,0,0,1
"17487","institutions_",0,1,0,0,1
"17488","instore",1,0,0,0,1
"17489","instrength",1,0,0,0,1
"17490","instrumentwe",1,0,0,0,1
"17491","insubordination",1,0,0,0,1
"17492","insuch",1,0,0,0,1
"17493","insufferableresults",1,0,0,0,1
"17494","insufficiency",1,0,0,0,1
"17495","insufficiently",1,0,0,0,1
"17496","insultedand",1,0,0,0,1
"17497","insultswere",1,0,0,0,1
"17498","insurrectionary",0,1,0,0,1
"17499","insurrections",0,1,0,0,1
"17500","intact",1,0,0,0,1
"17501","intalbot",1,0,0,0,1
"17502","inteaching",1,0,0,0,1
"17503","integrityof",1,0,0,0,1
"17504","intellection",0,1,0,0,1
"17505","intellectlanguished",1,0,0,0,1
"17506","intellectualendowments",1,0,0,0,1
"17507","intelligible",0,1,0,0,1
"17508","intemated",0,0,0,1,1
"17509","intemperance.slaves",1,0,0,0,1
"17510","intendeddeparture",1,0,0,0,1
"17511","intendedto",1,0,0,0,1
"17512","intendingto",1,0,0,0,1
"17513","intends",0,1,0,0,1
"17514","intenseand",1,0,0,0,1
"17515","intensebereavement",1,0,0,0,1
"17516","intensedesire",1,0,0,0,1
"17517","intenselyferocious",1,0,0,0,1
"17518","intensity",1,0,0,0,1
"17519","intentional",1,0,0,0,1
"17520","intentlyas",1,0,0,0,1
"17521","intercepted",0,0,1,0,1
"17522","intereor",0,0,0,1,1
"17523","interestedas",1,0,0,0,1
"17524","interestin",1,0,0,0,1
"17525","interestingone",1,0,0,0,1
"17526","interestingperiod",1,0,0,0,1
"17527","interestingto",1,0,0,0,1
"17528","interests",0,0,0,1,1
"17529","interestwas",1,0,0,0,1
"17530","interjection",0,0,0,1,1
"17531","interlinked",0,0,1,0,1
"17532","intermeddlers",1,0,0,0,1
"17533","interminable",1,0,0,0,1
"17534","interned",0,0,0,1,1
"17535","interred",0,0,0,1,1
"17536","interrogate",1,0,0,0,1
"17537","interrupt",1,0,0,0,1
"17538","interrupted",1,0,0,0,1
"17539","interrupting",1,0,0,0,1
"17540","interruptionfrom",1,0,0,0,1
"17541","intervention",0,1,0,0,1
"17542","interview.it",1,0,0,0,1
"17543","interviews",1,0,0,0,1
"17544","interwoven",0,1,0,0,1
"17545","inthese",1,0,0,0,1
"17546","intimateacquaintance",1,0,0,0,1
"17547","intimations",1,0,0,0,1
"17548","intimidation",1,0,0,0,1
"17549","intoconsideration",1,0,0,0,1
"17550","intohis",1,0,0,0,1
"17551","intoits",1,0,0,0,1
"17552","intolerableburden",1,0,0,0,1
"17553","intolerableby",1,0,0,0,1
"17554","intolerablygreater",1,0,0,0,1
"17555","intopractical",1,0,0,0,1
"17556","intoprison",1,0,0,0,1
"17557","intothree",1,0,0,0,1
"17558","intouse",1,0,0,0,1
"17559","intowhose",1,0,0,0,1
"17560","intractable",0,1,0,0,1
"17561","intractableof",1,0,0,0,1
"17562","intraveling",1,0,0,0,1
"17563","intrenchments",1,0,0,0,1
"17564","introdnced",0,0,0,1,1
"17565","introducingthe",1,0,0,0,1
"17566","introductions",1,0,0,0,1
"17567","intuitive",0,1,0,0,1
"17568","inured",1,0,0,0,1
"17569","inurging",1,0,0,0,1
"17570","invade",0,1,0,0,1
"17571","invaded",1,0,0,0,1
"17572","invain",1,0,0,0,1
"17573","invalidated",0,1,0,0,1
"17574","invaluable",0,0,1,0,1
"17575","invasions",0,1,0,0,1
"17576","inventedby",1,0,0,0,1
"17577","inventing",0,1,0,0,1
"17578","inventionto",1,0,0,0,1
"17579","inventors",1,0,0,0,1
"17580","investigating",1,0,0,0,1
"17581","investigatingcommittee",1,0,0,0,1
"17582","investment",1,0,0,0,1
"17583","inview",1,0,0,0,1
"17584","invisiblespirits",1,0,0,0,1
"17585","invitationgiven",1,0,0,0,1
"17586","invitations",1,0,0,0,1
"17587","invitationto",1,0,0,0,1
"17588","invited.outside",1,0,0,0,1
"17589","inviteddoctors",1,0,0,0,1
"17590","invitedme",1,0,0,0,1
"17591","invitesthe",1,0,0,0,1
"17592","invitinghim",1,0,0,0,1
"17593","invitingthe",1,0,0,0,1
"17594","involvethe",1,0,0,0,1
"17595","inwalking",1,0,0,0,1
"17596","inwardly",1,0,0,0,1
"17597","inwhat",1,0,0,0,1
"17598","inwhispers",1,0,0,0,1
"17599","iobeyed",1,0,0,0,1
"17600","iobserved",1,0,0,0,1
"17601","ionly",1,0,0,0,1
"17602","ipicked",1,0,0,0,1
"17603","iplace",1,0,0,0,1
"17604","ipossessed",1,0,0,0,1
"17605","ira",0,1,0,0,1
"17606","ireally",1,0,0,0,1
"17607","irefer",1,0,0,0,1
"17608","iregret",1,0,0,0,1
"17609","ireland.debate",1,0,0,0,1
"17610","irelandwithin",1,0,0,0,1
"17611","iremained",1,0,0,0,1
"17612","ireson",1,0,0,0,1
"17613","ireturned",1,0,0,0,1
"17614","ireview",1,0,0,0,1
"17615","irishmenunloading",1,0,0,0,1
"17616","ironedbandana",1,0,0,0,1
"17617","ironlike",0,1,0,0,1
"17618","irrational",0,1,0,0,1
"17619","irreconcilable.in",1,0,0,0,1
"17620","irrefutable",0,1,0,0,1
"17621","irrespective",1,0,0,0,1
"17622","isaac’s",0,1,0,0,1
"17623","isaacand",1,0,0,0,1
"17624","isaact",1,0,0,0,1
"17625","isabella",0,0,0,1,1
"17626","isaiah",1,0,0,0,1
"17627","isalways",1,0,0,0,1
"17628","iscalled",1,0,0,0,1
"17629","isclear",1,0,0,0,1
"17630","isconcerned",1,0,0,0,1
"17631","isdone",1,0,0,0,1
"17632","iseducated",1,0,0,0,1
"17633","iseemed",1,0,0,0,1
"17634","iseldom",1,0,0,0,1
"17635","isfor",1,0,0,0,1
"17636","isfurnished",1,0,0,0,1
"17637","isgoverned",1,0,0,0,1
"17638","isgrateful",1,0,0,0,1
"17639","ishowed",1,0,0,0,1
"17640","isit",1,0,0,0,1
"17641","island.when",1,0,0,0,1
"17642","islands",0,1,0,0,1
"17643","ismaila",0,0,0,1,1
"17644","ismuch",1,0,0,0,1
"17645","isnecessary",1,0,0,0,1
"17646","ison",1,0,0,0,1
"17647","ispoke",1,0,0,0,1
"17648","ispractically",1,0,0,0,1
"17649","isprecious",1,0,0,0,1
"17650","israel’s",0,0,1,0,1
"17651","israelitish",1,0,0,0,1
"17652","isreported",1,0,0,0,1
"17653","issac",0,1,0,0,1
"17654","isseldom",1,0,0,0,1
"17655","issick",1,0,0,0,1
"17656","issupposed",1,0,0,0,1
"17657","istheir",1,0,0,0,1
"17658","isvery",1,0,0,0,1
"17659","isvindicated",1,0,0,0,1
"17660","iswith",1,0,0,0,1
"17661","isworth",1,0,0,0,1
"17662","it.among",1,0,0,0,1
"17663","it.both",1,0,0,0,1
"17664","it.capt",1,0,0,0,1
"17665","it.first",1,0,0,0,1
"17666","it.i",1,0,0,0,1
"17667","it.in",1,0,0,0,1
"17668","it.the",1,0,0,0,1
"17669","it.when",1,0,0,0,1
"17670","itabandoned.becoming",1,0,0,0,1
"17671","italarmed",1,0,0,0,1
"17672","italian",0,0,0,1,1
"17673","italics",0,0,1,0,1
"17674","italive",1,0,0,0,1
"17675","itand",1,0,0,0,1
"17676","itas",1,0,0,0,1
"17677","itback.when",1,0,0,0,1
"17678","itbeing",1,0,0,0,1
"17679","itbut",1,0,0,0,1
"17680","itcan",1,0,0,0,1
"17681","itcomes",1,0,0,0,1
"17682","itconsisted",1,0,0,0,1
"17683","itdid",1,0,0,0,1
"17684","itdifficult",1,0,0,0,1
"17685","items",1,0,0,0,1
"17686","itfrom",1,0,0,0,1
"17687","itgave",1,0,0,0,1
"17688","itgives",1,0,0,0,1
"17689","itgoes",1,0,0,0,1
"17690","ithen",1,0,0,0,1
"17691","ithis",1,0,0,0,1
"17692","itin",1,0,0,0,1
"17693","itknown",1,0,0,0,1
"17694","itmade",1,0,0,0,1
"17695","itmight",1,0,0,0,1
"17696","itmust",1,0,0,0,1
"17697","itnecessary",1,0,0,0,1
"17698","itnever",1,0,0,0,1
"17699","itoiled",1,0,0,0,1
"17700","iton",1,0,0,0,1
"17701","itore",1,0,0,0,1
"17702","itout",1,0,0,0,1
"17703","itpurported",1,0,0,0,1
"17704","itrust",1,0,0,0,1
"17705","itsaccomplishment.those",1,0,0,0,1
"17706","itsaction",1,0,0,0,1
"17707","itsadoption",1,0,0,0,1
"17708","itsadvanced",1,0,0,0,1
"17709","itsample",1,0,0,0,1
"17710","itsattendants",1,0,0,0,1
"17711","itsaugust",1,0,0,0,1
"17712","itsbearer",1,0,0,0,1
"17713","itsbitter",1,0,0,0,1
"17714","itsborders",1,0,0,0,1
"17715","itscommand",1,0,0,0,1
"17716","itscut",1,0,0,0,1
"17717","itsdeadly",1,0,0,0,1
"17718","itsdeparture",1,0,0,0,1
"17719","itsdepositors",1,0,0,0,1
"17720","itsdesolating",1,0,0,0,1
"17721","itself_",0,1,0,0,1
"17722","itself.the",1,0,0,0,1
"17723","itself.this",1,0,0,0,1
"17724","itselfwas",1,0,0,0,1
"17725","itsextinction",1,0,0,0,1
"17726","itsfavor",1,0,0,0,1
"17727","itsflourishing",1,0,0,0,1
"17728","itsfruit",1,0,0,0,1
"17729","itshall",1,0,0,0,1
"17730","itshands",1,0,0,0,1
"17731","itsheavy",1,0,0,0,1
"17732","itsheltered",1,0,0,0,1
"17733","itsinhabitants",1,0,0,0,1
"17734","itsisolation",1,0,0,0,1
"17735","itsletter",1,0,0,0,1
"17736","itsliabilities",1,0,0,0,1
"17737","itsmanagement",1,0,0,0,1
"17738","itsmeans",1,0,0,0,1
"17739","itsmomentous",1,0,0,0,1
"17740","itsmultifarious",1,0,0,0,1
"17741","itsmurderous",1,0,0,0,1
"17742","itsoccupants",1,0,0,0,1
"17743","itsold",1,0,0,0,1
"17744","itspeople",1,0,0,0,1
"17745","itspresence.i",1,0,0,0,1
"17746","itsprobable",1,0,0,0,1
"17747","itsradicalism",1,0,0,0,1
"17748","itssound",1,0,0,0,1
"17749","itssuccess.the",1,0,0,0,1
"17750","itssunbeams.among",1,0,0,0,1
"17751","itstopmost",1,0,0,0,1
"17752","itstowering",1,0,0,0,1
"17753","itsvery",1,0,0,0,1
"17754","itsweeping",1,0,0,0,1
"17755","itswhite",1,0,0,0,1
"17756","itthat",1,0,0,0,1
"17757","itthundered",1,0,0,0,1
"17758","ittouched",1,0,0,0,1
"17759","itwith",1,0,0,0,1
"17760","itwore",1,0,0,0,1
"17761","itwould",1,0,0,0,1
"17762","iv.a",1,0,0,0,1
"17763","iv.recollections",1,0,0,0,1
"17764","iventured",1,0,0,0,1
"17765","ivy",1,0,0,0,1
"17766","iwalked",1,0,0,0,1
"17767","iwant",1,0,0,0,1
"17768","iwent",1,0,0,0,1
"17769","iwish",1,0,0,0,1
"17770","iworked",1,0,0,0,1
"17771","ix.change",1,0,0,0,1
"17772","ix.increasing",1,0,0,0,1
"17773","j.may",1,0,0,0,1
"17774","jack’s",0,1,0,0,1
"17775","jacks",0,1,0,0,1
"17776","jail.once",1,0,0,0,1
"17777","jailmaster",1,0,0,0,1
"17778","jaketold",1,0,0,0,1
"17779","jamaica",1,0,0,0,1
"17780","jamesbeacham",1,0,0,0,1
"17781","jamesmonroe",1,0,0,0,1
"17782","jane",1,0,0,0,1
"17783","janes",1,0,0,0,1
"17784","janu",0,0,0,1,1
"17785","jarred",0,1,0,0,1
"17786","jarredmy",1,0,0,0,1
"17787","jarring",0,1,0,0,1
"17788","jars",0,0,0,1,1
"17789","jeff",1,0,0,0,1
"17790","jehial",1,0,0,0,1
"17791","jehovah",1,0,0,0,1
"17792","jennieran",1,0,0,0,1
"17793","jenny",0,1,0,0,1
"17794","jeopardy",1,0,0,0,1
"17795","jeremiah",1,0,0,0,1
"17796","jests",1,0,0,0,1
"17797","jew",1,0,0,0,1
"17798","jewelled",0,0,0,1,1
"17799","jewish",0,0,0,1,1
"17800","jews",1,0,0,0,1
"17801","jimcrow",1,0,0,0,1
"17802","jims",0,1,0,0,1
"17803","jinny",0,1,0,0,1
"17804","jobbers",0,1,0,0,1
"17805","jockey",1,0,0,0,1
"17806","joe",0,0,0,1,1
"17807","john.this",1,0,0,0,1
"17808","johna",1,0,0,0,1
"17809","johnbrown’s",1,0,0,0,1
"17810","johnc",1,0,0,0,1
"17811","johnharris",1,0,0,0,1
"17812","johnm",1,0,0,0,1
"17813","johnminer",1,0,0,0,1
"17814","johnrussell",1,0,0,0,1
"17815","johns",0,0,0,1,1
"17816","johnsherman",1,0,0,0,1
"17817","johnsonassured",1,0,0,0,1
"17818","johnsonon",1,0,0,0,1
"17819","johnsonwas",1,0,0,0,1
"17820","johnston",1,0,0,0,1
"17821","johnthe",1,0,0,0,1
"17822","johnwas",1,0,0,0,1
"17823","joke",0,1,0,0,1
"17824","joke.he",1,0,0,0,1
"17825","jonah",0,1,0,0,1
"17826","jonahof",1,0,0,0,1
"17827","jonathan",1,0,0,0,1
"17828","jonathanbuffum",1,0,0,0,1
"17829","jonathanbuffum’s",1,0,0,0,1
"17830","joshuar",1,0,0,0,1
"17831","jostle",1,0,0,0,1
"17832","jostling",0,0,0,1,1
"17833","jot",1,0,0,0,1
"17834","journal_",0,1,0,0,1
"17835","journey.once",1,0,0,0,1
"17836","journeying",1,0,0,0,1
"17837","journeymencalkers",1,0,0,0,1
"17838","journeys",0,0,1,0,1
"17839","journeytoward",1,0,0,0,1
"17840","joy.on",1,0,0,0,1
"17841","joymy",1,0,0,0,1
"17842","jubilant",0,1,0,0,1
"17843","judas",0,1,0,0,1
"17844","judgedthat",1,0,0,0,1
"17845","judgment.the",1,0,0,0,1
"17846","judson",1,0,0,0,1
"17847","juicy",0,1,0,0,1
"17848","julia",1,0,0,0,1
"17849","juliagriffiths",1,0,0,0,1
"17850","jumpdown",1,0,0,0,1
"17851","jumping",0,0,0,1,1
"17852","jungles",1,0,0,0,1
"17853","jupiter",0,0,0,1,1
"17854","jurors",1,0,0,0,1
"17855","juryman",1,0,0,0,1
"17856","jurymen",1,0,0,0,1
"17857","just_",0,1,0,0,1
"17858","justafter",1,0,0,0,1
"17859","justbeen",1,0,0,0,1
"17860","justfy",0,1,0,0,1
"17861","justice.while",1,0,0,0,1
"17862","justicedone",1,0,0,0,1
"17863","justiceinto",1,0,0,0,1
"17864","justideas",1,0,0,0,1
"17865","justmentioned",1,0,0,0,1
"17866","justreferred",1,0,0,0,1
"17867","justto",1,0,0,0,1
"17868","justwhat",1,0,0,0,1
"17869","katy.capt",1,0,0,0,1
"17870","keat",1,0,0,0,1
"17871","keenest",0,1,0,0,1
"17872","keenobserver",1,0,0,0,1
"17873","keepingaway",1,0,0,0,1
"17874","keepingmen",1,0,0,0,1
"17875","keepingup",1,0,0,0,1
"17876","keepit",1,0,0,0,1
"17877","kelleywas",1,0,0,0,1
"17878","keltons",1,0,0,0,1
"17879","kemp’s",0,0,1,0,1
"17880","kent",0,1,0,0,1
"17881","kentuckians",1,0,0,0,1
"17882","kentucky.in",1,0,0,0,1
"17883","kenyon",1,0,0,0,1
"17884","kept.chapter",1,0,0,0,1
"17885","keptholy",1,0,0,0,1
"17886","keptonly",1,0,0,0,1
"17887","key.this",1,0,0,0,1
"17888","keystone",0,1,0,0,1
"17889","kickingcolored",1,0,0,0,1
"17890","kidnap",0,0,1,0,1
"17891","kidnapper",0,0,1,0,1
"17892","kidnapper’s",0,0,1,0,1
"17893","kidnapperswho",1,0,0,0,1
"17894","killhim",1,0,0,0,1
"17895","kills",0,1,0,0,1
"17896","killthe",1,0,0,0,1
"17897","kind_",1,0,0,0,1
"17898","kindand",1,0,0,0,1
"17899","kindattention",1,0,0,0,1
"17900","kinder",0,0,1,0,1
"17901","kindest",0,0,1,0,1
"17902","kindliness",0,0,1,0,1
"17903","kindly.a",1,0,0,0,1
"17904","kindlyas",1,0,0,0,1
"17905","kindlyby",1,0,0,0,1
"17906","kindlyreceived",1,0,0,0,1
"17907","kindnesses",1,0,0,0,1
"17908","kindreaders",1,0,0,0,1
"17909","kingly",0,0,0,1,1
"17910","kings",0,0,0,1,1
"17911","kinney",0,1,0,0,1
"17912","kinsfolk",1,0,0,0,1
"17913","kinsman",1,0,0,0,1
"17914","kinsmone",0,0,0,1,1
"17915","kiss",1,0,0,0,1
"17916","kissed",1,0,0,0,1
"17917","kissid",0,0,0,1,1
"17918","kneeled",1,0,0,0,1
"17919","knelt",0,1,0,0,1
"17920","knew",0,0,0,1,1
"17921","knewabraham",1,0,0,0,1
"17922","knewand",1,0,0,0,1
"17923","knewhow",1,0,0,0,1
"17924","knewtoo",1,0,0,0,1
"17925","knibb",1,0,0,0,1
"17926","knit",1,0,0,0,1
"17927","knitting",0,1,0,0,1
"17928","knoton",1,0,0,0,1
"17929","knotted",0,1,0,0,1
"17930","knoweth",0,0,1,0,1
"17931","knoweverything",1,0,0,0,1
"17932","knowexactly",1,0,0,0,1
"17933","knowhim",1,0,0,0,1
"17934","knowingthis",1,0,0,0,1
"17935","knowledge.fellow",1,0,0,0,1
"17936","knowledgeof",1,0,0,0,1
"17937","knowledgeunder",1,0,0,0,1
"17938","knowmr",1,0,0,0,1
"17939","knowno",1,0,0,0,1
"17940","knownthereafter",1,0,0,0,1
"17941","knowsenough",1,0,0,0,1
"17942","knowthat",1,0,0,0,1
"17943","knowthe",1,0,0,0,1
"17944","knowthem",1,0,0,0,1
"17945","knowwell",1,0,0,0,1
"17946","knoxville",1,0,0,0,1
"17947","korall",0,0,0,1,1
"17948","l’outrance_",0,1,0,0,1
"17949","labelled",0,0,1,0,1
"17950","lable",0,0,0,1,1
"17951","laboredin",1,0,0,0,1
"17952","laboreri",1,0,0,0,1
"17953","laborers.in",1,0,0,0,1
"17954","laborfaithfully",1,0,0,0,1
"17955","laboringclasses",1,0,0,0,1
"17956","laboriously",1,0,0,0,1
"17957","laborof",1,0,0,0,1
"17958","labors.i",1,0,0,0,1
"17959","laborschool",1,0,0,0,1
"17960","laborto",1,0,0,0,1
"17961","labrador",1,0,0,0,1
"17962","lacerations",0,1,0,0,1
"17963","lads",0,1,0,0,1
"17964","ladswho",1,0,0,0,1
"17965","lady’s",1,0,0,0,1
"17966","lag",1,0,0,0,1
"17967","laidmyself",1,0,0,0,1
"17968","laidon",1,0,0,0,1
"17969","lamblike",0,0,1,0,1
"17970","lameand",1,0,0,0,1
"17971","lament",0,1,0,0,1
"17972","lamented",1,0,0,0,1
"17973","lamenting",0,1,0,0,1
"17974","lamest",0,1,0,0,1
"17975","lamp",1,0,0,0,1
"17976","lancaster",1,0,0,0,1
"17977","lance",0,1,0,0,1
"17978","land_",0,0,1,0,1
"17979","land.considering",1,0,0,0,1
"17980","land.this",1,0,0,0,1
"17981","landas",1,0,0,0,1
"17982","landeast",1,0,0,0,1
"17983","landed.she",1,0,0,0,1
"17984","landingat",1,0,0,0,1
"17985","landless",1,0,0,0,1
"17986","lands.i",1,0,0,0,1
"17987","landscape",0,0,0,1,1
"17988","landslides",0,0,0,1,1
"17989","landwith",1,0,0,0,1
"17990","languor",0,1,0,0,1
"17991","laps",0,0,0,1,1
"17992","larder",1,0,0,0,1
"17993","largeaudience",1,0,0,0,1
"17994","largedegree",1,0,0,0,1
"17995","largeman",1,0,0,0,1
"17996","largermeasure",1,0,0,0,1
"17997","largerscale.as",1,0,0,0,1
"17998","largespace",1,0,0,0,1
"17999","largethe",1,0,0,0,1
"18000","largevote",1,0,0,0,1
"18001","lash.this",1,0,0,0,1
"18002","lashdid",1,0,0,0,1
"18003","lashedthe",1,0,0,0,1
"18004","lashing",0,0,1,0,1
"18005","lashscampered",1,0,0,0,1
"18006","lasted",1,0,0,0,1
"18007","lastlong",1,0,0,0,1
"18008","lasts",1,0,0,0,1
"18009","lasttime",1,0,0,0,1
"18010","late ",0,0,0,1,1
"18011","late_",0,1,0,0,1
"18012","latelypossessed",1,0,0,0,1
"18013","latepresident",1,0,0,0,1
"18014","latham",1,0,0,0,1
"18015","latter’s",0,1,0,0,1
"18016","latterbecame",1,0,0,0,1
"18017","latterhad",1,0,0,0,1
"18018","latterwritten",1,0,0,0,1
"18019","laugh.we",1,0,0,0,1
"18020","laughable",1,0,0,0,1
"18021","laught",0,0,0,1,1
"18022","laughter",0,0,0,1,1
"18023","lausanne",0,0,0,1,1
"18024","laut",1,0,0,0,1
"18025","lava",0,0,0,1,1
"18026","law.i",1,0,0,0,1
"18027","law.mr",1,0,0,0,1
"18028","law.my",1,0,0,0,1
"18029","lawenforced",1,0,0,0,1
"18030","lawof",1,0,0,0,1
"18031","lawrence",1,0,0,0,1
"18032","lawspassed",1,0,0,0,1
"18033","lawyer’s",1,0,0,0,1
"18034","lax",0,0,1,0,1
"18035","layers",0,1,0,0,1
"18036","lays",0,1,0,0,1
"18037","lazerrus",0,0,0,1,1
"18038","laziest",1,0,0,0,1
"18039","lead.on",1,0,0,0,1
"18040","leadersexpected",1,0,0,0,1
"18041","leadershipof",1,0,0,0,1
"18042","leadersthe",1,0,0,0,1
"18043","leadingnorthward",1,0,0,0,1
"18044","leadingrepublican",1,0,0,0,1
"18045","leadingto",1,0,0,0,1
"18046","league",1,0,0,0,1
"18047","leaning ",0,0,0,1,1
"18048","leaped",0,1,0,0,1
"18049","lear",1,0,0,0,1
"18050","learn.two",1,0,0,0,1
"18051","learnedafterwards",1,0,0,0,1
"18052","learnedthere",1,0,0,0,1
"18053","learnedto",1,0,0,0,1
"18054","learner",1,0,0,0,1
"18055","learnhis",1,0,0,0,1
"18056","learnsto",1,0,0,0,1
"18057","leas",0,1,0,0,1
"18058","lease",1,0,0,0,1
"18059","leased",0,1,0,0,1
"18060","leasure",0,0,0,1,1
"18061","leaveit",1,0,0,0,1
"18062","leavethe",1,0,0,0,1
"18063","lecture.i",1,0,0,0,1
"18064","lecturesbefore",1,0,0,0,1
"18065","ledger_",0,1,0,0,1
"18066","ledhim",1,0,0,0,1
"18067","ledme",1,0,0,0,1
"18068","lee’smill",1,0,0,0,1
"18069","leechild",1,0,0,0,1
"18070","leewere",1,0,0,0,1
"18071","leftthomas",1,0,0,0,1
"18072","legalized",0,0,1,0,1
"18073","legalizing",1,0,0,0,1
"18074","legion",0,1,0,0,1
"18075","legislate",1,0,0,0,1
"18076","legislative",1,0,0,0,1
"18077","legislator",1,0,0,0,1
"18078","legitimateobject",1,0,0,0,1
"18079","legless",1,0,0,0,1
"18080","lemoyne",1,0,0,0,1
"18081","lend",0,1,0,0,1
"18082","lender",1,0,0,0,1
"18083","lengthconsented",1,0,0,0,1
"18084","lengthened",1,0,0,0,1
"18085","leniency",1,0,0,0,1
"18086","lenore",0,0,0,1,1
"18087","lenox",0,0,1,0,1
"18088","lespenard",0,0,1,0,1
"18089","lespremonts",0,0,0,1,1
"18090","lessabhorrence",1,0,0,0,1
"18091","lessafford",1,0,0,0,1
"18092","lessattachment",1,0,0,0,1
"18093","lessened",0,1,0,0,1
"18094","lesser",1,0,0,0,1
"18095","lesseraffluence",1,0,0,0,1
"18096","lessfrequent.as",1,0,0,0,1
"18097","lessimportance",1,0,0,0,1
"18098","lessinterested",1,0,0,0,1
"18099","lessons.we",1,0,0,0,1
"18100","lessonto",1,0,0,0,1
"18101","lesssinging",1,0,0,0,1
"18102","lesssubject",1,0,0,0,1
"18103","lestthe",1,0,0,0,1
"18104","lettered",0,1,0,0,1
"18105","letterwritten",1,0,0,0,1
"18106","lettinggo",1,0,0,0,1
"18107","letus",1,0,0,0,1
"18108","levees",1,0,0,0,1
"18109","leveled",1,0,0,0,1
"18110","leveler",1,0,0,0,1
"18111","levity",1,0,0,0,1
"18112","liberalconditions",1,0,0,0,1
"18113","liberalityand",1,0,0,0,1
"18114","liberalize",1,0,0,0,1
"18115","liberalminded",1,0,0,0,1
"18116","liberalpolicy",1,0,0,0,1
"18117","liberalrepublican",1,0,0,0,1
"18118","liberator.had",1,0,0,0,1
"18119","liberia",1,0,0,0,1
"18120","liberty.as",1,0,0,0,1
"18121","liberty.i",1,0,0,0,1
"18122","libertyand",1,0,0,0,1
"18123","libertyhad",1,0,0,0,1
"18124","libertyof",1,0,0,0,1
"18125","libyan",0,0,0,1,1
"18126","licentious",1,0,0,0,1
"18127","licentiousness",0,1,0,0,1
"18128","lien",0,1,0,0,1
"18129","lies",0,1,0,0,1
"18130","life.after",1,0,0,0,1
"18131","life.before",1,0,0,0,1
"18132","life.but",1,0,0,0,1
"18133","life.do",1,0,0,0,1
"18134","life.i",1,0,0,0,1
"18135","life.it",1,0,0,0,1
"18136","life.the",1,0,0,0,1
"18137","life’s",1,0,0,0,1
"18138","lifeamong",1,0,0,0,1
"18139","lifeblood",1,0,0,0,1
"18140","lifegiving",1,0,0,0,1
"18141","lifehad",1,0,0,0,1
"18142","lifein",1,0,0,0,1
"18143","lifeis",1,0,0,0,1
"18144","lifewould",1,0,0,0,1
"18145","liffey",0,1,0,0,1
"18146","liftedfrom",1,0,0,0,1
"18147","liftedhim",1,0,0,0,1
"18148","lightlyoverlooked",1,0,0,0,1
"18149","lightness",0,1,0,0,1
"18150","like.arriving",1,0,0,0,1
"18151","like.masters",1,0,0,0,1
"18152","likean",1,0,0,0,1
"18153","likebeauty_",1,0,0,0,1
"18154","likecelebrations.the",1,0,0,0,1
"18155","liked.it",1,0,0,0,1
"18156","likedso",1,0,0,0,1
"18157","likedto",1,0,0,0,1
"18158","likeinterposing",1,0,0,0,1
"18159","likely",0,0,0,1,1
"18160","likeone",1,0,0,0,1
"18161","likesaying",1,0,0,0,1
"18162","likestupor",1,0,0,0,1
"18163","likethe",1,0,0,0,1
"18164","limitation",1,0,0,0,1
"18165","limiting",1,0,0,0,1
"18166","limitless",1,0,0,0,1
"18167","linar",0,0,0,1,1
"18168","lincoln_",1,0,0,0,1
"18169","lincoln.his",1,0,0,0,1
"18170","lincoln.i",1,0,0,0,1
"18171","lincoln.it",1,0,0,0,1
"18172","lincoln.the",1,0,0,0,1
"18173","lincoln.what",1,0,0,0,1
"18174","lincolnas",1,0,0,0,1
"18175","lincolnhad",1,0,0,0,1
"18176","lincolnsaid",1,0,0,0,1
"18177","lineaments",1,0,0,0,1
"18178","linenshirts",1,0,0,0,1
"18179","linger",1,0,0,0,1
"18180","lingers",1,0,0,0,1
"18181","links",1,0,0,0,1
"18182","lion’s",0,0,1,0,1
"18183","lisp",0,0,1,0,1
"18184","lispenardand",1,0,0,0,1
"18185","lisps",0,1,0,0,1
"18186","listento",1,0,0,0,1
"18187","literallya",1,0,0,0,1
"18188","literallyturned",1,0,0,0,1
"18189","literallyunknown",1,0,0,0,1
"18190","lithe",0,1,0,0,1
"18191","littleadvantage",1,0,0,0,1
"18192","littleattention",1,0,0,0,1
"18193","littlebelow",1,0,0,0,1
"18194","littleboisterous",1,0,0,0,1
"18195","littlebrother",1,0,0,0,1
"18196","littlecareful",1,0,0,0,1
"18197","littledisappointed",1,0,0,0,1
"18198","littledomestic",1,0,0,0,1
"18199","littleengine",1,0,0,0,1
"18200","littlefarm",1,0,0,0,1
"18201","littlegirl",1,0,0,0,1
"18202","littlehall",1,0,0,0,1
"18203","littleknowledge",1,0,0,0,1
"18204","littlelegs",1,0,0,0,1
"18205","littleover",1,0,0,0,1
"18206","littlepleasantry",1,0,0,0,1
"18207","littlequestions",1,0,0,0,1
"18208","littleregard",1,0,0,0,1
"18209","littletendrils",1,0,0,0,1
"18210","littlethe",1,0,0,0,1
"18211","littleto",1,0,0,0,1
"18212","littletoo",1,0,0,0,1
"18213","liveda",1,0,0,0,1
"18214","livedwith",1,0,0,0,1
"18215","liveliest",0,0,1,0,1
"18216","livelyinterest",1,0,0,0,1
"18217","livened",0,0,0,1,1
"18218","lives.for",1,0,0,0,1
"18219","liveth",1,0,0,0,1
"18220","living.thus",1,0,0,0,1
"18221","livingdaughters",1,0,0,0,1
"18222","livingdeath",1,0,0,0,1
"18223","livingparchment",1,0,0,0,1
"18224","lloyd.the",1,0,0,0,1
"18225","lloydsfor",1,0,0,0,1
"18226","lloydwere",1,0,0,0,1
"18227","lloydwhom",1,0,0,0,1
"18228","loads",0,1,0,0,1
"18229","loafers",1,0,0,0,1
"18230","loan",1,0,0,0,1
"18231","loathe",0,1,0,0,1
"18232","loathedthem",1,0,0,0,1
"18233","loathsome",0,1,0,0,1
"18234","loathsomein",1,0,0,0,1
"18235","loaves",0,1,0,0,1
"18236","localities",1,0,0,0,1
"18237","locality.when",1,0,0,0,1
"18238","localization",1,0,0,0,1
"18239","location.after",1,0,0,0,1
"18240","locomotion",0,1,0,0,1
"18241","locomotive",1,0,0,0,1
"18242","lodgings",0,0,0,1,1
"18243","loft.the",1,0,0,0,1
"18244","loftier",1,0,0,0,1
"18245","logicalthan",1,0,0,0,1
"18246","logs",0,1,0,0,1
"18247","lombardy",1,0,0,0,1
"18248","london.i",1,0,0,0,1
"18249","loneliness:thus",1,0,0,0,1
"18250","long.despite",1,0,0,0,1
"18251","longa",1,0,0,0,1
"18252","longas",1,0,0,0,1
"18253","longbondage",1,0,0,0,1
"18254","longbreath",1,0,0,0,1
"18255","longdelayed",1,0,0,0,1
"18256","longe",0,1,0,0,1
"18257","longer_",0,1,0,0,1
"18258","longeramong",1,0,0,0,1
"18259","longerask",1,0,0,0,1
"18260","longernecessary",1,0,0,0,1
"18261","longeroffensive",1,0,0,0,1
"18262","longerthe",1,0,0,0,1
"18263","longerwanted",1,0,0,0,1
"18264","longetude",0,0,0,1,1
"18265","longfellow",0,1,0,0,1
"18266","longif",1,0,0,0,1
"18267","longin",1,0,0,0,1
"18268","longpoint",1,0,0,0,1
"18269","longprovidential",1,0,0,0,1
"18270","longston",1,0,0,0,1
"18271","longtalk",1,0,0,0,1
"18272","longtestimony",1,0,0,0,1
"18273","lookedupon",1,0,0,0,1
"18274","lookers",1,0,0,0,1
"18275","lookingback",1,0,0,0,1
"18276","looks",0,0,0,1,1
"18277","lookthrough",1,0,0,0,1
"18278","loosened",0,1,0,0,1
"18279","looseto",1,0,0,0,1
"18280","lord_",1,0,0,0,1
"18281","lord’sprayer",1,0,0,0,1
"18282","lordbeaconsfield",1,0,0,0,1
"18283","loring",1,0,0,0,1
"18284","loser",0,1,0,0,1
"18285","loserby",1,0,0,0,1
"18286","losses",1,0,0,0,1
"18287","lossing",1,0,0,0,1
"18288","lostby",1,0,0,0,1
"18289","lostmuch",1,0,0,0,1
"18290","loudcursing",1,0,0,0,1
"18291","louden",0,0,1,0,1
"18292","loudest",1,0,0,0,1
"18293","louisa",1,0,0,0,1
"18294","lounger",0,1,0,0,1
"18295","loved.we",1,0,0,0,1
"18296","lovehe",1,0,0,0,1
"18297","lovejoy",1,0,0,0,1
"18298","loveof",1,0,0,0,1
"18299","lover",1,0,0,0,1
"18300","lovingdisposition",1,0,0,0,1
"18301","lovingfriends",1,0,0,0,1
"18302","lovingly",1,0,0,0,1
"18303","low_",0,1,0,0,1
"18304","low.while",1,0,0,0,1
"18305","lowe",0,0,1,0,1
"18306","lowell",0,1,0,0,1
"18307","lowndes",0,0,1,0,1
"18308","loyaladministration",1,0,0,0,1
"18309","loyalamerican",1,0,0,0,1
"18310","loyalarmy",1,0,0,0,1
"18311","loyalgovernor",1,0,0,0,1
"18312","loyalist’s",1,0,0,0,1
"18313","loyalist’sconvention",1,0,0,0,1
"18314","loyalistprocession",1,0,0,0,1
"18315","loyalmen",1,0,0,0,1
"18316","loyalnational",1,0,0,0,1
"18317","lucinda",1,0,0,0,1
"18318","lucretiamott",1,0,0,0,1
"18319","lucy",0,1,0,0,1
"18320","ludmilla",0,0,0,1,1
"18321","luggage",1,0,0,0,1
"18322","lugged",1,0,0,0,1
"18323","luke",0,0,0,1,1
"18324","lumber",0,1,0,0,1
"18325","lump",0,0,1,0,1
"18326","lumps",0,1,0,0,1
"18327","lungs",1,0,0,0,1
"18328","lures",1,0,0,0,1
"18329","lurks",1,0,0,0,1
"18330","luster",1,0,0,0,1
"18331","lustre",0,0,0,1,1
"18332","lusts",0,0,1,0,1
"18333","luxomborg",0,0,0,1,1
"18334","luxuriant",0,1,0,0,1
"18335","luxuriously",0,1,0,0,1
"18336","lybian",0,0,0,1,1
"18337","lycabettus",0,0,0,1,1
"18338","lyingthere",1,0,0,0,1
"18339","lyon",0,0,0,1,1
"18340","m.botts",1,0,0,0,1
"18341","m’cune",0,1,0,0,1
"18342","m’durmond",0,0,1,0,1
"18343","mable",0,0,0,1,1
"18344","madame",0,0,0,1,1
"18345","madearrangements",1,0,0,0,1
"18346","madeblack",1,0,0,0,1
"18347","madefor",1,0,0,0,1
"18348","madefortune",1,0,0,0,1
"18349","madehim",1,0,0,0,1
"18350","madeit",1,0,0,0,1
"18351","mademy",1,0,0,0,1
"18352","madeour",1,0,0,0,1
"18353","madepresident",1,0,0,0,1
"18354","maderequisition",1,0,0,0,1
"18355","madethat",1,0,0,0,1
"18356","madethis",1,0,0,0,1
"18357","madethree",1,0,0,0,1
"18358","madeto",1,0,0,0,1
"18359","madeup",1,0,0,0,1
"18360","madevaluable",1,0,0,0,1
"18361","madison",1,0,0,0,1
"18362","madman",1,0,0,0,1
"18363","madnessat",1,0,0,0,1
"18364","magazine",1,0,0,0,1
"18365","magical",0,1,0,0,1
"18366","magicalpowers",1,0,0,0,1
"18367","magiceloquence",1,0,0,0,1
"18368","magicpower",1,0,0,0,1
"18369","magistrateas",1,0,0,0,1
"18370","magnetic",0,1,0,0,1
"18371","magnifies",1,0,0,0,1
"18372","mahometan",1,0,0,0,1
"18373","maiden",0,1,0,0,1
"18374","maidens",0,1,0,0,1
"18375","maids",0,0,1,0,1
"18376","mailing",1,0,0,0,1
"18377","mainlyabout",1,0,0,0,1
"18378","maintainingthat",1,0,0,0,1
"18379","majestically",1,0,0,0,1
"18380","makeall",1,0,0,0,1
"18381","makebets",1,0,0,0,1
"18382","makecapt",1,0,0,0,1
"18383","makeing",0,0,0,1,1
"18384","makeit",1,0,0,0,1
"18385","maker",0,1,0,0,1
"18386","makesright",1,0,0,0,1
"18387","makethem",1,0,0,0,1
"18388","makeyou",1,0,0,0,1
"18389","makinghim",1,0,0,0,1
"18390","makingkansas",1,0,0,0,1
"18391","makinglaws",1,0,0,0,1
"18392","makingthe",1,0,0,0,1
"18393","makingtolerant",1,0,0,0,1
"18394","malefactors",1,0,0,0,1
"18395","maligners",1,0,0,0,1
"18396","malignity_",0,1,0,0,1
"18397","mallets",1,0,0,0,1
"18398","mamelukes",0,0,0,1,1
"18399","mammon",0,0,1,0,1
"18400","man.he",1,0,0,0,1
"18401","man.i",1,0,0,0,1
"18402","man.it",1,0,0,0,1
"18403","man.men",1,0,0,0,1
"18404","man.sunday",1,0,0,0,1
"18405","man.the",1,0,0,0,1
"18406","man’s_",0,1,0,0,1
"18407","man’shouse.in",1,0,0,0,1
"18408","manacled",0,0,1,0,1
"18409","manageable",1,0,0,0,1
"18410","manbehind",1,0,0,0,1
"18411","manby",1,0,0,0,1
"18412","mane",0,1,0,0,1
"18413","manfully",0,1,0,0,1
"18414","mange",0,0,1,0,1
"18415","mangled.i",1,0,0,0,1
"18416","mangling",0,0,1,0,1
"18417","manhood.i",1,0,0,0,1
"18418","maninto",1,0,0,0,1
"18419","mankind_",0,1,0,0,1
"18420","manlyassertion",1,0,0,0,1
"18421","mannamed",1,0,0,0,1
"18422","manned",0,0,1,0,1
"18423","mannedby",1,0,0,0,1
"18424","manneraltogether",1,0,0,0,1
"18425","mannerperfectly",1,0,0,0,1
"18426","manners.miles",1,0,0,0,1
"18427","mansion_",1,0,0,0,1
"18428","mansionon",1,0,0,0,1
"18429","manstealers",1,0,0,0,1
"18430","mansuspected",1,0,0,0,1
"18431","manthan",1,0,0,0,1
"18432","manto",1,0,0,0,1
"18433","manufactures",1,0,0,0,1
"18434","manure.while",1,0,0,0,1
"18435","manuscripts",0,0,0,1,1
"18436","manwere",1,0,0,0,1
"18437","many ",0,0,0,1,1
"18438","many.dear",1,0,0,0,1
"18439","many.living",1,0,0,0,1
"18440","manyacres",1,0,0,0,1
"18441","manycircumstances",1,0,0,0,1
"18442","manyhours",1,0,0,0,1
"18443","manymillions",1,0,0,0,1
"18444","manyothers",1,0,0,0,1
"18445","manypersons",1,0,0,0,1
"18446","manyphases",1,0,0,0,1
"18447","manysimilar",1,0,0,0,1
"18448","manyslave",1,0,0,0,1
"18449","manyspeeches",1,0,0,0,1
"18450","manythings",1,0,0,0,1
"18451","manytimes",1,0,0,0,1
"18452","manyyears",1,0,0,0,1
"18453","maple",0,1,0,0,1
"18454","mapped",1,0,0,0,1
"18455","mappedout",1,0,0,0,1
"18456","marathon",0,0,0,1,1
"18457","marblecounters",1,0,0,0,1
"18458","march8",1,0,0,0,1
"18459","marchconspicuously",1,0,0,0,1
"18460","marchingthrough",1,0,0,0,1
"18461","marco",0,0,0,1,1
"18462","mariele",0,0,0,1,1
"18463","marines",1,0,0,0,1
"18464","markedhim",1,0,0,0,1
"18465","markedthe",1,0,0,0,1
"18466","marko",0,0,0,1,1
"18467","maropolis",0,0,0,1,1
"18468","marriages",0,1,0,0,1
"18469","marriedman",1,0,0,0,1
"18470","mars",0,1,0,0,1
"18471","marshaled",1,0,0,0,1
"18472","marshals.notwithstanding",1,0,0,0,1
"18473","mart",0,1,0,0,1
"18474","martha",0,0,0,1,1
"18475","martines",0,0,0,1,1
"18476","martyred",1,0,0,0,1
"18477","marvelled",1,0,0,0,1
"18478","maryland.after",1,0,0,0,1
"18479","maryland.during",1,0,0,0,1
"18480","marylandand",1,0,0,0,1
"18481","mase",0,0,0,1,1
"18482","mask",0,1,0,0,1
"18483","massachusettsregiments",1,0,0,0,1
"18484","mast",0,1,0,0,1
"18485","master_",0,1,0,0,1
"18486","master.all",1,0,0,0,1
"18487","master.my",1,0,0,0,1
"18488","master.these",1,0,0,0,1
"18489","master’syoungest",1,0,0,0,1
"18490","masteragainst",1,0,0,0,1
"18491","masterbilly",1,0,0,0,1
"18492","masterdaniel",1,0,0,0,1
"18493","masterdisturbed",1,0,0,0,1
"18494","mastering",0,1,0,0,1
"18495","masterof",1,0,0,0,1
"18496","masteropens",1,0,0,0,1
"18497","masterreceived",1,0,0,0,1
"18498","masters.an",1,0,0,0,1
"18499","masterselected",1,0,0,0,1
"18500","mastersgenerally",1,0,0,0,1
"18501","masterwas",1,0,0,0,1
"18502","masts",0,1,0,0,1
"18503","matchfor",1,0,0,0,1
"18504","matchless",1,0,0,0,1
"18505","matrimony",0,0,1,0,1
"18506","matrons",0,0,1,0,1
"18507","mattered",1,0,0,0,1
"18508","matteredlittle",1,0,0,0,1
"18509","matterof",1,0,0,0,1
"18510","matterto",1,0,0,0,1
"18511","maurais",0,0,0,1,1
"18512","maws",0,0,1,0,1
"18513","may_",0,1,0,0,1
"18514","mayhurl",1,0,0,0,1
"18515","mayproperly",1,0,0,0,1
"18516","mayseem",1,0,0,0,1
"18517","maytherefore",1,0,0,0,1
"18518","maywish",1,0,0,0,1
"18519","mazzini",0,1,0,0,1
"18520","mccune",1,0,0,0,1
"18521","mckim",1,0,0,0,1
"18522","md",1,0,0,0,1
"18523","me_much",1,0,0,0,1
"18524","me.appendix",1,0,0,0,1
"18525","me.as",1,0,0,0,1
"18526","me.at",1,0,0,0,1
"18527","me.eager",1,0,0,0,1
"18528","me.in",1,0,0,0,1
"18529","me.it",1,0,0,0,1
"18530","me.master",1,0,0,0,1
"18531","me.my",1,0,0,0,1
"18532","me.now",1,0,0,0,1
"18533","me.she",1,0,0,0,1
"18534","me.strange",1,0,0,0,1
"18535","me.there",1,0,0,0,1
"18536","me.though",1,0,0,0,1
"18537","me.we",1,0,0,0,1
"18538","me.while",1,0,0,0,1
"18539","meafter",1,0,0,0,1
"18540","meager",1,0,0,0,1
"18541","meagher",1,0,0,0,1
"18542","meal_",0,1,0,0,1
"18543","mealand",1,0,0,0,1
"18544","meanand",1,0,0,0,1
"18545","meanings",0,1,0,0,1
"18546","meanness.as",1,0,0,0,1
"18547","means.it",1,0,0,0,1
"18548","meansin",1,0,0,0,1
"18549","meansso",1,0,0,0,1
"18550","meansto",1,0,0,0,1
"18551","meantto",1,0,0,0,1
"18552","measurable",1,0,0,0,1
"18553","measureless",1,0,0,0,1
"18554","measureswere",1,0,0,0,1
"18555","measurewith",1,0,0,0,1
"18556","mebut",1,0,0,0,1
"18557","mecca",1,0,0,0,1
"18558","mechanically",0,1,0,0,1
"18559","medes",0,0,0,1,1
"18560","medetareanion",0,0,0,1,1
"18561","medeteranian",0,0,0,1,1
"18562","medicineever",1,0,0,0,1
"18563","medicines",0,1,0,0,1
"18564","medicio",0,0,0,1,1
"18565","mediteranean",0,0,0,1,1
"18566","mediterranean",0,1,0,0,1
"18567","mediumof",1,0,0,0,1
"18568","meduring",1,0,0,0,1
"18569","meeting.chapter",1,0,0,0,1
"18570","meeting.in",1,0,0,0,1
"18571","meetingarrived",1,0,0,0,1
"18572","meetinghouse",0,0,1,0,1
"18573","meetingin",1,0,0,0,1
"18574","meetingon",1,0,0,0,1
"18575","meetingwhich",1,0,0,0,1
"18576","meetthe",1,0,0,0,1
"18577","meetwith",1,0,0,0,1
"18578","meeverything",1,0,0,0,1
"18579","meextravagant",1,0,0,0,1
"18580","mefacts",1,0,0,0,1
"18581","mefeel",1,0,0,0,1
"18582","mefor",1,0,0,0,1
"18583","mehome",1,0,0,0,1
"18584","meignorant",1,0,0,0,1
"18585","meigs",1,0,0,0,1
"18586","melace",0,0,0,1,1
"18587","melanchthon",0,1,0,0,1
"18588","mêlée",1,0,0,0,1
"18589","meliberally",1,0,0,0,1
"18590","melike",1,0,0,0,1
"18591","melittle",1,0,0,0,1
"18592","melloe",1,0,0,0,1
"18593","melt",0,1,0,0,1
"18594","memento",1,0,0,0,1
"18595","memoirs",0,0,1,0,1
"18596","memorial",1,0,0,0,1
"18597","memorialized",1,0,0,0,1
"18598","memory.supper",1,0,0,0,1
"18599","memost",1,0,0,0,1
"18600","men.cunningham",1,0,0,0,1
"18601","men.the",1,0,0,0,1
"18602","men.with",1,0,0,0,1
"18603","menaced",1,0,0,0,1
"18604","menacing",0,1,0,0,1
"18605","menand",1,0,0,0,1
"18606","menbeneath",1,0,0,0,1
"18607","mend",0,1,0,0,1
"18608","mendenhall",1,0,0,0,1
"18609","mendid",1,0,0,0,1
"18610","menengaged",1,0,0,0,1
"18611","menhe",1,0,0,0,1
"18612","meni",0,0,0,1,1
"18613","menial",1,0,0,0,1
"18614","menpuzzled",1,0,0,0,1
"18615","menso",1,0,0,0,1
"18616","mentaldeficiencies",1,0,0,0,1
"18617","mentallyand",1,0,0,0,1
"18618","mentalscience",1,0,0,0,1
"18619","mentionall",1,0,0,0,1
"18620","mentionedhere",1,0,0,0,1
"18621","mentionedwith",1,0,0,0,1
"18622","mentioning",1,0,0,0,1
"18623","mentions",0,1,0,0,1
"18624","mento",1,0,0,0,1
"18625","mentone",0,0,0,1,1
"18626","menwho",1,0,0,0,1
"18627","meon",1,0,0,0,1
"18628","mer",0,0,0,1,1
"18629","merchants",0,1,0,0,1
"18630","mercilessness",0,1,0,0,1
"18631","merebrute",1,0,0,0,1
"18632","merechild",1,0,0,0,1
"18633","mereindividual",1,0,0,0,1
"18634","merely",0,0,0,1,1
"18635","merelyemancipated",1,0,0,0,1
"18636","merging",0,1,0,0,1
"18637","merited",1,0,0,0,1
"18638","meritorious",1,0,0,0,1
"18639","merrimac",1,0,0,0,1
"18640","merriments",0,0,1,0,1
"18641","meshelter",1,0,0,0,1
"18642","mesome",1,0,0,0,1
"18643","message",1,0,0,0,1
"18644","messageliberated",1,0,0,0,1
"18645","messageof",1,0,0,0,1
"18646","messengersfrom",1,0,0,0,1
"18647","messina",0,0,0,1,1
"18648","messrs.cobden",1,0,0,0,1
"18649","messrs.garrison",1,0,0,0,1
"18650","messrs.storks",1,0,0,0,1
"18651","messrs.trumbull",1,0,0,0,1
"18652","meswallow",1,0,0,0,1
"18653","met.it",1,0,0,0,1
"18654","met.their",1,0,0,0,1
"18655","metake",1,0,0,0,1
"18656","metal",0,1,0,0,1
"18657","metalrunning",1,0,0,0,1
"18658","metals",0,1,0,0,1
"18659","meted",0,1,0,0,1
"18660","methat",1,0,0,0,1
"18661","metoften",1,0,0,0,1
"18662","metoo",1,0,0,0,1
"18663","metropolis",0,1,0,0,1
"18664","meunusually",1,0,0,0,1
"18665","mewelcome",1,0,0,0,1
"18666","mewell",1,0,0,0,1
"18667","miasma",1,0,0,0,1
"18668","miasmatic",1,0,0,0,1
"18669","michaels.this",1,0,0,0,1
"18670","michaelsattempt",1,0,0,0,1
"18671","michaelsby",1,0,0,0,1
"18672","michaelsthe",1,0,0,0,1
"18673","michel",0,0,0,1,1
"18674","michelangelo",0,0,0,1,1
"18675","mid",0,1,0,0,1
"18676","miday",0,0,0,1,1
"18677","midday",0,0,1,0,1
"18678","middlebury",1,0,0,0,1
"18679","might_",0,1,0,0,1
"18680","might.but",1,0,0,0,1
"18681","mightdeem",1,0,0,0,1
"18682","mightexperience",1,0,0,0,1
"18683","mightgive",1,0,0,0,1
"18684","mightier",1,0,0,0,1
"18685","mightinnocently",1,0,0,0,1
"18686","mightperhaps",1,0,0,0,1
"18687","mightspeedily",1,0,0,0,1
"18688","mightwell",1,0,0,0,1
"18689","migration",1,0,0,0,1
"18690","migrations",1,0,0,0,1
"18691","mildness",0,1,0,0,1
"18692","mildnessand",1,0,0,0,1
"18693","milesfrom",1,0,0,0,1
"18694","milesfurther",1,0,0,0,1
"18695","militarynecessity",1,0,0,0,1
"18696","militates",0,1,0,0,1
"18697","millard",1,0,0,0,1
"18698","miller’s",0,1,0,0,1
"18699","milliken’s",1,0,0,0,1
"18700","milton",1,0,0,0,1
"18701","mimicry",0,1,0,0,1
"18702","mind.nor",1,0,0,0,1
"18703","mindcast",1,0,0,0,1
"18704","mindedand",1,0,0,0,1
"18705","mindedness",1,0,0,0,1
"18706","mindi",1,0,0,0,1
"18707","minding",1,0,0,0,1
"18708","mindsof",1,0,0,0,1
"18709","mine_",1,0,0,0,1
"18710","mine_possible_",1,0,0,0,1
"18711","mine.my",1,0,0,0,1
"18712","minester",0,0,0,1,1
"18713","minglingtheir",1,0,0,0,1
"18714","mining",1,0,0,0,1
"18715","ministeray",0,0,0,1,1
"18716","ministered",1,0,0,0,1
"18717","ministering",0,0,1,0,1
"18718","mint",0,0,1,0,1
"18719","minutesallotted",1,0,0,0,1
"18720","minutest",0,1,0,0,1
"18721","miracles",0,0,0,1,1
"18722","mirthful",0,1,0,0,1
"18723","misadventure",1,0,0,0,1
"18724","mischievouslyplacarded",1,0,0,0,1
"18725","miserably",1,0,0,0,1
"18726","miseries",0,1,0,0,1
"18727","misery.some",1,0,0,0,1
"18728","misfortune.the",1,0,0,0,1
"18729","misgiving",1,0,0,0,1
"18730","misled",1,0,0,0,1
"18731","misnomer",1,0,0,0,1
"18732","misnomers",0,0,1,0,1
"18733","misrepresentations",1,0,0,0,1
"18734","misrepresented",0,0,1,0,1
"18735","missionarywork",1,0,0,0,1
"18736","mississipi",1,0,0,0,1
"18737","mississippivalley.chapter",1,0,0,0,1
"18738","missourians",1,0,0,0,1
"18739","missouricompromise",1,0,0,0,1
"18740","misstatements",0,0,1,0,1
"18741","mist",1,0,0,0,1
"18742","mitres",0,0,0,1,1
"18743","mixture",0,1,0,0,1
"18744","mobbed.the",1,0,0,0,1
"18745","mobocraticdemonstrations",1,0,0,0,1
"18746","mobocraticviolence",1,0,0,0,1
"18747","mock",0,1,0,0,1
"18748","mode_",1,0,0,0,1
"18749","models",0,0,0,1,1
"18750","moden",0,0,0,1,1
"18751","modeof",1,0,0,0,1
"18752","moderator",0,1,0,0,1
"18753","modernegypt",1,0,0,0,1
"18754","modestly",1,0,0,0,1
"18755","modesty",1,0,0,0,1
"18756","modifies",0,1,0,0,1
"18757","modify",1,0,0,0,1
"18758","mohamden",0,0,0,1,1
"18759","mohamedan",0,0,0,1,1
"18760","mohameden",0,0,0,1,1
"18761","mohomid",0,0,0,1,1
"18762","moisture",1,0,0,0,1
"18763","molestation",0,1,0,0,1
"18764","momentpossible.about",1,0,0,0,1
"18765","momentswhen",1,0,0,0,1
"18766","momentthe",1,0,0,0,1
"18767","momentwhen",1,0,0,0,1
"18768","monarch",0,0,0,1,1
"18769","monarchies",0,1,0,0,1
"18770","monastery",0,0,0,1,1
"18771","mondaymorning",1,0,0,0,1
"18772","money.i",1,0,0,0,1
"18773","money.mrs",1,0,0,0,1
"18774","money.unhappily",1,0,0,0,1
"18775","moneyless",0,1,0,0,1
"18776","moneyof",1,0,0,0,1
"18777","moneys",1,0,0,0,1
"18778","moneywith",1,0,0,0,1
"18779","mongols",0,1,0,0,1
"18780","monitor",1,0,0,0,1
"18781","monk",0,0,0,1,1
"18782","monkeys",1,0,0,0,1
"18783","monks",0,0,0,1,1
"18784","monks ",0,0,0,1,1
"18785","monopolized",0,1,0,0,1
"18786","monopolizedby",1,0,0,0,1
"18787","monotonous",1,0,0,0,1
"18788","monroewas",1,0,0,0,1
"18789","monstrosity",1,0,0,0,1
"18790","month’s",1,0,0,0,1
"18791","monthlyallowance",1,0,0,0,1
"18792","months.i",1,0,0,0,1
"18793","monuments",1,0,0,0,1
"18794","monumentwe",1,0,0,0,1
"18795","moralconvictions",1,0,0,0,1
"18796","moralpower",1,0,0,0,1
"18797","moralsentiment",1,0,0,0,1
"18798","moralsuasion",1,0,0,0,1
"18799","moralthunder",1,0,0,0,1
"18800","more.can",1,0,0,0,1
"18801","more.the",1,0,0,0,1
"18802","moreand",1,0,0,0,1
"18803","moreattention",1,0,0,0,1
"18804","morecertain",1,0,0,0,1
"18805","morecritical",1,0,0,0,1
"18806","moredevotional",1,0,0,0,1
"18807","moredifficult",1,0,0,0,1
"18808","moredistressing",1,0,0,0,1
"18809","moreeffectually",1,0,0,0,1
"18810","moreexalted",1,0,0,0,1
"18811","morefirmly",1,0,0,0,1
"18812","morefortunately",1,0,0,0,1
"18813","morein",1,0,0,0,1
"18814","morekindly",1,0,0,0,1
"18815","moreknowledge",1,0,0,0,1
"18816","morelike",1,0,0,0,1
"18817","moremarked",1,0,0,0,1
"18818","moremoney",1,0,0,0,1
"18819","moremy",1,0,0,0,1
"18820","moreof",1,0,0,0,1
"18821","moreretired",1,0,0,0,1
"18822","moresafely",1,0,0,0,1
"18823","moreslave",1,0,0,0,1
"18824","morewas",1,0,0,0,1
"18825","morewould",1,0,0,0,1
"18826","morning.during",1,0,0,0,1
"18827","morning.on",1,0,0,0,1
"18828","morningpapers",1,0,0,0,1
"18829","mornings",1,0,0,0,1
"18830","moropoles",0,0,0,1,1
"18831","morrisisland",1,0,0,0,1
"18832","morrow",0,1,0,0,1
"18833","morsel",0,1,0,0,1
"18834","mortgage",1,0,0,0,1
"18835","mosesnorris",1,0,0,0,1
"18836","mosoleum",0,0,0,1,1
"18837","mosquitoes",0,1,0,0,1
"18838","mostafter",1,0,0,0,1
"18839","mostbitter",1,0,0,0,1
"18840","mostbitterly",1,0,0,0,1
"18841","mostdearly",1,0,0,0,1
"18842","mosteager",1,0,0,0,1
"18843","mosteffective",1,0,0,0,1
"18844","mostencouraging",1,0,0,0,1
"18845","mostenduring",1,0,0,0,1
"18846","mostfriendly",1,0,0,0,1
"18847","mostimportant",1,0,0,0,1
"18848","mostkind",1,0,0,0,1
"18849","mostpart",1,0,0,0,1
"18850","mostpersecuted",1,0,0,0,1
"18851","mostpopular",1,0,0,0,1
"18852","mostprominent",1,0,0,0,1
"18853","moststrikingly",1,0,0,0,1
"18854","mostunwelcome",1,0,0,0,1
"18855","mostvivid",1,0,0,0,1
"18856","motes",0,0,1,0,1
"18857","mother.mrs",1,0,0,0,1
"18858","mother.the",1,0,0,0,1
"18859","mother’sknee",1,0,0,0,1
"18860","motherhood",1,0,0,0,1
"18861","motherless",1,0,0,0,1
"18862","motherswho",1,0,0,0,1
"18863","motiveand",1,0,0,0,1
"18864","motives.i",1,0,0,0,1
"18865","motivesand",1,0,0,0,1
"18866","motivesfor",1,0,0,0,1
"18867","motly",0,0,0,1,1
"18868","motts",1,0,0,0,1
"18869","mould",1,0,0,0,1
"18870","moulding",0,1,0,0,1
"18871","mountainous",0,0,0,1,1
"18872","mountains.these",1,0,0,0,1
"18873","mountan",0,0,0,1,1
"18874","mounte",0,0,0,1,1
"18875","mournful.in",1,0,0,0,1
"18876","mournfully",1,0,0,0,1
"18877","mouthand",1,0,0,0,1
"18878","movementsdetermined",1,0,0,0,1
"18879","movementsexcited",1,0,0,0,1
"18880","movers",0,1,0,0,1
"18881","movingmultitude",1,0,0,0,1
"18882","mr.calhoun",1,0,0,0,1
"18883","mr.cobden",1,0,0,0,1
"18884","mr.combe",1,0,0,0,1
"18885","mr.cunard",1,0,0,0,1
"18886","mr.garfield",1,0,0,0,1
"18887","mr.green",1,0,0,0,1
"18888","mr.helmsley’s",1,0,0,0,1
"18889","mr.hilles",1,0,0,0,1
"18890","mr.johnson",1,0,0,0,1
"18891","mr.jones",1,0,0,0,1
"18892","mr.l",1,0,0,0,1
"18893","mr.plummer",1,0,0,0,1
"18894","mr.price’s",1,0,0,0,1
"18895","mr.richmond",1,0,0,0,1
"18896","mr.sears’s",1,0,0,0,1
"18897","mr.sevier",1,0,0,0,1
"18898","mr.sumner",1,0,0,0,1
"18899","mr.walter",1,0,0,0,1
"18900","mr.wendell",1,0,0,0,1
"18901","mrs.croffts",1,0,0,0,1
"18902","mrs.giles",1,0,0,0,1
"18903","mrs.hilles",1,0,0,0,1
"18904","mrs.howitt",1,0,0,0,1
"18905","mrs.norris",1,0,0,0,1
"18906","mrs.stowe",1,0,0,0,1
"18907","ms",0,0,1,0,1
"18908","much_",0,1,0,0,1
"18909","muchabout",1,0,0,0,1
"18910","muchagainst",1,0,0,0,1
"18911","muchby",1,0,0,0,1
"18912","muchexcited",1,0,0,0,1
"18913","muchexposed",1,0,0,0,1
"18914","muchhardened",1,0,0,0,1
"18915","muchlarger",1,0,0,0,1
"18916","muchmore",1,0,0,0,1
"18917","muchof",1,0,0,0,1
"18918","muchopposition",1,0,0,0,1
"18919","muchother",1,0,0,0,1
"18920","muchover",1,0,0,0,1
"18921","muchperil",1,0,0,0,1
"18922","muddiest",1,0,0,0,1
"18923","mulattoes",0,0,0,1,1
"18924","multifarious",0,1,0,0,1
"18925","multiply",1,0,0,0,1
"18926","mummies",0,0,0,1,1
"18927","murderand",1,0,0,0,1
"18928","murderer.master",1,0,0,0,1
"18929","murderer.the",1,0,0,0,1
"18930","murderers.these",1,0,0,0,1
"18931","murdering",0,1,0,0,1
"18932","murfreesboro",1,0,0,0,1
"18933","murmuring",1,0,0,0,1
"18934","murraylloyd",1,0,0,0,1
"18935","murrayof",1,0,0,0,1
"18936","murry",0,0,0,1,1
"18937","musicand",1,0,0,0,1
"18938","musium",0,0,0,1,1
"18939","mustfight",1,0,0,0,1
"18940","mustgo",1,0,0,0,1
"18941","musthave",1,0,0,0,1
"18942","mustmake",1,0,0,0,1
"18943","mustpreach",1,0,0,0,1
"18944","mustsay",1,0,0,0,1
"18945","musttrust",1,0,0,0,1
"18946","mutations",0,1,0,0,1
"18947","mutilating",0,1,0,0,1
"18948","mutterings",0,1,0,0,1
"18949","mutuallyunderstand",1,0,0,0,1
"18950","myafternoon",1,0,0,0,1
"18951","myage",1,0,0,0,1
"18952","myamiable",1,0,0,0,1
"18953","myanti",1,0,0,0,1
"18954","myappointment",1,0,0,0,1
"18955","myarrival",1,0,0,0,1
"18956","myassistant",1,0,0,0,1
"18957","myattention",1,0,0,0,1
"18958","myawkwardness",1,0,0,0,1
"18959","mybecoming",1,0,0,0,1
"18960","mybody",1,0,0,0,1
"18961","mybondage",1,0,0,0,1
"18962","myboyhood",1,0,0,0,1
"18963","mybrother",1,0,0,0,1
"18964","mycaucasian",1,0,0,0,1
"18965","mychildhood",1,0,0,0,1
"18966","myclothes",1,0,0,0,1
"18967","mycolumbian",1,0,0,0,1
"18968","mycompany",1,0,0,0,1
"18969","myconviction",1,0,0,0,1
"18970","mycountry",1,0,0,0,1
"18971","mycowardice",1,0,0,0,1
"18972","mydaughter",1,0,0,0,1
"18973","myday",1,0,0,0,1
"18974","mydeep",1,0,0,0,1
"18975","mydemands",1,0,0,0,1
"18976","mydeparture",1,0,0,0,1
"18977","mydiploma",1,0,0,0,1
"18978","mydisunion",1,0,0,0,1
"18979","myearliest",1,0,0,0,1
"18980","myefforts",1,0,0,0,1
"18981","myenslavement",1,0,0,0,1
"18982","myescape",1,0,0,0,1
"18983","myfailure",1,0,0,0,1
"18984","myfellow",1,0,0,0,1
"18985","myfellowmen",1,0,0,0,1
"18986","myformer",1,0,0,0,1
"18987","myframe",1,0,0,0,1
"18988","myfreedom.notwithstanding",1,0,0,0,1
"18989","myfriend",1,0,0,0,1
"18990","myfriends",1,0,0,0,1
"18991","mygarments",1,0,0,0,1
"18992","mygreatest",1,0,0,0,1
"18993","myhands",1,0,0,0,1
"18994","myhappiness",1,0,0,0,1
"18995","myheart",1,0,0,0,1
"18996","myimmunity",1,0,0,0,1
"18997","myimperfect",1,0,0,0,1
"18998","myinnocence",1,0,0,0,1
"18999","myintended",1,0,0,0,1
"19000","myisolation",1,0,0,0,1
"19001","myleaden",1,0,0,0,1
"19002","myletters",1,0,0,0,1
"19003","mylittle",1,0,0,0,1
"19004","myloneliness",1,0,0,0,1
"19005","mylong",1,0,0,0,1
"19006","mymaster’s",1,0,0,0,1
"19007","mymeans",1,0,0,0,1
"19008","mymoral",1,0,0,0,1
"19009","mymovements",1,0,0,0,1
"19010","mynew",1,0,0,0,1
"19011","mynewly",1,0,0,0,1
"19012","mynext",1,0,0,0,1
"19013","myobligation",1,0,0,0,1
"19014","myonly",1,0,0,0,1
"19015","myopinions",1,0,0,0,1
"19016","myother",1,0,0,0,1
"19017","mypart",1,0,0,0,1
"19018","mypeculiar",1,0,0,0,1
"19019","mypeople",1,0,0,0,1
"19020","myplans",1,0,0,0,1
"19021","mypleasure",1,0,0,0,1
"19022","mypresumed",1,0,0,0,1
"19023","myprotection",1,0,0,0,1
"19024","myre",1,0,0,0,1
"19025","myreaders",1,0,0,0,1
"19026","myreception",1,0,0,0,1
"19027","myregret",1,0,0,0,1
"19028","myrelations",1,0,0,0,1
"19029","myremoval",1,0,0,0,1
"19030","myrepresentation",1,0,0,0,1
"19031","myresignation",1,0,0,0,1
"19032","myrespected",1,0,0,0,1
"19033","myronholly",1,0,0,0,1
"19034","myrtle",1,0,0,0,1
"19035","mysabbath",1,0,0,0,1
"19036","myseeming",1,0,0,0,1
"19037","myself.against",1,0,0,0,1
"19038","myself.as",1,0,0,0,1
"19039","myself.seven",1,0,0,0,1
"19040","myself.the",1,0,0,0,1
"19041","myself.upon",1,0,0,0,1
"19042","myselfaccused",1,0,0,0,1
"19043","myselfelected",1,0,0,0,1
"19044","myselfeven",1,0,0,0,1
"19045","myselfisolated",1,0,0,0,1
"19046","myselfno",1,0,0,0,1
"19047","myselfof",1,0,0,0,1
"19048","myselfpersonally",1,0,0,0,1
"19049","myselfsecure",1,0,0,0,1
"19050","myselfto",1,0,0,0,1
"19051","myservices",1,0,0,0,1
"19052","myshoulder",1,0,0,0,1
"19053","myshoulders",1,0,0,0,1
"19054","mysins",1,0,0,0,1
"19055","mysixteen",1,0,0,0,1
"19056","myslaves",1,0,0,0,1
"19057","mysleeping",1,0,0,0,1
"19058","mysteriesof",1,0,0,0,1
"19059","mytemporary",1,0,0,0,1
"19060","myth",0,1,0,0,1
"19061","mywelcome",1,0,0,0,1
"19062","mywork",1,0,0,0,1
"19063","mywrists",1,0,0,0,1
"19064","n.buffum",1,0,0,0,1
"19065","n.y",0,1,0,0,1
"19066","nailed",1,0,0,0,1
"19067","naish",0,0,0,1,1
"19068","nameas",1,0,0,0,1
"19069","namedas",1,0,0,0,1
"19070","namedin",1,0,0,0,1
"19071","namefor",1,0,0,0,1
"19072","namehas",1,0,0,0,1
"19073","namemy",1,0,0,0,1
"19074","namesmight",1,0,0,0,1
"19075","namewas",1,0,0,0,1
"19076","nance",0,1,0,0,1
"19077","nanny",0,0,1,0,1
"19078","napoleon’s",0,1,0,0,1
"19079","napolian",1,0,0,0,1
"19080","narmal",0,0,0,1,1
"19081","narrative.on",1,0,0,0,1
"19082","narratives",0,0,0,1,1
"19083","narrators",1,0,0,0,1
"19084","narrowlyafter",1,0,0,0,1
"19085","nat.turner",1,0,0,0,1
"19086","nathanjohnson",1,0,0,0,1
"19087","nation.it",1,0,0,0,1
"19088","nation.these",1,0,0,0,1
"19089","nationale",0,0,0,1,1
"19090","nationalgovernment",1,0,0,0,1
"19091","nationallimitations",1,0,0,0,1
"19092","nationalpolitical",1,0,0,0,1
"19093","nationand",1,0,0,0,1
"19094","nationin",1,0,0,0,1
"19095","nationshave",1,0,0,0,1
"19096","nationsseldom",1,0,0,0,1
"19097","nativeland",1,0,0,0,1
"19098","nativeplace",1,0,0,0,1
"19099","naturalcuriosity",1,0,0,0,1
"19100","naturalhistory",1,0,0,0,1
"19101","naturalists",0,1,0,0,1
"19102","naturallyemploy",1,0,0,0,1
"19103","naturallyinquired",1,0,0,0,1
"19104","naturallyoccupies",1,0,0,0,1
"19105","naturallyto",1,0,0,0,1
"19106","naturalthat",1,0,0,0,1
"19107","naturalthere",1,0,0,0,1
"19108","naturedly",0,0,0,1,1
"19109","naturemade",1,0,0,0,1
"19110","naturetemporary",1,0,0,0,1
"19111","navigation",0,0,0,1,1
"19112","neal",0,1,0,0,1
"19113","nealhardy",1,0,0,0,1
"19114","nearing",1,0,0,0,1
"19115","nearlydone",1,0,0,0,1
"19116","nearlyforty",1,0,0,0,1
"19117","nearlyhalf",1,0,0,0,1
"19118","nearlyknocked",1,0,0,0,1
"19119","nearlyor",1,0,0,0,1
"19120","nearlyvanished",1,0,0,0,1
"19121","nearness",0,1,0,0,1
"19122","neater",0,0,1,0,1
"19123","nebraskabill",1,0,0,0,1
"19124","neccessary",0,1,0,0,1
"19125","necessarilydangerous",1,0,0,0,1
"19126","necessaryin",1,0,0,0,1
"19127","necessityimposed",1,0,0,0,1
"19128","necessityis",1,0,0,0,1
"19129","neck.my",1,0,0,0,1
"19130","neds",0,1,0,0,1
"19131","need",0,0,0,1,1
"19132","needed",0,0,0,1,1
"19133","neededmore",1,0,0,0,1
"19134","neededprotection",1,0,0,0,1
"19135","needextinguish",1,0,0,0,1
"19136","needle",0,1,0,0,1
"19137","needless",1,0,0,0,1
"19138","needlessly",1,0,0,0,1
"19139","needof",1,0,0,0,1
"19140","needonly",1,0,0,0,1
"19141","needto",1,0,0,0,1
"19142","neglecting",1,0,0,0,1
"19143","negroessimply",1,0,0,0,1
"19144","negroid",0,1,0,0,1
"19145","negropew",1,0,0,0,1
"19146","negroprejudice",1,0,0,0,1
"19147","neitheranticipated",1,0,0,0,1
"19148","neitherdid",1,0,0,0,1
"19149","neithergarrison",1,0,0,0,1
"19150","neitherinstitute",1,0,0,0,1
"19151","neitherproperty",1,0,0,0,1
"19152","neithershoes",1,0,0,0,1
"19153","neithertheir",1,0,0,0,1
"19154","nell",0,0,1,0,1
"19155","nellie",1,0,0,0,1
"19156","nelly’s",0,1,0,0,1
"19157","neots",0,0,0,1,1
"19158","nephew",0,0,1,0,1
"19159","neptune",0,0,0,1,1
"19160","nest",0,0,0,1,1
"19161","nestled",0,1,0,0,1
"19162","netand",1,0,0,0,1
"19163","neutralized",0,0,1,0,1
"19164","never.i",1,0,0,0,1
"19165","neverallowed",1,0,0,0,1
"19166","neverbeen",1,0,0,0,1
"19167","neverbefore",1,0,0,0,1
"19168","neverdid",1,0,0,0,1
"19169","neverhaving",1,0,0,0,1
"19170","neverlisped",1,0,0,0,1
"19171","neversaw",1,0,0,0,1
"19172","neversee",1,0,0,0,1
"19173","neverserved",1,0,0,0,1
"19174","neverstaggered",1,0,0,0,1
"19175","nevertell",1,0,0,0,1
"19176","neverto",1,0,0,0,1
"19177","neverused",1,0,0,0,1
"19178","neverweary",1,0,0,0,1
"19179","newark",1,0,0,0,1
"19180","newbedford",1,0,0,0,1
"19181","newburyport",0,1,0,0,1
"19182","newcombination",1,0,0,0,1
"19183","newconditions",1,0,0,0,1
"19184","newdanger",1,0,0,0,1
"19185","newdeparture",1,0,0,0,1
"19186","newhampshere",0,0,0,1,1
"19187","newlyemancipated",1,0,0,0,1
"19188","newlyenfranchised",1,0,0,0,1
"19189","newmaster",1,0,0,0,1
"19190","newof",1,0,0,0,1
"19191","newparty",1,0,0,0,1
"19192","newport.no",1,0,0,0,1
"19193","newrepublic",1,0,0,0,1
"19194","newspaperswere",1,0,0,0,1
"19195","newsurroundings",1,0,0,0,1
"19196","nextday",1,0,0,0,1
"19197","nextvisited",1,0,0,0,1
"19198","nextwe",1,0,0,0,1
"19199","nibbles",1,0,0,0,1
"19200","nicefeeling",1,0,0,0,1
"19201","nicer",1,0,0,0,1
"19202","nichols",1,0,0,0,1
"19203","nicky",1,0,0,0,1
"19204","night.in",1,0,0,0,1
"19205","nightfall",0,1,0,0,1
"19206","nightingale",0,1,0,0,1
"19207","nightly",0,1,0,0,1
"19208","nightof",1,0,0,0,1
"19209","nightshungry",1,0,0,0,1
"19210","nightsi",1,0,0,0,1
"19211","niles",0,0,0,1,1
"19212","nimble",1,0,0,0,1
"19213","nine",0,0,0,1,1
"19214","ninety",0,1,0,0,1
"19215","ninth",1,0,0,0,1
"19216","niver",0,0,0,1,1
"19217","noabsolute",1,0,0,0,1
"19218","noamount",1,0,0,0,1
"19219","noblechesapeake",1,0,0,0,1
"19220","nobleco",1,0,0,0,1
"19221","noblehearted",0,1,0,0,1
"19222","nobleness",1,0,0,0,1
"19223","noblepeople",1,0,0,0,1
"19224","nobleresolution",1,0,0,0,1
"19225","nobles",0,1,0,0,1
"19226","noblesoul",1,0,0,0,1
"19227","nocomment",1,0,0,0,1
"19228","nocontradiction",1,0,0,0,1
"19229","nocorrespondence",1,0,0,0,1
"19230","nodeceiving",1,0,0,0,1
"19231","nodisturbance",1,0,0,0,1
"19232","nodoubt",1,0,0,0,1
"19233","noexception",1,0,0,0,1
"19234","noheart",1,0,0,0,1
"19235","noillusions",1,0,0,0,1
"19236","noinstances",1,0,0,0,1
"19237","noisiest",1,0,0,0,1
"19238","noisily",1,0,0,0,1
"19239","noisybravado",1,0,0,0,1
"19240","nolonger",1,0,0,0,1
"19241","nolonger.pending",1,0,0,0,1
"19242","nomatter",1,0,0,0,1
"19243","nomean",1,0,0,0,1
"19244","nomore",1,0,0,0,1
"19245","none.like",1,0,0,0,1
"19246","nonebased",1,0,0,0,1
"19247","nonecessity",1,0,0,0,1
"19248","nonsence",0,1,0,0,1
"19249","nonslaveholder",0,1,0,0,1
"19250","nonslaveholding",0,1,0,0,1
"19251","noopportunity",1,0,0,0,1
"19252","nopreparation",1,0,0,0,1
"19253","noproperty",1,0,0,0,1
"19254","norace",1,0,0,0,1
"19255","noreal",1,0,0,0,1
"19256","norejoinder",1,0,0,0,1
"19257","norelegant",1,0,0,0,1
"19258","noremedy",1,0,0,0,1
"19259","norights",1,0,0,0,1
"19260","normal",1,0,0,0,1
"19261","north.though",1,0,0,0,1
"19262","northampton",0,1,0,0,1
"19263","northe",1,0,0,0,1
"19264","northeast",1,0,0,0,1
"19265","northeaster",1,0,0,0,1
"19266","northernatmosphere",1,0,0,0,1
"19267","northhad",1,0,0,0,1
"19268","northpassage",1,0,0,0,1
"19269","northto",1,0,0,0,1
"19270","northward",0,1,0,0,1
"19271","northwere",1,0,0,0,1
"19272","northwest",1,0,0,0,1
"19273","northwold",0,0,0,1,1
"19274","norwegian",1,0,0,0,1
"19275","noshoulders",1,0,0,0,1
"19276","nosily",0,1,0,0,1
"19277","noslavery",1,0,0,0,1
"19278","nospeech",1,0,0,0,1
"19279","nostrils",0,1,0,0,1
"19280","nosuch",1,0,0,0,1
"19281","not_marshal_",1,0,0,0,1
"19282","nota",1,0,0,0,1
"19283","notadmitted",1,0,0,0,1
"19284","notallowed",1,0,0,0,1
"19285","notalways",1,0,0,0,1
"19286","notan",1,0,0,0,1
"19287","notanimated",1,0,0,0,1
"19288","notappear",1,0,0,0,1
"19289","notat",1,0,0,0,1
"19290","notattempt",1,0,0,0,1
"19291","notbe",1,0,0,0,1
"19292","notbeen",1,0,0,0,1
"19293","notbefore",1,0,0,0,1
"19294","notcensure",1,0,0,0,1
"19295","notcomplete",1,0,0,0,1
"19296","notconsidered",1,0,0,0,1
"19297","notcontent",1,0,0,0,1
"19298","notdepend",1,0,0,0,1
"19299","notdoubt",1,0,0,0,1
"19300","noteasily",1,0,0,0,1
"19301","notedslave",1,0,0,0,1
"19302","notes_",0,1,0,0,1
"19303","notes.they",1,0,0,0,1
"19304","noteven",1,0,0,0,1
"19305","noteworthy.it",1,0,0,0,1
"19306","notexaggerate",1,0,0,0,1
"19307","notgive",1,0,0,0,1
"19308","notglory",1,0,0,0,1
"19309","nothere",1,0,0,0,1
"19310","nothingabout",1,0,0,0,1
"19311","nothingagainst",1,0,0,0,1
"19312","nothingimprobable",1,0,0,0,1
"19313","nothingwas",1,0,0,0,1
"19314","nothingwithout",1,0,0,0,1
"19315","nothought",1,0,0,0,1
"19316","nothwithstanding",0,1,0,0,1
"19317","noticewas",1,0,0,0,1
"19318","notified",1,0,0,0,1
"19319","notiing",0,0,0,1,1
"19320","notimpossible",1,0,0,0,1
"19321","noting",0,0,0,1,1
"19322","notinstantly",1,0,0,0,1
"19323","notintended",1,0,0,0,1
"19324","notinterfere",1,0,0,0,1
"19325","notionsabout",1,0,0,0,1
"19326","notknow",1,0,0,0,1
"19327","notless",1,0,0,0,1
"19328","notliked",1,0,0,0,1
"19329","notlong",1,0,0,0,1
"19330","notmerely",1,0,0,0,1
"19331","notof",1,0,0,0,1
"19332","notoriously",0,1,0,0,1
"19333","notorioustoo",1,0,0,0,1
"19334","notown",1,0,0,0,1
"19335","notprepared",1,0,0,0,1
"19336","notprocure",1,0,0,0,1
"19337","notrather",1,0,0,0,1
"19338","notregard",1,0,0,0,1
"19339","notrely",1,0,0,0,1
"19340","notresist",1,0,0,0,1
"19341","notrouble",1,0,0,0,1
"19342","notsacrifice",1,0,0,0,1
"19343","notseen",1,0,0,0,1
"19344","notserve",1,0,0,0,1
"19345","notsoon",1,0,0,0,1
"19346","notstating",1,0,0,0,1
"19347","notsucceed",1,0,0,0,1
"19348","notsuspect",1,0,0,0,1
"19349","notsustenance",1,0,0,0,1
"19350","nott",1,0,0,0,1
"19351","nottake",1,0,0,0,1
"19352","notthat",1,0,0,0,1
"19353","notthe",1,0,0,0,1
"19354","notto",1,0,0,0,1
"19355","nottold",1,0,0,0,1
"19356","nottrouble",1,0,0,0,1
"19357","notunfrequent",1,0,0,0,1
"19358","notventured",1,0,0,0,1
"19359","notvery",1,0,0,0,1
"19360","notwholly",1,0,0,0,1
"19361","notwish",1,0,0,0,1
"19362","notwithout",1,0,0,0,1
"19363","notwithstandingthe",1,0,0,0,1
"19364","notwo",1,0,0,0,1
"19365","notwonderful",1,0,0,0,1
"19366","notyet",1,0,0,0,1
"19367","nov",1,0,0,0,1
"19368","now.a",1,0,0,0,1
"19369","now.satisfied",1,0,0,0,1
"19370","nowa",1,0,0,0,1
"19371","nowand",1,0,0,0,1
"19372","nowdenies",1,0,0,0,1
"19373","nowdevoting",1,0,0,0,1
"19374","nowdrawn",1,0,0,0,1
"19375","nowdrove",1,0,0,0,1
"19376","nowforgot",1,0,0,0,1
"19377","nowhere",0,0,0,1,1
"19378","nowhis",1,0,0,0,1
"19379","nowshaking",1,0,0,0,1
"19380","nowshooting",1,0,0,0,1
"19381","nowthought",1,0,0,0,1
"19382","nowwas",1,0,0,0,1
"19383","nowwish",1,0,0,0,1
"19384","nucleus",1,0,0,0,1
"19385","nullified.the",1,0,0,0,1
"19386","numberedthree",1,0,0,0,1
"19387","numberi",1,0,0,0,1
"19388","numberless",1,0,0,0,1
"19389","numerously",1,0,0,0,1
"19390","nursery",0,1,0,0,1
"19391","nurture",0,1,0,0,1
"19392","nutrix",0,1,0,0,1
"19393","nuts",1,0,0,0,1
"19394","o.wattles",1,0,0,0,1
"19395","o’connellsaid",1,0,0,0,1
"19396","o’nine",0,1,0,0,1
"19397","oaks",1,0,0,0,1
"19398","oars",1,0,0,0,1
"19399","oberlin",1,0,0,0,1
"19400","obeyedthe",1,0,0,0,1
"19401","objectionable",1,0,0,0,1
"19402","objectively",1,0,0,0,1
"19403","objects.i",1,0,0,0,1
"19404","obligationsto",1,0,0,0,1
"19405","obligationto",1,0,0,0,1
"19406","oblige",1,0,0,0,1
"19407","obliquity",1,0,0,0,1
"19408","obliterate",0,0,1,0,1
"19409","obliterated",0,1,0,0,1
"19410","obliterating",0,1,0,0,1
"19411","oblivion",0,0,0,1,1
"19412","obolisk ",0,0,0,1,1
"19413","obolisque",0,0,0,1,1
"19414","obscurityis",1,0,0,0,1
"19415","obsequiousness",0,1,0,0,1
"19416","observable",0,1,0,0,1
"19417","observance",1,0,0,0,1
"19418","observant",1,0,0,0,1
"19419","observations",0,1,0,0,1
"19420","observationto",1,0,0,0,1
"19421","observedthat",1,0,0,0,1
"19422","observedtowards",1,0,0,0,1
"19423","observer",0,1,0,0,1
"19424","observers.i",1,0,0,0,1
"19425","obstructed",0,1,0,0,1
"19426","obstructing",1,0,0,0,1
"19427","obstruction",0,1,0,0,1
"19428","obtainedat",1,0,0,0,1
"19429","obtainedcomplete",1,0,0,0,1
"19430","obtaintheir",1,0,0,0,1
"19431","obtrudingitself",1,0,0,0,1
"19432","obtrusive",1,0,0,0,1
"19433","obtuseness",0,1,0,0,1
"19434","occasion.among",1,0,0,0,1
"19435","occasionally.he",1,0,0,0,1
"19436","occasionallydid",1,0,0,0,1
"19437","occasionalrelief",1,0,0,0,1
"19438","occasionedby",1,0,0,0,1
"19439","occasionedhad",1,0,0,0,1
"19440","occasionedthe",1,0,0,0,1
"19441","occasionfor",1,0,0,0,1
"19442","occasionpass",1,0,0,0,1
"19443","occasionsix",1,0,0,0,1
"19444","occupation.in",1,0,0,0,1
"19445","occupied.old",1,0,0,0,1
"19446","occupiedby",1,0,0,0,1
"19447","occupypositions",1,0,0,0,1
"19448","occurred.on",1,0,0,0,1
"19449","occurrences.my",1,0,0,0,1
"19450","oclo",0,0,0,1,1
"19451","oclock",0,0,0,1,1
"19452","of.such",1,0,0,0,1
"19453","ofabolition",1,0,0,0,1
"19454","ofabout",1,0,0,0,1
"19455","ofabraham",1,0,0,0,1
"19456","ofabuse",1,0,0,0,1
"19457","ofadvice",1,0,0,0,1
"19458","ofafter",1,0,0,0,1
"19459","ofages",1,0,0,0,1
"19460","ofalmost",1,0,0,0,1
"19461","ofanimosity",1,0,0,0,1
"19462","ofarrest",1,0,0,0,1
"19463","ofatrocities",1,0,0,0,1
"19464","ofattack",1,0,0,0,1
"19465","ofaversion",1,0,0,0,1
"19466","ofbalsam",1,0,0,0,1
"19467","ofbrown’s",1,0,0,0,1
"19468","ofbuchanan’s",1,0,0,0,1
"19469","ofburden",1,0,0,0,1
"19470","ofby",1,0,0,0,1
"19471","ofcanada",1,0,0,0,1
"19472","ofcaptain",1,0,0,0,1
"19473","ofchagrin",1,0,0,0,1
"19474","ofcharacter",1,0,0,0,1
"19475","ofcharge",1,0,0,0,1
"19476","ofcircumstances",1,0,0,0,1
"19477","ofcolor",1,0,0,0,1
"19478","ofcolored",1,0,0,0,1
"19479","ofcommunism",1,0,0,0,1
"19480","ofcompensation",1,0,0,0,1
"19481","ofcomplicity",1,0,0,0,1
"19482","ofconquest",1,0,0,0,1
"19483","ofconsequences",1,0,0,0,1
"19484","ofconsistency",1,0,0,0,1
"19485","ofdefeat.another",1,0,0,0,1
"19486","ofdelivering",1,0,0,0,1
"19487","ofdemocratic",1,0,0,0,1
"19488","ofdenying",1,0,0,0,1
"19489","ofdifference",1,0,0,0,1
"19490","ofdigging",1,0,0,0,1
"19491","ofdisruption",1,0,0,0,1
"19492","ofdoing",1,0,0,0,1
"19493","ofdoors",1,0,0,0,1
"19494","ofdoubtful",1,0,0,0,1
"19495","ofdr",1,0,0,0,1
"19496","ofemancipation",1,0,0,0,1
"19497","ofengland",1,0,0,0,1
"19498","oferrands",1,0,0,0,1
"19499","ofexpediency",1,0,0,0,1
"19500","offendedthis",1,0,0,0,1
"19501","offerhis",1,0,0,0,1
"19502","offerings",0,0,0,1,1
"19503","office.but",1,0,0,0,1
"19504","officeof",1,0,0,0,1
"19505","officeon",1,0,0,0,1
"19506","officeshe",1,0,0,0,1
"19507","officeunder",1,0,0,0,1
"19508","officials",1,0,0,0,1
"19509","officious",0,1,0,0,1
"19510","offifteen",1,0,0,0,1
"19511","offlesh",1,0,0,0,1
"19512","offloggings",1,0,0,0,1
"19513","offlorida",1,0,0,0,1
"19514","offood",1,0,0,0,1
"19515","offsomewhere",1,0,0,0,1
"19516","offthe",1,0,0,0,1
"19517","offwithout",1,0,0,0,1
"19518","ofgen",1,0,0,0,1
"19519","ofgeneralization",1,0,0,0,1
"19520","ofgenerous",1,0,0,0,1
"19521","ofgod",1,0,0,0,1
"19522","ofgod’s",1,0,0,0,1
"19523","ofgolden",1,0,0,0,1
"19524","ofgrace",1,0,0,0,1
"19525","ofgrant",1,0,0,0,1
"19526","ofgreat",1,0,0,0,1
"19527","ofhalf",1,0,0,0,1
"19528","ofhard",1,0,0,0,1
"19529","ofharper’s",1,0,0,0,1
"19530","ofharsh",1,0,0,0,1
"19531","ofhearts",1,0,0,0,1
"19532","ofholidays",1,0,0,0,1
"19533","ofholy",1,0,0,0,1
"19534","ofhope",1,0,0,0,1
"19535","ofhuman",1,0,0,0,1
"19536","ofhumanity",1,0,0,0,1
"19537","ofimpartiality",1,0,0,0,1
"19538","ofindiana",1,0,0,0,1
"19539","ofinjustice",1,0,0,0,1
"19540","ofintending",1,0,0,0,1
"19541","ofintroduction",1,0,0,0,1
"19542","ofjack",1,0,0,0,1
"19543","ofjuly",1,0,0,0,1
"19544","ofkindred",1,0,0,0,1
"19545","oflaborers",1,0,0,0,1
"19546","oflearning",1,0,0,0,1
"19547","ofleaving",1,0,0,0,1
"19548","oflight",1,0,0,0,1
"19549","oflincoln",1,0,0,0,1
"19550","oflittle",1,0,0,0,1
"19551","ofliving",1,0,0,0,1
"19552","oflucy",1,0,0,0,1
"19553","ofman",1,0,0,0,1
"19554","ofman’s",1,0,0,0,1
"19555","ofmankind",1,0,0,0,1
"19556","ofmany",1,0,0,0,1
"19557","ofmaryland",1,0,0,0,1
"19558","ofmason",1,0,0,0,1
"19559","ofmassachusetts",1,0,0,0,1
"19560","ofme",1,0,0,0,1
"19561","ofmeaning",1,0,0,0,1
"19562","ofmeeting",1,0,0,0,1
"19563","ofmen",1,0,0,0,1
"19564","ofmirth",1,0,0,0,1
"19565","ofmoss",1,0,0,0,1
"19566","ofmuch",1,0,0,0,1
"19567","ofnational",1,0,0,0,1
"19568","ofnations",1,0,0,0,1
"19569","ofnature",1,0,0,0,1
"19570","ofnegro",1,0,0,0,1
"19571","ofnewspaper",1,0,0,0,1
"19572","ofnovember",1,0,0,0,1
"19573","ofobtaining",1,0,0,0,1
"19574","ofoil",1,0,0,0,1
"19575","ofone",1,0,0,0,1
"19576","ofopposition",1,0,0,0,1
"19577","ofother",1,0,0,0,1
"19578","ofothers",1,0,0,0,1
"19579","ofover",1,0,0,0,1
"19580","ofoverseers",1,0,0,0,1
"19581","ofpassing",1,0,0,0,1
"19582","ofpassion",1,0,0,0,1
"19583","ofpeace",1,0,0,0,1
"19584","ofpistols",1,0,0,0,1
"19585","ofpleasure",1,0,0,0,1
"19586","ofpossessing.to",1,0,0,0,1
"19587","ofprayer",1,0,0,0,1
"19588","ofprejudice",1,0,0,0,1
"19589","ofpreparation",1,0,0,0,1
"19590","ofpride",1,0,0,0,1
"19591","ofproperty",1,0,0,0,1
"19592","ofproperty.another",1,0,0,0,1
"19593","ofrace",1,0,0,0,1
"19594","ofreason",1,0,0,0,1
"19595","ofreligion",1,0,0,0,1
"19596","ofresolutions",1,0,0,0,1
"19597","ofretaining",1,0,0,0,1
"19598","ofreverence",1,0,0,0,1
"19599","ofrobbery",1,0,0,0,1
"19600","ofrochester",1,0,0,0,1
"19601","ofsaying",1,0,0,0,1
"19602","ofself",1,0,0,0,1
"19603","ofsetting",1,0,0,0,1
"19604","ofshadrack",1,0,0,0,1
"19605","ofsheep",1,0,0,0,1
"19606","ofslave",1,0,0,0,1
"19607","ofslaveholding",1,0,0,0,1
"19608","ofsome",1,0,0,0,1
"19609","ofsouthern",1,0,0,0,1
"19610","ofstrangers",1,0,0,0,1
"19611","ofstreet",1,0,0,0,1
"19612","ofsuccess.i",1,0,0,0,1
"19613","ofsuccessful",1,0,0,0,1
"19614","ofsuch",1,0,0,0,1
"19615","ofsunday",1,0,0,0,1
"19616","often",0,0,0,1,1
"19617","oftenas",1,0,0,0,1
"19618","oftendid",1,0,0,0,1
"19619","oftenerwho",1,0,0,0,1
"19620","oftenpunished",1,0,0,0,1
"19621","oftentimes",1,0,0,0,1
"19622","oftents",1,0,0,0,1
"19623","oftenwounded",1,0,0,0,1
"19624","ofthat",1,0,0,0,1
"19625","ofthinking",1,0,0,0,1
"19626","ofthose",1,0,0,0,1
"19627","ofthought",1,0,0,0,1
"19628","oftime",1,0,0,0,1
"19629","oftimidity",1,0,0,0,1
"19630","oftransgression",1,0,0,0,1
"19631","oftrial",1,0,0,0,1
"19632","oftrial.those",1,0,0,0,1
"19633","ofttimes",0,1,0,0,1
"19634","oftwo",1,0,0,0,1
"19635","ofunderstanding",1,0,0,0,1
"19636","ofunmixed",1,0,0,0,1
"19637","ofunrequited",1,0,0,0,1
"19638","ofunruffled",1,0,0,0,1
"19639","ofunscrupulous",1,0,0,0,1
"19640","ofveterans",1,0,0,0,1
"19641","ofviolence",1,0,0,0,1
"19642","ofvulgarity",1,0,0,0,1
"19643","ofweariness",1,0,0,0,1
"19644","ofwhipping",1,0,0,0,1
"19645","ofwhippings",1,0,0,0,1
"19646","ofwhom",1,0,0,0,1
"19647","ofwidely",1,0,0,0,1
"19648","ofwild",1,0,0,0,1
"19649","ofwinter",1,0,0,0,1
"19650","ofwisdom",1,0,0,0,1
"19651","ofwit",1,0,0,0,1
"19652","ofwrath",1,0,0,0,1
"19653","oiledmachinery",1,0,0,0,1
"19654","oldblacksmith’s",1,0,0,0,1
"19655","oldbroadway",1,0,0,0,1
"19656","oldclothes",1,0,0,0,1
"19657","older",0,0,0,1,1
"19658","oldest",0,0,0,1,1
"19659","oldfriend",1,0,0,0,1
"19660","oldhe",1,0,0,0,1
"19661","oldlogs",1,0,0,0,1
"19662","oldmassachusetts",1,0,0,0,1
"19663","oldmaster’s",1,0,0,0,1
"19664","oldopponents",1,0,0,0,1
"19665","oldslave",1,0,0,0,1
"19666","oldspelling",1,0,0,0,1
"19667","oldsuspicion",1,0,0,0,1
"19668","oldtown",1,0,0,0,1
"19669","oldwoods",1,0,0,0,1
"19670","olive",0,0,0,1,1
"19671","oliver",1,0,0,0,1
"19672","ollilea",0,0,0,1,1
"19673","omage",0,0,0,1,1
"19674","ominous",0,1,0,0,1
"19675","omnibus",0,1,0,0,1
"19676","omnibuses",0,0,0,1,1
"19677","omnibusto",1,0,0,0,1
"19678","omnipotent",0,1,0,0,1
"19679","on.i",1,0,0,0,1
"19680","ona",1,0,0,0,1
"19681","onbeing",1,0,0,0,1
"19682","once.from",1,0,0,0,1
"19683","once.i’ll",1,0,0,0,1
"19684","onceknown",1,0,0,0,1
"19685","oncemistress",1,0,0,0,1
"19686","oncethat",1,0,0,0,1
"19687","oncethoroughly",1,0,0,0,1
"19688","oncol",1,0,0,0,1
"19689","ondashing",0,0,0,1,1
"19690","one ",0,0,0,1,1
"19691","one.first",1,0,0,0,1
"19692","one.he",1,0,0,0,1
"19693","one.the",1,0,0,0,1
"19694","onebelonging",1,0,0,0,1
"19695","onecart",1,0,0,0,1
"19696","onechild",1,0,0,0,1
"19697","onecrevice",1,0,0,0,1
"19698","oneentirely",1,0,0,0,1
"19699","onehand",1,0,0,0,1
"19700","onemarked",1,0,0,0,1
"19701","onemay",1,0,0,0,1
"19702","onemore",1,0,0,0,1
"19703","oneor",1,0,0,0,1
"19704","oneother",1,0,0,0,1
"19705","onepart",1,0,0,0,1
"19706","oneperson",1,0,0,0,1
"19707","ones",0,0,0,1,1
"19708","ones.of",1,0,0,0,1
"19709","oneself",1,0,0,0,1
"19710","oneside",0,0,0,1,1
"19711","onesowed",1,0,0,0,1
"19712","onething",1,0,0,0,1
"19713","onetime",1,0,0,0,1
"19714","onewho",1,0,0,0,1
"19715","oneword",1,0,0,0,1
"19716","oneyear",1,0,0,0,1
"19717","onhere",1,0,0,0,1
"19718","onit",1,0,0,0,1
"19719","onlychance",1,0,0,0,1
"19720","onlyforeshadow",1,0,0,0,1
"19721","onlyhad",1,0,0,0,1
"19722","onlyprecaution",1,0,0,0,1
"19723","onlyrecollections",1,0,0,0,1
"19724","onlysay",1,0,0,0,1
"19725","onlyto",1,0,0,0,1
"19726","onlywe",1,0,0,0,1
"19727","onlywounded",1,0,0,0,1
"19728","onmore",1,0,0,0,1
"19729","onreading",1,0,0,0,1
"19730","onsetting",1,0,0,0,1
"19731","onsome",1,0,0,0,1
"19732","onspecial",1,0,0,0,1
"19733","ontarioand",1,0,0,0,1
"19734","onthat",1,0,0,0,1
"19735","onthose",1,0,0,0,1
"19736","onward.thus",1,0,0,0,1
"19737","onwhich",1,0,0,0,1
"19738","oozy",1,0,0,0,1
"19739","oped",0,0,1,0,1
"19740","open",0,0,0,1,1
"19741","opened",0,0,0,1,1
"19742","openedthe",1,0,0,0,1
"19743","openedupon",1,0,0,0,1
"19744","opens",0,0,0,1,1
"19745","opento",1,0,0,0,1
"19746","openviolation",1,0,0,0,1
"19747","operate",1,0,0,0,1
"19748","operated",1,0,0,0,1
"19749","operation.from",1,0,0,0,1
"19750","operationof",1,0,0,0,1
"19751","opinionwas",1,0,0,0,1
"19752","opnions",0,0,0,1,1
"19753","oponents",0,1,0,0,1
"19754","opportunitiesfor",1,0,0,0,1
"19755","oppose.fellow",1,0,0,0,1
"19756","opposedthe",1,0,0,0,1
"19757","opposes",1,0,0,0,1
"19758","oppositionfrom",1,0,0,0,1
"19759","oppositionin",1,0,0,0,1
"19760","oppressed.the",1,0,0,0,1
"19761","ora",1,0,0,0,1
"19762","oracted",1,0,0,0,1
"19763","oran",0,0,0,1,1
"19764","orarrangement",1,0,0,0,1
"19765","oras",1,0,0,0,1
"19766","orat",1,0,0,0,1
"19767","oratorwere",1,0,0,0,1
"19768","oratorymr",1,0,0,0,1
"19769","orattempted",1,0,0,0,1
"19770","orbenefactors",1,0,0,0,1
"19771","orblast",1,0,0,0,1
"19772","orblows",1,0,0,0,1
"19773","orcolored",1,0,0,0,1
"19774","orcontracted",1,0,0,0,1
"19775","order.half",1,0,0,0,1
"19776","orderly",0,0,0,1,1
"19777","ordersfrom",1,0,0,0,1
"19778","ordinarysalutations",1,0,0,0,1
"19779","ordriven",1,0,0,0,1
"19780","ordry",1,0,0,0,1
"19781","orduties",1,0,0,0,1
"19782","oreffort",1,0,0,0,1
"19783","orever",1,0,0,0,1
"19784","orexceptional",1,0,0,0,1
"19785","orexclude",1,0,0,0,1
"19786","orfifteen",1,0,0,0,1
"19787","orfour",1,0,0,0,1
"19788","organizedwhat",1,0,0,0,1
"19789","orgarrets",1,0,0,0,1
"19790","orgin",0,1,0,0,1
"19791","orhe",1,0,0,0,1
"19792","orher",1,0,0,0,1
"19793","orhinders",1,0,0,0,1
"19794","oriental",0,0,0,1,1
"19795","originality",0,1,0,0,1
"19796","originatedsomewhere",1,0,0,0,1
"19797","orignally",0,1,0,0,1
"19798","orjustice",1,0,0,0,1
"19799","orleansnaturally",1,0,0,0,1
"19800","orleansthey",1,0,0,0,1
"19801","ormolestation",1,0,0,0,1
"19802","ornaments",0,0,0,1,1
"19803","ornowhere",1,0,0,0,1
"19804","orpeople",1,0,0,0,1
"19805","orphan",1,0,0,0,1
"19806","orpowerful",1,0,0,0,1
"19807","orprevious",1,0,0,0,1
"19808","orresist",1,0,0,0,1
"19809","orrespected",1,0,0,0,1
"19810","orseventy",1,0,0,0,1
"19811","orshe",1,0,0,0,1
"19812","orshunning",1,0,0,0,1
"19813","orsnow",1,0,0,0,1
"19814","orsocial",1,0,0,0,1
"19815","orson",1,0,0,0,1
"19816","orthem",1,0,0,0,1
"19817","orthirty",1,0,0,0,1
"19818","orthree",1,0,0,0,1
"19819","orto",1,0,0,0,1
"19820","ortoo",1,0,0,0,1
"19821","ortrough",1,0,0,0,1
"19822","orunfortunately",1,0,0,0,1
"19823","orvis",1,0,0,0,1
"19824","orwhitewashed",1,0,0,0,1
"19825","orworth",1,0,0,0,1
"19826","ossawatamie",1,0,0,0,1
"19827","ostracised",1,0,0,0,1
"19828","ostritch",0,0,0,1,1
"19829","othello’s",1,0,0,0,1
"19830","othelo",0,0,0,1,1
"19831","other.chapter",1,0,0,0,1
"19832","other.dr",1,0,0,0,1
"19833","other.if",1,0,0,0,1
"19834","other’sstrength",1,0,0,0,1
"19835","otheramerican",1,0,0,0,1
"19836","otherbad",1,0,0,0,1
"19837","otherboy",1,0,0,0,1
"19838","otherchildren",1,0,0,0,1
"19839","othercities",1,0,0,0,1
"19840","otherclothes",1,0,0,0,1
"19841","othercoachmen",1,0,0,0,1
"19842","othercourse",1,0,0,0,1
"19843","otherday",1,0,0,0,1
"19844","otherduties",1,0,0,0,1
"19845","otheremergencies",1,0,0,0,1
"19846","otherfellow",1,0,0,0,1
"19847","otherfor",1,0,0,0,1
"19848","otherladies",1,0,0,0,1
"19849","othermen",1,0,0,0,1
"19850","othernation",1,0,0,0,1
"19851","otherobject",1,0,0,0,1
"19852","otherobjections",1,0,0,0,1
"19853","otherpapers",1,0,0,0,1
"19854","otherpassengers.chapter",1,0,0,0,1
"19855","otherpoints",1,0,0,0,1
"19856","otherpossible",1,0,0,0,1
"19857","others",0,0,0,1,1
"19858","others.of",1,0,0,0,1
"19859","others.there",1,0,0,0,1
"19860","others.while",1,0,0,0,1
"19861","othersan",1,0,0,0,1
"19862","otherspot",1,0,0,0,1
"19863","othersubjects",1,0,0,0,1
"19864","othertimes",1,0,0,0,1
"19865","othertrying",1,0,0,0,1
"19866","otherwise",0,0,0,1,1
"19867","otherwiseassisting",1,0,0,0,1
"19868","otherwiseknown",1,0,0,0,1
"19869","otheryoung",1,0,0,0,1
"19870","otis",1,0,0,0,1
"19871","ottilia",1,0,0,0,1
"19872","ouly",0,0,0,1,1
"19873","ouradvantage",1,0,0,0,1
"19874","ourarrival",1,0,0,0,1
"19875","ourassembling",1,0,0,0,1
"19876","ourbeing",1,0,0,0,1
"19877","ourblood",1,0,0,0,1
"19878","ourbondage.i",1,0,0,0,1
"19879","ourboundaries.this",1,0,0,0,1
"19880","ourbrothers",1,0,0,0,1
"19881","ourcaptain",1,0,0,0,1
"19882","ourcause",1,0,0,0,1
"19883","ourcircumstances",1,0,0,0,1
"19884","ourcolored",1,0,0,0,1
"19885","ourcongregation",1,0,0,0,1
"19886","ourconvention",1,0,0,0,1
"19887","ourdestiny",1,0,0,0,1
"19888","ourdifferences",1,0,0,0,1
"19889","ourdoctor",1,0,0,0,1
"19890","ourdoctors",1,0,0,0,1
"19891","ourfriend",1,0,0,0,1
"19892","ourfriends",1,0,0,0,1
"19893","ourgeneral",1,0,0,0,1
"19894","ourhearts",1,0,0,0,1
"19895","ourhistory",1,0,0,0,1
"19896","ourhopes",1,0,0,0,1
"19897","ourignorance",1,0,0,0,1
"19898","ourlegislators",1,0,0,0,1
"19899","ourlines",1,0,0,0,1
"19900","ourmeeting",1,0,0,0,1
"19901","ourneighborhood",1,0,0,0,1
"19902","ourold",1,0,0,0,1
"19903","ourparty",1,0,0,0,1
"19904","ourrides",1,0,0,0,1
"19905","ourroom",1,0,0,0,1
"19906","oursabbath",1,0,0,0,1
"19907","ourselves.the",1,0,0,0,1
"19908","ourselvesand",1,0,0,0,1
"19909","ourselvesas",1,0,0,0,1
"19910","ourselveseverything",1,0,0,0,1
"19911","oursense",1,0,0,0,1
"19912","ourservices",1,0,0,0,1
"19913","ourships",1,0,0,0,1
"19914","oursisterhood",1,0,0,0,1
"19915","oursufferings",1,0,0,0,1
"19916","ourtalk",1,0,0,0,1
"19917","ourthanks.mr",1,0,0,0,1
"19918","ourvisit",1,0,0,0,1
"19919","ourvoice",1,0,0,0,1
"19920","out_",0,1,0,0,1
"19921","outbreak",0,1,0,0,1
"19922","outbursts",0,1,0,0,1
"19923","outdoor",1,0,0,0,1
"19924","outdoubtless",1,0,0,0,1
"19925","outer",0,1,0,0,1
"19926","outgoing",1,0,0,0,1
"19927","outgrow",0,1,0,0,1
"19928","outgrowths",0,1,0,0,1
"19929","outin",1,0,0,0,1
"19930","outlayof",1,0,0,0,1
"19931","outline",0,1,0,0,1
"19932","outlines",0,1,0,0,1
"19933","outlying",1,0,0,0,1
"19934","outno",1,0,0,0,1
"19935","outpourings",0,1,0,0,1
"19936","outrageous",0,1,0,0,1
"19937","outragesdeep",1,0,0,0,1
"19938","outrageswhich",1,0,0,0,1
"19939","outrageupon",1,0,0,0,1
"19940","outset",1,0,0,0,1
"19941","outsideof",1,0,0,0,1
"19942","outsiders",0,1,0,0,1
"19943","outsidersinterested",1,0,0,0,1
"19944","outsidethe",1,0,0,0,1
"19945","outskirts",0,0,1,0,1
"19946","outstrip",0,1,0,0,1
"19947","outthat",1,0,0,0,1
"19948","outthoughts",1,0,0,0,1
"19949","outwardly",0,0,1,0,1
"19950","outwardrelations",1,0,0,0,1
"19951","outwardseeming",1,0,0,0,1
"19952","ovens",0,1,0,0,1
"19953","over_",0,1,0,0,1
"19954","overa",1,0,0,0,1
"19955","overamerican",1,0,0,0,1
"19956","overbearing",0,1,0,0,1
"19957","overborne",0,0,1,0,1
"19958","overcame",0,0,1,0,1
"19959","overclean",0,1,0,0,1
"19960","overcomingone",1,0,0,0,1
"19961","overflowed",1,0,0,0,1
"19962","overflowing",1,0,0,0,1
"19963","overflowingwith",1,0,0,0,1
"19964","overhang",1,0,0,0,1
"19965","overhear",1,0,0,0,1
"19966","overjoyed",0,1,0,0,1
"19967","overkind",0,0,1,0,1
"19968","overleaped",1,0,0,0,1
"19969","overruling",0,1,0,0,1
"19970","overseer.i",1,0,0,0,1
"19971","overseer.such",1,0,0,0,1
"19972","overseerand",1,0,0,0,1
"19973","overseerhad",1,0,0,0,1
"19974","overseers.in",1,0,0,0,1
"19975","oversight",0,1,0,0,1
"19976","oversightof",1,0,0,0,1
"19977","oversleeping",0,1,0,0,1
"19978","overstates",0,0,1,0,1
"19979","overt",1,0,0,0,1
"19980","overthem",1,0,0,0,1
"19981","overthrown",0,1,0,0,1
"19982","overthrowthem",1,0,0,0,1
"19983","overwhelmedby",1,0,0,0,1
"19984","overwith",1,0,0,0,1
"19985","overwork",0,1,0,0,1
"19986","owedhim",1,0,0,0,1
"19987","oweners",0,0,0,1,1
"19988","owls",1,0,0,0,1
"19989","own_",1,0,0,0,1
"19990","ownconduct",1,0,0,0,1
"19991","owncontracts",1,0,0,0,1
"19992","ownedand",1,0,0,0,1
"19993","ownedyour",1,0,0,0,1
"19994","owner.a",1,0,0,0,1
"19995","owners.for",1,0,0,0,1
"19996","ownershipof",1,0,0,0,1
"19997","ownexistence",1,0,0,0,1
"19998","ownforce",1,0,0,0,1
"19999","ownglory",1,0,0,0,1
"20000","owngood",1,0,0,0,1
"20001","ownknowledge",1,0,0,0,1
"20002","ownlabor",1,0,0,0,1
"20003","ownlife",1,0,0,0,1
"20004","ownloneliness",1,0,0,0,1
"20005","ownme",1,0,0,0,1
"20006","ownrace",1,0,0,0,1
"20007","ownwiry",1,0,0,0,1
"20008","oxenentangled",1,0,0,0,1
"20009","oxenstarted",1,0,0,0,1
"20010","oxenwere",1,0,0,0,1
"20011","p.rodgers",1,0,0,0,1
"20012","pacas",1,0,0,0,1
"20013","pacific",0,1,0,0,1
"20014","pacified",1,0,0,0,1
"20015","packthe",1,0,0,0,1
"20016","paddy",1,0,0,0,1
"20017","pagani",0,0,0,1,1
"20018","pageant",1,0,0,0,1
"20019","paidfor",1,0,0,0,1
"20020","paidmy",1,0,0,0,1
"20021","paidno",1,0,0,0,1
"20022","paine",1,0,0,0,1
"20023","painful.besides",1,0,0,0,1
"20024","painfullyfamiliar",1,0,0,0,1
"20025","painfulto",1,0,0,0,1
"20026","painting",0,1,0,0,1
"20027","pairof",1,0,0,0,1
"20028","pairs",1,0,0,0,1
"20029","palaces",0,0,0,1,1
"20030","palatable",0,1,0,0,1
"20031","palazzor",0,0,0,1,1
"20032","palfry",1,0,0,0,1
"20033","palliative",1,0,0,0,1
"20034","palm",0,1,0,0,1
"20035","palmas",0,1,0,0,1
"20036","palmed",0,0,0,1,1
"20037","palpably",0,0,1,0,1
"20038","palpitating",0,1,0,0,1
"20039","pamphlets",1,0,0,0,1
"20040","panoply",1,0,0,0,1
"20041","pantomine",0,0,0,1,1
"20042","papacy",0,0,0,1,1
"20043","papal",1,0,0,0,1
"20044","paper_",1,0,0,0,1
"20045","paperbut",1,0,0,0,1
"20046","paperexists.one",1,0,0,0,1
"20047","papers.but",1,0,0,0,1
"20048","papersthe",1,0,0,0,1
"20049","paperwas",1,0,0,0,1
"20050","par",0,0,0,1,1
"20051","paraded",1,0,0,0,1
"20052","paragon",0,1,0,0,1
"20053","paragraph",1,0,0,0,1
"20054","paralyze",1,0,0,0,1
"20055","paralyzing",0,1,0,0,1
"20056","paramount",1,0,0,0,1
"20057","parapets",1,0,0,0,1
"20058","paraphernalia",0,1,0,0,1
"20059","parcelsor",1,0,0,0,1
"20060","parchment",0,1,0,0,1
"20061","parchment.if",1,0,0,0,1
"20062","pardoned",1,0,0,0,1
"20063","parentage",0,0,1,0,1
"20064","parentcould",1,0,0,0,1
"20065","parentsmust",1,0,0,0,1
"20066","parleying",0,1,0,0,1
"20067","parlorsoccupied",1,0,0,0,1
"20068","parricide",1,0,0,0,1
"20069","partaking",0,1,0,0,1
"20070","partchapter",1,0,0,0,1
"20071","partfor",1,0,0,0,1
"20072","partialand",1,0,0,0,1
"20073","participant",0,0,1,0,1
"20074","participatedas",1,0,0,0,1
"20075","participationin",1,0,0,0,1
"20076","particularlyrelated",1,0,0,0,1
"20077","parting",0,0,0,1,1
"20078","partlyconstitutional",1,0,0,0,1
"20079","partook",1,0,0,0,1
"20080","partsof",1,0,0,0,1
"20081","partthe",1,0,0,0,1
"20082","partus",0,0,0,1,1
"20083","party.during",1,0,0,0,1
"20084","party.here",1,0,0,0,1
"20085","partyat",1,0,0,0,1
"20086","partyearnestly",1,0,0,0,1
"20087","partyhave",1,0,0,0,1
"20088","partythat",1,0,0,0,1
"20089","partywhich",1,0,0,0,1
"20090","passagesto",1,0,0,0,1
"20091","passedaround",1,0,0,0,1
"20092","passeddelightfully",1,0,0,0,1
"20093","passedround",1,0,0,0,1
"20094","passedthis",1,0,0,0,1
"20095","passenger.american",1,0,0,0,1
"20096","passengers.this",1,0,0,0,1
"20097","passengers.thousands",1,0,0,0,1
"20098","passengersalighted",1,0,0,0,1
"20099","passesbeen",1,0,0,0,1
"20100","passingfrom",1,0,0,0,1
"20101","passinglaws",1,0,0,0,1
"20102","passingover",1,0,0,0,1
"20103","passionately",0,1,0,0,1
"20104","passlaws",1,0,0,0,1
"20105","password",1,0,0,0,1
"20106","past.though",1,0,0,0,1
"20107","pastdifferences",1,0,0,0,1
"20108","pastoral",1,0,0,0,1
"20109","pastseven",1,0,0,0,1
"20110","patch",1,0,0,0,1
"20111","pate",1,0,0,0,1
"20112","pateoli",0,0,0,1,1
"20113","paternal",0,1,0,0,1
"20114","paterson",1,0,0,0,1
"20115","path.i",1,0,0,0,1
"20116","pathof",1,0,0,0,1
"20117","patience:no",1,0,0,0,1
"20118","patriarch",0,0,0,1,1
"20119","patriarchal",0,1,0,0,1
"20120","patrician",1,0,0,0,1
"20121","patriot",1,0,0,0,1
"20122","patriotically",1,0,0,0,1
"20123","patrioticcabinet",1,0,0,0,1
"20124","patrioticdeclamation",1,0,0,0,1
"20125","patriotismof",1,0,0,0,1
"20126","patrols",0,0,1,0,1
"20127","patronage",1,0,0,0,1
"20128","patronized",0,1,0,0,1
"20129","patrons",1,0,0,0,1
"20130","patton",1,0,0,0,1
"20131","paul’s",1,0,0,0,1
"20132","pauls",0,0,0,1,1
"20133","pawtucket",1,0,0,0,1
"20134","paymy",1,0,0,0,1
"20135","payne",1,0,0,0,1
"20136","payoff",1,0,0,0,1
"20137","pazzuoli",0,0,0,1,1
"20138","pea",0,1,0,0,1
"20139","peabody",1,0,0,0,1
"20140","peace.here",1,0,0,0,1
"20141","peace.it",1,0,0,0,1
"20142","peace.the",1,0,0,0,1
"20143","peaceand",1,0,0,0,1
"20144","peacefully",0,0,0,1,1
"20145","peacemakers",1,0,0,0,1
"20146","peachy",0,1,0,0,1
"20147","peakers",0,1,0,0,1
"20148","peal",0,1,0,0,1
"20149","pearl",0,1,0,0,1
"20150","pears",0,1,0,0,1
"20151","peasing",0,0,0,1,1
"20152","pecking",1,0,0,0,1
"20153","peculiarlywoman’s",1,0,0,0,1
"20154","pecuniarily",1,0,0,0,1
"20155","pecuniaryadvantage",1,0,0,0,1
"20156","pedestal",0,0,0,1,1
"20157","peeled",0,1,0,0,1
"20158","peeping",0,0,0,1,1
"20159","peicer",0,0,0,1,1
"20160","pelicans",0,0,0,1,1
"20161","penaltiesimposed",1,0,0,0,1
"20162","pence",0,1,0,0,1
"20163","pencels",0,0,0,1,1
"20164","pendleton",1,0,0,0,1
"20165","penetrating",0,1,0,0,1
"20166","peninsuladisasters",1,0,0,0,1
"20167","penned",0,1,0,0,1
"20168","pennsylvaniato",1,0,0,0,1
"20169","penny",0,1,0,0,1
"20170","pent",0,1,0,0,1
"20171","people’s",0,0,1,0,1
"20172","peopleand",1,0,0,0,1
"20173","peopleattended",1,0,0,0,1
"20174","peoplecame",1,0,0,0,1
"20175","peoplehave",1,0,0,0,1
"20176","peoples",0,0,0,1,1
"20177","peoplesaid",1,0,0,0,1
"20178","peoplethemselves",1,0,0,0,1
"20179","peoplewere",1,0,0,0,1
"20180","peoture",0,0,0,1,1
"20181","per",0,0,0,1,1
"20182","perambulate",0,1,0,0,1
"20183","perceiving",0,0,0,1,1
"20184","perdition",0,0,1,0,1
"20185","peremptory",0,1,0,0,1
"20186","perfectthat",1,0,0,0,1
"20187","perfidious",1,0,0,0,1
"20188","perforce",0,1,0,0,1
"20189","performer",0,1,0,0,1
"20190","performerimprovised",1,0,0,0,1
"20191","performinga",1,0,0,0,1
"20192","perhapsbe",1,0,0,0,1
"20193","perhapsit",1,0,0,0,1
"20194","perhapsmore",1,0,0,0,1
"20195","periodically",0,1,0,0,1
"20196","periodof",1,0,0,0,1
"20197","periods",0,0,0,1,1
"20198","periodsthe",1,0,0,0,1
"20199","perjury",1,0,0,0,1
"20200","permeated",1,0,0,0,1
"20201","permiss",0,0,0,1,1
"20202","permittedalabamas",1,0,0,0,1
"20203","permittedto",1,0,0,0,1
"20204","permitting",0,1,0,0,1
"20205","perpetuatea",1,0,0,0,1
"20206","perplexingquestions",1,0,0,0,1
"20207","perplexity",0,1,0,0,1
"20208","persecutors",0,1,0,0,1
"20209","persians",0,0,0,1,1
"20210","person’s",0,1,0,0,1
"20211","personages",0,0,0,1,1
"20212","personating",1,0,0,0,1
"20213","personify",0,0,0,1,1
"20214","persons.they",1,0,0,0,1
"20215","personsfrom",1,0,0,0,1
"20216","personsof",1,0,0,0,1
"20217","personsshould",1,0,0,0,1
"20218","persuading",1,0,0,0,1
"20219","peruse",0,0,1,0,1
"20220","perused",0,1,0,0,1
"20221","perusing",0,1,0,0,1
"20222","pervading",1,0,0,0,1
"20223","perverse",1,0,0,0,1
"20224","perversion",1,0,0,0,1
"20225","pervert",1,0,0,0,1
"20226","perweek",1,0,0,0,1
"20227","pest",0,1,0,0,1
"20228","pestilenceon",1,0,0,0,1
"20229","pests",0,1,0,0,1
"20230","peterboro",1,0,0,0,1
"20231","petitioners",0,1,0,0,1
"20232","petitionto",1,0,0,0,1
"20233","petrified",0,1,0,0,1
"20234","petro",0,0,0,1,1
"20235","petulance",0,1,0,0,1
"20236","petulence",1,0,0,0,1
"20237","phaeton",1,0,0,0,1
"20238","phalanx",1,0,0,0,1
"20239","phantoms",0,1,0,0,1
"20240","phantomswhich",1,0,0,0,1
"20241","pharaohs",0,0,0,1,1
"20242","pharisaical",0,0,1,0,1
"20243","pharoahs",0,0,0,1,1
"20244","phebe",1,0,0,0,1
"20245","philadelphia.great",1,0,0,0,1
"20246","philadelphia.the",1,0,0,0,1
"20247","philadelphiasteamers",1,0,0,0,1
"20248","philanthropy",1,0,0,0,1
"20249","phillip",1,0,0,0,1
"20250","phillipsthought",1,0,0,0,1
"20251","philosophicaldiscussion",1,0,0,0,1
"20252","philosophicalin",1,0,0,0,1
"20253","philosophically",1,0,0,0,1
"20254","philosophize",0,1,0,0,1
"20255","phip",0,1,0,0,1
"20256","phonography",1,0,0,0,1
"20257","phraseology",1,0,0,0,1
"20258","phrenology",1,0,0,0,1
"20259","physicalperfections",1,0,0,0,1
"20260","physicalstrength",1,0,0,0,1
"20261","physician",0,1,0,0,1
"20262","physiologists",0,1,0,0,1
"20263","pickering",0,1,0,0,1
"20264","picturing",1,0,0,0,1
"20265","piecefor",1,0,0,0,1
"20266","piercingcries",1,0,0,0,1
"20267","piety.my",1,0,0,0,1
"20268","piledby",1,0,0,0,1
"20269","pileof",1,0,0,0,1
"20270","piles",0,0,0,1,1
"20271","pilgrims",0,0,1,0,1
"20272","pillarswithout",1,0,0,0,1
"20273","pillory",0,1,0,0,1
"20274","pills",0,1,0,0,1
"20275","pillsburywould",1,0,0,0,1
"20276","pilot",0,0,0,1,1
"20277","pilots",0,0,0,1,1
"20278","pinches",0,1,0,0,1
"20279","pinching",0,1,0,0,1
"20280","pinchingfrost",1,0,0,0,1
"20281","pinchings",0,1,0,0,1
"20282","pincian",0,0,0,1,1
"20283","pined",0,1,0,0,1
"20284","pineforest",1,0,0,0,1
"20285","pines",0,0,0,1,1
"20286","pinhook",0,1,0,0,1
"20287","pining",0,1,0,0,1
"20288","piningunder",1,0,0,0,1
"20289","pintor",0,0,0,1,1
"20290","pioneer",1,0,0,0,1
"20291","pioneers",1,0,0,0,1
"20292","piously",1,0,0,0,1
"20293","pipes",0,0,0,1,1
"20294","piratical",1,0,0,0,1
"20295","pistol’s",0,1,0,0,1
"20296","pistolsand",1,0,0,0,1
"20297","pitiful",0,0,0,1,1
"20298","pitiless",0,0,1,0,1
"20299","pitilesspinchings",1,0,0,0,1
"20300","pitts",0,0,0,1,1
"20301","pittsburg",1,0,0,0,1
"20302","pitytowards",1,0,0,0,1
"20303","pius",0,0,0,1,1
"20304","place.for",1,0,0,0,1
"20305","place.he",1,0,0,0,1
"20306","place.here",1,0,0,0,1
"20307","place.his",1,0,0,0,1
"20308","place.i",1,0,0,0,1
"20309","place.on",1,0,0,0,1
"20310","place.one",1,0,0,0,1
"20311","placebut",1,0,0,0,1
"20312","placedwhere",1,0,0,0,1
"20313","placefor",1,0,0,0,1
"20314","placelike",1,0,0,0,1
"20315","placeof",1,0,0,0,1
"20316","placesin",1,0,0,0,1
"20317","placesof",1,0,0,0,1
"20318","placeswere",1,0,0,0,1
"20319","placethe",1,0,0,0,1
"20320","placewas",1,0,0,0,1
"20321","placid",0,1,0,0,1
"20322","plainer",1,0,0,0,1
"20323","plainest",1,0,0,0,1
"20324","plainlyquite",1,0,0,0,1
"20325","plainness",1,0,0,0,1
"20326","plaited",0,1,0,0,1
"20327","plancould",1,0,0,0,1
"20328","plane",1,0,0,0,1
"20329","planed",1,0,0,0,1
"20330","planet",1,0,0,0,1
"20331","plansof",1,0,0,0,1
"20332","plantationand",1,0,0,0,1
"20333","plantationof",1,0,0,0,1
"20334","plantationscurf",1,0,0,0,1
"20335","planteda",1,0,0,0,1
"20336","plantingtime",1,0,0,0,1
"20337","planto",1,0,0,0,1
"20338","plants",0,1,0,0,1
"20339","plate",1,0,0,0,1
"20340","platformon",1,0,0,0,1
"20341","plato",0,0,0,1,1
"20342","platter",0,0,1,0,1
"20343","plaudits",1,0,0,0,1
"20344","plausibility",0,1,0,0,1
"20345","plausibilty",0,1,0,0,1
"20346","playedso",1,0,0,0,1
"20347","playingabout",1,0,0,0,1
"20348","playmatesfor",1,0,0,0,1
"20349","pleads",0,1,0,0,1
"20350","pleain",1,0,0,0,1
"20351","pleaof",1,0,0,0,1
"20352","pleasantconversation",1,0,0,0,1
"20353","pleasantly",0,0,0,1,1
"20354","pleasantry",0,1,0,0,1
"20355","pleasantsunday",1,0,0,0,1
"20356","please",0,0,0,1,1
"20357","pleasedthat",1,0,0,0,1
"20358","pleasedto",1,0,0,0,1
"20359","pleaseor",1,0,0,0,1
"20360","pleasurable",0,0,1,0,1
"20361","pleasureand",1,0,0,0,1
"20362","plebeian",1,0,0,0,1
"20363","pledging",0,0,1,0,1
"20364","plies",0,0,0,1,1
"20365","plotted",0,1,0,0,1
"20366","plough",0,0,1,0,1
"20367","plume_",1,0,0,0,1
"20368","plunderingthe",1,0,0,0,1
"20369","plymouth",1,0,0,0,1
"20370","pocketknife",0,0,1,0,1
"20371","poem",1,0,0,0,1
"20372","poetry",1,0,0,0,1
"20373","pointillustrated",1,0,0,0,1
"20374","pointingher",1,0,0,0,1
"20375","pointof",1,0,0,0,1
"20376","pointwhere",1,0,0,0,1
"20377","poisoned",1,0,0,0,1
"20378","poisonof",1,0,0,0,1
"20379","poisonous",1,0,0,0,1
"20380","poking",0,1,0,0,1
"20381","poles",1,0,0,0,1
"20382","policemen",1,0,0,0,1
"20383","policyi",1,0,0,0,1
"20384","policyof",1,0,0,0,1
"20385","polish",0,1,0,0,1
"20386","politely",0,0,0,1,1
"20387","politic",1,0,0,0,1
"20388","politicalcareer",1,0,0,0,1
"20389","politicalenemies",1,0,0,0,1
"20390","politicians",1,0,0,0,1
"20391","polluting",0,1,0,0,1
"20392","pomeroy",1,0,0,0,1
"20393","pomeroy.the",1,0,0,0,1
"20394","pompei",0,0,0,1,1
"20395","pompeys",0,0,0,1,1
"20396","pompians",0,0,0,1,1
"20397","pondered",0,1,0,0,1
"20398","poorfellow",1,0,0,0,1
"20399","poorlady",1,0,0,0,1
"20400","poorwhite",1,0,0,0,1
"20401","poorwoman",1,0,0,0,1
"20402","poppie",1,0,0,0,1
"20403","popularcommander",1,0,0,0,1
"20404","populardispleasure",1,0,0,0,1
"20405","popularheart",1,0,0,0,1
"20406","populousand",1,0,0,0,1
"20407","porphose",0,0,0,1,1
"20408","porterand",1,0,0,0,1
"20409","portia",0,0,0,1,1
"20410","portionof",1,0,0,0,1
"20411","portland",1,0,0,0,1
"20412","posibility",0,1,0,0,1
"20413","position.one",1,0,0,0,1
"20414","positions.in",1,0,0,0,1
"20415","positionvanished",1,0,0,0,1
"20416","positivelaw",1,0,0,0,1
"20417","positiveness",0,1,0,0,1
"20418","possessedthe",1,0,0,0,1
"20419","possesses",1,0,0,0,1
"20420","possessesthe",1,0,0,0,1
"20421","possessionof",1,0,0,0,1
"20422","possessive",0,1,0,0,1
"20423","possiblei",1,0,0,0,1
"20424","possiblemeans",1,0,0,0,1
"20425","possiblethat",1,0,0,0,1
"20426","possiblething",1,0,0,0,1
"20427","post_",1,0,0,0,1
"20428","posterity",1,0,0,0,1
"20429","postpone",1,0,0,0,1
"20430","postseighteen",1,0,0,0,1
"20431","posturing",0,0,0,1,1
"20432","potato",0,1,0,0,1
"20433","potency",0,1,0,0,1
"20434","potentate",1,0,0,0,1
"20435","potpie",0,1,0,0,1
"20436","pounced",1,0,0,0,1
"20437","pounded",0,1,0,0,1
"20438","poundedby",1,0,0,0,1
"20439","pourout",1,0,0,0,1
"20440","pours",0,1,0,0,1
"20441","povertykept",1,0,0,0,1
"20442","powder",1,0,0,0,1
"20443","powders",0,1,0,0,1
"20444","powell",1,0,0,0,1
"20445","power.he",1,0,0,0,1
"20446","power.this",1,0,0,0,1
"20447","powerfor",1,0,0,0,1
"20448","powerfulspeeches",1,0,0,0,1
"20449","powerfulwoman",1,0,0,0,1
"20450","powerlessness",0,1,0,0,1
"20451","powers.for",1,0,0,0,1
"20452","pox",1,0,0,0,1
"20453","practicable",0,1,0,0,1
"20454","practice.when",1,0,0,0,1
"20455","practicehad",1,0,0,0,1
"20456","practiceof",1,0,0,0,1
"20457","practise",0,0,1,0,1
"20458","pratt",0,1,0,0,1
"20459","prayer_",0,1,0,0,1
"20460","prayersand",1,0,0,0,1
"20461","prayes",0,0,0,1,1
"20462","prayingfor",1,0,0,0,1
"20463","pre",0,1,0,0,1
"20464","precautions",0,1,0,0,1
"20465","precede",0,1,0,0,1
"20466","precedence",0,1,0,0,1
"20467","precedingnights",1,0,0,0,1
"20468","precept",0,1,0,0,1
"20469","preciousforever.fellow",1,0,0,0,1
"20470","preciselyas",1,0,0,0,1
"20471","preclude",1,0,0,0,1
"20472","precludes",0,1,0,0,1
"20473","prediction",1,0,0,0,1
"20474","predictions",0,1,0,0,1
"20475","predominate",0,1,0,0,1
"20476","predominates",0,1,0,0,1
"20477","preëminence",1,0,0,0,1
"20478","preeminently",0,1,0,0,1
"20479","preest",0,0,0,1,1
"20480","preferring_liberty_",1,0,0,0,1
"20481","prefixes",1,0,0,0,1
"20482","pregnable",0,1,0,0,1
"20483","prejudiceagainst",1,0,0,0,1
"20484","prejudiced",0,1,0,0,1
"20485","prejudices.in",1,0,0,0,1
"20486","prejudiceunpopular",1,0,0,0,1
"20487","premaere",0,0,0,1,1
"20488","premium",1,0,0,0,1
"20489","preparedfor",1,0,0,0,1
"20490","prepares",1,0,0,0,1
"20491","preponderate",1,0,0,0,1
"20492","prequalial",0,0,0,1,1
"20493","prerogative",0,1,0,0,1
"20494","pres",1,0,0,0,1
"20495","presbyteran",0,0,0,1,1
"20496","presbyterianchurch",1,0,0,0,1
"20497","presedent",0,0,0,1,1
"20498","presenceof",1,0,0,0,1
"20499","presentationof",1,0,0,0,1
"20500","presentfavorable",1,0,0,0,1
"20501","presentin",1,0,0,0,1
"20502","presentinghim",1,0,0,0,1
"20503","presentminister",1,0,0,0,1
"20504","preservingany",1,0,0,0,1
"20505","preseveres",0,1,0,0,1
"20506","presidency.so",1,0,0,0,1
"20507","president_",1,0,0,0,1
"20508","president.there",1,0,0,0,1
"20509","president’s",1,0,0,0,1
"20510","presidentall",1,0,0,0,1
"20511","presidentand",1,0,0,0,1
"20512","presidentdeclared",1,0,0,0,1
"20513","presidentgrant’s",1,0,0,0,1
"20514","presidentialchair",1,0,0,0,1
"20515","presidentialoffice",1,0,0,0,1
"20516","presidentof",1,0,0,0,1
"20517","presidents",1,0,0,0,1
"20518","presidentto",1,0,0,0,1
"20519","presiding",0,1,0,0,1
"20520","presidingelder",1,0,0,0,1
"20521","press.the",1,0,0,0,1
"20522","pressinginvitation",1,0,0,0,1
"20523","presstook",1,0,0,0,1
"20524","prestige",1,0,0,0,1
"20525","preston",1,0,0,0,1
"20526","prests",0,0,0,1,1
"20527","presumptions",1,0,0,0,1
"20528","pretence",0,0,1,0,1
"20529","pretend",1,0,0,0,1
"20530","pretenders",0,1,0,0,1
"20531","pretendersto",1,0,0,0,1
"20532","pretending",0,0,0,1,1
"20533","prettyclearly",1,0,0,0,1
"20534","prettyclosely",1,0,0,0,1
"20535","prettygeneral",1,0,0,0,1
"20536","prettygenerally",1,0,0,0,1
"20537","prettylargely",1,0,0,0,1
"20538","prettyroughly",1,0,0,0,1
"20539","prevailed_mostly_",1,0,0,0,1
"20540","prevailedin",1,0,0,0,1
"20541","prevails",0,1,0,0,1
"20542","prevalenceof",1,0,0,0,1
"20543","prevalent",0,1,0,0,1
"20544","prevalentcalhoun",1,0,0,0,1
"20545","prevalentin",1,0,0,0,1
"20546","prevention",0,1,0,0,1
"20547","preventive",1,0,0,0,1
"20548","preventthe",1,0,0,0,1
"20549","prichard’s",1,0,0,0,1
"20550","pride.with",1,0,0,0,1
"20551","prideand",1,0,0,0,1
"20552","priestcraft",0,1,0,0,1
"20553","priestcraft.it",1,0,0,0,1
"20554","priestess",0,1,0,0,1
"20555","priesthood",0,1,0,0,1
"20556","primeminister",1,0,0,0,1
"20557","primitive",0,1,0,0,1
"20558","prince’s",0,1,0,0,1
"20559","princely",1,0,0,0,1
"20560","principalities",1,0,0,0,1
"20561","principledirecting",1,0,0,0,1
"20562","principleof",1,0,0,0,1
"20563","principlesand",1,0,0,0,1
"20564","principlesby",1,0,0,0,1
"20565","principlesdeemed",1,0,0,0,1
"20566","printers",1,0,0,0,1
"20567","printingpress",1,0,0,0,1
"20568","priorto",1,0,0,0,1
"20569","prison.but",1,0,0,0,1
"20570","prison.the",1,0,0,0,1
"20571","prisonersat",1,0,0,0,1
"20572","pritchard’s",1,0,0,0,1
"20573","privationby",1,0,0,0,1
"20574","priveleged",0,0,0,1,1
"20575","privilegedmen",1,0,0,0,1
"20576","probabably",0,0,0,1,1
"20577","probabilityof",1,0,0,0,1
"20578","probablythought",1,0,0,0,1
"20579","probation",1,0,0,0,1
"20580","proceededagainst",1,0,0,0,1
"20581","proceededunder",1,0,0,0,1
"20582","proceedings.indeed",1,0,0,0,1
"20583","proceedingsattracted",1,0,0,0,1
"20584","proceeds",1,0,0,0,1
"20585","procession.i",1,0,0,0,1
"20586","processionas",1,0,0,0,1
"20587","proclaiming",0,0,0,1,1
"20588","proclamationof",1,0,0,0,1
"20589","proclivity",0,1,0,0,1
"20590","procrastination",1,0,0,0,1
"20591","procured",1,0,0,0,1
"20592","prodigious",1,0,0,0,1
"20593","producea",1,0,0,0,1
"20594","producedon",1,0,0,0,1
"20595","produces",0,1,0,0,1
"20596","producing",0,0,1,0,1
"20597","productions",1,0,0,0,1
"20598","prof.john",1,0,0,0,1
"20599","profess",0,1,0,0,1
"20600","professed.may",1,0,0,0,1
"20601","professedly_christian_",1,0,0,0,1
"20602","professes",1,0,0,0,1
"20603","professors",0,1,0,0,1
"20604","professorsand",1,0,0,0,1
"20605","profile",0,1,0,0,1
"20606","profoundest",1,0,0,0,1
"20607","progress.fellow",1,0,0,0,1
"20608","progressthan",1,0,0,0,1
"20609","prohibiting",1,0,0,0,1
"20610","prolic",0,0,0,1,1
"20611","prolific",1,0,0,0,1
"20612","prolonged",0,0,1,0,1
"20613","promenading",0,0,0,1,1
"20614","promenently",0,0,0,1,1
"20615","prominencein",1,0,0,0,1
"20616","prominentchin",1,0,0,0,1
"20617","prominently",1,0,0,0,1
"20618","promisedto",1,0,0,0,1
"20619","promising",0,1,0,0,1
"20620","promisingthat",1,0,0,0,1
"20621","promotethe",1,0,0,0,1
"20622","promotingit",1,0,0,0,1
"20623","promptings",1,0,0,0,1
"20624","promptitude",0,1,0,0,1
"20625","promptlyexposed",1,0,0,0,1
"20626","promptlywithheld",1,0,0,0,1
"20627","prompts",0,1,0,0,1
"20628","promulged",0,1,0,0,1
"20629","pronouncing",0,0,1,0,1
"20630","proofwould",1,0,0,0,1
"20631","prop",1,0,0,0,1
"20632","propagandist",0,1,0,0,1
"20633","propagandists",1,0,0,0,1
"20634","propagation",1,0,0,0,1
"20635","properceremony",1,0,0,0,1
"20636","properdistance",1,0,0,0,1
"20637","properindustry",1,0,0,0,1
"20638","properlyhe",1,0,0,0,1
"20639","properrules",1,0,0,0,1
"20640","property_",1,0,0,0,1
"20641","propertylikely",1,0,0,0,1
"20642","propertyof",1,0,0,0,1
"20643","prophecies",0,1,0,0,1
"20644","prophecyof",1,0,0,0,1
"20645","prophert",0,0,0,1,1
"20646","prophesies",1,0,0,0,1
"20647","prophetic",1,0,0,0,1
"20648","prophetupon",1,0,0,0,1
"20649","propitiate",1,0,0,0,1
"20650","proportionate",1,0,0,0,1
"20651","proportionately",0,1,0,0,1
"20652","proportionatelyincreased",1,0,0,0,1
"20653","proportionto",1,0,0,0,1
"20654","proposedconventions",1,0,0,0,1
"20655","proposedhis",1,0,0,0,1
"20656","proposing",0,1,0,0,1
"20657","proprietors",1,0,0,0,1
"20658","prosecuting",1,0,0,0,1
"20659","proselyte",0,0,1,0,1
"20660","proselytes",0,0,1,0,1
"20661","prospectof",1,0,0,0,1
"20662","prospectwas",1,0,0,0,1
"20663","prosper",1,0,0,0,1
"20664","prosperity.they",1,0,0,0,1
"20665","prostitution",0,0,1,0,1
"20666","protectedit",1,0,0,0,1
"20667","protectingwing",1,0,0,0,1
"20668","protectionfrom",1,0,0,0,1
"20669","protectionist",1,0,0,0,1
"20670","protectionists",0,1,0,0,1
"20671","protections_",1,0,0,0,1
"20672","protest",1,0,0,0,1
"20673","protestants",1,0,0,0,1
"20674","protestsof",1,0,0,0,1
"20675","protract",1,0,0,0,1
"20676","protracting",1,0,0,0,1
"20677","prots",0,0,0,1,1
"20678","proudest",0,0,0,1,1
"20679","proved.after",1,0,0,0,1
"20680","provedas",1,0,0,0,1
"20681","provedthemselves",1,0,0,0,1
"20682","provefatal",1,0,0,0,1
"20683","proverb.outside",1,0,0,0,1
"20684","provideda",1,0,0,0,1
"20685","providedwith",1,0,0,0,1
"20686","providemeans",1,0,0,0,1
"20687","provident",0,1,0,0,1
"20688","province",0,1,0,0,1
"20689","provisionsor",1,0,0,0,1
"20690","provokedsomething",1,0,0,0,1
"20691","provokehim",1,0,0,0,1
"20692","provoking",0,1,0,0,1
"20693","prow",0,0,0,1,1
"20694","prowling",1,0,0,0,1
"20695","psychological",0,1,0,0,1
"20696","publicationat",1,0,0,0,1
"20697","publicationsof",1,0,0,0,1
"20698","publicmeeting",1,0,0,0,1
"20699","publicmen",1,0,0,0,1
"20700","publicmind",1,0,0,0,1
"20701","publicusefulness",1,0,0,0,1
"20702","publicwhat",1,0,0,0,1
"20703","publishedby",1,0,0,0,1
"20704","publisherof",1,0,0,0,1
"20705","publishes",0,1,0,0,1
"20706","pulses",0,0,1,0,1
"20707","pumps",0,1,0,0,1
"20708","punishedby",1,0,0,0,1
"20709","punishingits",1,0,0,0,1
"20710","pupels",0,0,0,1,1
"20711","pupilage",0,1,0,0,1
"20712","pupils.one",1,0,0,0,1
"20713","purchaseda",1,0,0,0,1
"20714","purer",0,1,0,0,1
"20715","puritan",1,0,0,0,1
"20716","purpose ",0,0,0,1,1
"20717","purposeindicated",1,0,0,0,1
"20718","pushedaside",1,0,0,0,1
"20719","puta",1,0,0,0,1
"20720","putan",1,0,0,0,1
"20721","putbayonets",1,0,0,0,1
"20722","putdown",1,0,0,0,1
"20723","putthe",1,0,0,0,1
"20724","putupon",1,0,0,0,1
"20725","putwet",1,0,0,0,1
"20726","puzzled",0,1,0,0,1
"20727","pyramids",0,0,0,1,1
"20728","pyyramids",0,0,0,1,1
"20729","quaintest",0,0,0,1,1
"20730","quaintold",1,0,0,0,1
"20731","quakerism",1,0,0,0,1
"20732","qualifications",0,1,0,0,1
"20733","qualifying",1,0,0,0,1
"20734","qualitiesthat",1,0,0,0,1
"20735","quanties",0,1,0,0,1
"20736","quantities",1,0,0,0,1
"20737","quarreling",1,0,0,0,1
"20738","quarterand",1,0,0,0,1
"20739","quartered",0,1,0,0,1
"20740","quebec",1,0,0,0,1
"20741","queen’s",1,0,0,0,1
"20742","quest",0,0,1,0,1
"20743","question.the",1,0,0,0,1
"20744","questioncould",1,0,0,0,1
"20745","questionin",1,0,0,0,1
"20746","questioning",0,1,0,0,1
"20747","questionthe",1,0,0,0,1
"20748","questionvirtually",1,0,0,0,1
"20749","quieting",1,0,0,0,1
"20750","quietlyreading",1,0,0,0,1
"20751","quietted",0,0,0,1,1
"20752","quiteabsurd",1,0,0,0,1
"20753","quiteas",1,0,0,0,1
"20754","quitecorrect",1,0,0,0,1
"20755","quitecourageously",1,0,0,0,1
"20756","quitefree",1,0,0,0,1
"20757","quitegood",1,0,0,0,1
"20758","quitemarked",1,0,0,0,1
"20759","quitesure",1,0,0,0,1
"20760","quits",0,1,0,0,1
"20761","quitt",0,0,0,1,1
"20762","quondam",0,1,0,0,1
"20763","quota",1,0,0,0,1
"20764","quotedthese",1,0,0,0,1
"20765","r.giddings",1,0,0,0,1
"20766","race_",0,1,0,0,1
"20767","race.at",1,0,0,0,1
"20768","race.besides",1,0,0,0,1
"20769","race.i",1,0,0,0,1
"20770","raceby",1,0,0,0,1
"20771","raceor",1,0,0,0,1
"20772","racewho",1,0,0,0,1
"20773","racewhose",1,0,0,0,1
"20774","radically",1,0,0,0,1
"20775","rafters",0,1,0,0,1
"20776","rag",0,0,0,1,1
"20777","ragamuffins",1,0,0,0,1
"20778","raging",1,0,0,0,1
"20779","raiders",1,0,0,0,1
"20780","railed",1,0,0,0,1
"20781","railways",1,0,0,0,1
"20782","rainbeating",1,0,0,0,1
"20783","rains",0,1,0,0,1
"20784","raisedagents",1,0,0,0,1
"20785","raisetwo",1,0,0,0,1
"20786","raisingthe",1,0,0,0,1
"20787","rake",1,0,0,0,1
"20788","rakes",0,0,1,0,1
"20789","raking",0,1,0,0,1
"20790","ralph",1,0,0,0,1
"20791","ram",1,0,0,0,1
"20792","ramifications",0,1,0,0,1
"20793","rampant",1,0,0,0,1
"20794","ramsey",0,1,0,0,1
"20795","ranged",0,1,0,0,1
"20796","ranthe",1,0,0,0,1
"20797","ranting",0,0,1,0,1
"20798","rapacity",0,1,0,0,1
"20799","rapidcurrent",1,0,0,0,1
"20800","rapidity",1,0,0,0,1
"20801","rapt",0,1,0,0,1
"20802","rarer",0,0,1,0,1
"20803","rascally",1,0,0,0,1
"20804","rascals",0,1,0,0,1
"20805","rascalsnow",1,0,0,0,1
"20806","rash",1,0,0,0,1
"20807","rashness",0,1,0,0,1
"20808","ratehe",1,0,0,0,1
"20809","rateoff",1,0,0,0,1
"20810","rations",1,0,0,0,1
"20811","rattle",0,1,0,0,1
"20812","rattles",0,1,0,0,1
"20813","rattling",0,0,1,0,1
"20814","rauselear",1,0,0,0,1
"20815","raving",0,0,1,0,1
"20816","reachedchestnut",1,0,0,0,1
"20817","reachedharrisburgh",1,0,0,0,1
"20818","reachedme",1,0,0,0,1
"20819","reachedpittsfield",1,0,0,0,1
"20820","reaches",0,1,0,0,1
"20821","reachinghome",1,0,0,0,1
"20822","reachingthe",1,0,0,0,1
"20823","reachit",1,0,0,0,1
"20824","reachme",1,0,0,0,1
"20825","reachthe",1,0,0,0,1
"20826","readagain",1,0,0,0,1
"20827","readerof",1,0,0,0,1
"20828","readilycomplied",1,0,0,0,1
"20829","readilyhave",1,0,0,0,1
"20830","readingand",1,0,0,0,1
"20831","reads",0,0,1,0,1
"20832","readville",1,0,0,0,1
"20833","realgentlemen",1,0,0,0,1
"20834","reality.our",1,0,0,0,1
"20835","realityhad",1,0,0,0,1
"20836","realization",1,0,0,0,1
"20837","reallyin",1,0,0,0,1
"20838","reallymade",1,0,0,0,1
"20839","reaped",1,0,0,0,1
"20840","reaping",0,1,0,0,1
"20841","rears",1,0,0,0,1
"20842","reasonedfurther",1,0,0,0,1
"20843","reasonfor",1,0,0,0,1
"20844","rebellion.do",1,0,0,0,1
"20845","rebellionfor",1,0,0,0,1
"20846","rebellionhad",1,0,0,0,1
"20847","rebellionof",1,0,0,0,1
"20848","rebellionwithout",1,0,0,0,1
"20849","rebelsagainst",1,0,0,0,1
"20850","rebelsthemselves",1,0,0,0,1
"20851","rebuffs",1,0,0,0,1
"20852","rebuked",1,0,0,0,1
"20853","rebukes",0,1,0,0,1
"20854","recalling",1,0,0,0,1
"20855","recapitulates",0,1,0,0,1
"20856","recapitulatesthe",1,0,0,0,1
"20857","recapture.in",1,0,0,0,1
"20858","recaptureme",1,0,0,0,1
"20859","recapturing",1,0,0,0,1
"20860","receide",0,0,0,1,1
"20861","receivea",1,0,0,0,1
"20862","receivedinformation",1,0,0,0,1
"20863","receivedone",1,0,0,0,1
"20864","receiveus",1,0,0,0,1
"20865","receivingmoney",1,0,0,0,1
"20866","receptions",1,0,0,0,1
"20867","recess",1,0,0,0,1
"20868","recesses",0,1,0,0,1
"20869","recetations",0,0,0,1,1
"20870","rechard",0,0,0,1,1
"20871","recieved",0,0,0,1,1
"20872","recieving",0,0,0,1,1
"20873","recipient",1,0,0,0,1
"20874","reckon",1,0,0,0,1
"20875","reclamation",1,0,0,0,1
"20876","reclines",0,1,0,0,1
"20877","recognizedthrough",1,0,0,0,1
"20878","recognizes",0,1,0,0,1
"20879","recollect",0,0,1,0,1
"20880","recollected",1,0,0,0,1
"20881","recollecting",1,0,0,0,1
"20882","recommending",0,1,0,0,1
"20883","reconcile",0,1,0,0,1
"20884","reconsidered",1,0,0,0,1
"20885","reconstruct",1,0,0,0,1
"20886","recording",0,1,0,0,1
"20887","recover",1,0,0,0,1
"20888","recruit",1,0,0,0,1
"20889","recruiting.from",1,0,0,0,1
"20890","recruits",1,0,0,0,1
"20891","recurring",0,1,0,0,1
"20892","reddening",0,1,0,0,1
"20893","redeemedin",1,0,0,0,1
"20894","redeemer",0,1,0,0,1
"20895","redemption",1,0,0,0,1
"20896","redemptionhad",1,0,0,0,1
"20897","redress.chapter",1,0,0,0,1
"20898","redressed",1,0,0,0,1
"20899","reechoed",0,1,0,0,1
"20900","reel",0,1,0,0,1
"20901","reenforcement",0,1,0,0,1
"20902","reenslavement",0,1,0,0,1
"20903","ref",0,0,0,1,1
"20904","referring",0,1,0,0,1
"20905","referto",1,0,0,0,1
"20906","refinedsociety",1,0,0,0,1
"20907","refinement.my",1,0,0,0,1
"20908","refinery",1,0,0,0,1
"20909","reflected",0,0,1,0,1
"20910","reflectioni",1,0,0,0,1
"20911","reflective",0,0,1,0,1
"20912","reformatory",1,0,0,0,1
"20913","reformed",0,0,1,0,1
"20914","refought",0,1,0,0,1
"20915","refresh",1,0,0,0,1
"20916","refreshments",0,1,0,0,1
"20917","refugein",1,0,0,0,1
"20918","refunded ",0,0,0,1,1
"20919","refusedto",1,0,0,0,1
"20920","refuseus",1,0,0,0,1
"20921","refusingits",1,0,0,0,1
"20922","refute",0,1,0,0,1
"20923","refuted.if",1,0,0,0,1
"20924","regardourselves",1,0,0,0,1
"20925","regardsometimes",1,0,0,0,1
"20926","regeneratedthroughout",1,0,0,0,1
"20927","regime",1,0,0,0,1
"20928","register",0,1,0,0,1
"20929","regretful",1,0,0,0,1
"20930","regularlyconstituted",1,0,0,0,1
"20931","regularwhipping",1,0,0,0,1
"20932","regulation",1,0,0,0,1
"20933","reinforced",0,1,0,0,1
"20934","rejecting",0,0,0,1,1
"20935","rejoice.if",1,0,0,0,1
"20936","rejoicingthat",1,0,0,0,1
"20937","rejoins",0,1,0,0,1
"20938","relating",0,1,0,0,1
"20939","relationof",1,0,0,0,1
"20940","relationsto",1,0,0,0,1
"20941","relationswere",1,0,0,0,1
"20942","relationto",1,0,0,0,1
"20943","relativeswhom",1,0,0,0,1
"20944","relax",0,1,0,0,1
"20945","releasing",0,1,0,0,1
"20946","relegious",0,0,0,1,1
"20947","relented",0,1,0,0,1
"20948","reliable",1,0,0,0,1
"20949","reliance",1,0,0,0,1
"20950","reliant",0,1,0,0,1
"20951","relict",1,0,0,0,1
"20952","reliefto",1,0,0,0,1
"20953","relievedmy",1,0,0,0,1
"20954","relieves",1,0,0,0,1
"20955","relighting",0,1,0,0,1
"20956","religion_",0,0,1,0,1
"20957","religiousassociations",1,0,0,0,1
"20958","relinquish",0,0,1,0,1
"20959","relished",1,0,0,0,1
"20960","relishes",0,1,0,0,1
"20961","relishmy",1,0,0,0,1
"20962","remainds",0,0,0,1,1
"20963","remainswere",1,0,0,0,1
"20964","remainwrong",1,0,0,0,1
"20965","remarkablefor",1,0,0,0,1
"20966","remarkablyclear",1,0,0,0,1
"20967","remarkablydignified",1,0,0,0,1
"20968","remedial",0,1,0,0,1
"20969","rememberedthat",1,0,0,0,1
"20970","rememberever",1,0,0,0,1
"20971","remindedof",1,0,0,0,1
"20972","remindingme",1,0,0,0,1
"20973","remond_",0,0,1,0,1
"20974","remonstrate",1,0,0,0,1
"20975","remonstrated",1,0,0,0,1
"20976","remote",1,0,0,0,1
"20977","removingprejudice",1,0,0,0,1
"20978","remuses",0,1,0,0,1
"20979","renderedme",1,0,0,0,1
"20980","renders",0,0,1,0,1
"20981","rendezvous",1,0,0,0,1
"20982","rendition",1,0,0,0,1
"20983","renounced",0,1,0,0,1
"20984","renouncedhis",1,0,0,0,1
"20985","renown",1,0,0,0,1
"20986","reorganized",1,0,0,0,1
"20987","repaid",0,0,0,1,1
"20988","repairs",1,0,0,0,1
"20989","repass",1,0,0,0,1
"20990","repast",0,1,0,0,1
"20991","repealedtheir",1,0,0,0,1
"20992","repealing",1,0,0,0,1
"20993","repeateach",1,0,0,0,1
"20994","repeatedvisits",1,0,0,0,1
"20995","repeating",1,0,0,0,1
"20996","repentant",1,0,0,0,1
"20997","reperused",0,1,0,0,1
"20998","repetition",1,0,0,0,1
"20999","reporters",1,0,0,0,1
"21000","reportsof",1,0,0,0,1
"21001","reportwill",1,0,0,0,1
"21002","reposeon",1,0,0,0,1
"21003","reposes",1,0,0,0,1
"21004","reposing",1,0,0,0,1
"21005","repossession",1,0,0,0,1
"21006","reprehensible",0,1,0,0,1
"21007","representationsbefore",1,0,0,0,1
"21008","represents",1,0,0,0,1
"21009","representus",1,0,0,0,1
"21010","reprimand",1,0,0,0,1
"21011","reprimanded",0,1,0,0,1
"21012","reproachedthe",1,0,0,0,1
"21013","reproaches.even",1,0,0,0,1
"21014","reproachfully",0,1,0,0,1
"21015","reproachfullyask",1,0,0,0,1
"21016","reprobated",1,0,0,0,1
"21017","reproduce",0,1,0,0,1
"21018","reproofs",0,1,0,0,1
"21019","reprove",0,1,0,0,1
"21020","reproved",0,1,0,0,1
"21021","reproving",0,0,1,0,1
"21022","reptile",0,0,1,0,1
"21023","reptiles",0,1,0,0,1
"21024","republic.a",1,0,0,0,1
"21025","republic.chapter",1,0,0,0,1
"21026","republic.that",1,0,0,0,1
"21027","republic.this",1,0,0,0,1
"21028","republicanparty",1,0,0,0,1
"21029","republicanranks",1,0,0,0,1
"21030","republics",1,0,0,0,1
"21031","republicwithout",1,0,0,0,1
"21032","republishing",0,1,0,0,1
"21033","repudiation",1,0,0,0,1
"21034","repugnant",1,0,0,0,1
"21035","reputationat",1,0,0,0,1
"21036","reputationof",1,0,0,0,1
"21037","request.the",1,0,0,0,1
"21038","requested",1,0,0,0,1
"21039","requesting",0,0,0,1,1
"21040","require.here",1,0,0,0,1
"21041","requisite",1,0,0,0,1
"21042","rescuing",1,0,0,0,1
"21043","reseded",0,0,0,1,1
"21044","resembledthe",1,0,0,0,1
"21045","resembles",0,1,0,0,1
"21046","resented",1,0,0,0,1
"21047","reservations",1,0,0,0,1
"21048","reserved",0,1,0,0,1
"21049","residedin",1,0,0,0,1
"21050","residence.not",1,0,0,0,1
"21051","residenceof",1,0,0,0,1
"21052","residents",0,0,1,0,1
"21053","resigned",1,0,0,0,1
"21054","resistance.should",1,0,0,0,1
"21055","resistancein",1,0,0,0,1
"21056","resistancemade",1,0,0,0,1
"21057","resistances",0,1,0,0,1
"21058","resistants",1,0,0,0,1
"21059","resistedhis",1,0,0,0,1
"21060","resists",0,1,0,0,1
"21061","resolutionsand",1,0,0,0,1
"21062","resorts",1,0,0,0,1
"21063","resortwithout",1,0,0,0,1
"21064","resound",0,1,0,0,1
"21065","resources",0,0,1,0,1
"21066","respect.the",1,0,0,0,1
"21067","respect.though",1,0,0,0,1
"21068","respectably",1,0,0,0,1
"21069","respectand",1,0,0,0,1
"21070","respecter",0,1,0,0,1
"21071","respectfulhearing",1,0,0,0,1
"21072","respecthe",1,0,0,0,1
"21073","respectingclass",1,0,0,0,1
"21074","respectingthe",1,0,0,0,1
"21075","respectis",1,0,0,0,1
"21076","respectof",1,0,0,0,1
"21077","respectourselves",1,0,0,0,1
"21078","respects.charles",1,0,0,0,1
"21079","respectsequal",1,0,0,0,1
"21080","respond",1,0,0,0,1
"21081","responding",1,0,0,0,1
"21082","responds",0,1,0,0,1
"21083","responsibility.freedom",1,0,0,0,1
"21084","responsiblebeing",1,0,0,0,1
"21085","responsiblefor",1,0,0,0,1
"21086","responsiblefreeman",1,0,0,0,1
"21087","restedon",1,0,0,0,1
"21088","restlessness",1,0,0,0,1
"21089","restoration",1,0,0,0,1
"21090","restorepeaceful",1,0,0,0,1
"21091","restoreto",1,0,0,0,1
"21092","restrained",1,0,0,0,1
"21093","result.but",1,0,0,0,1
"21094","result.the",1,0,0,0,1
"21095","resultant",0,1,0,0,1
"21096","results.sleep",1,0,0,0,1
"21097","resultsof",1,0,0,0,1
"21098","retains",0,1,0,0,1
"21099","retaliate",1,0,0,0,1
"21100","retaliatein",1,0,0,0,1
"21101","retard",0,1,0,0,1
"21102","retire",1,0,0,0,1
"21103","retirement",0,1,0,0,1
"21104","retiring",0,1,0,0,1
"21105","retouching",1,0,0,0,1
"21106","retreat.i",1,0,0,0,1
"21107","retributive",0,1,0,0,1
"21108","retrospection",0,1,0,0,1
"21109","return.as",1,0,0,0,1
"21110","returnedi",1,0,0,0,1
"21111","returninstantly",1,0,0,0,1
"21112","returnme",1,0,0,0,1
"21113","returnto",1,0,0,0,1
"21114","reunbrook",0,0,0,1,1
"21115","rev_",0,1,0,0,1
"21116","rev.ephraim",1,0,0,0,1
"21117","rev.hiram",1,0,0,0,1
"21118","reveal",1,0,0,0,1
"21119","reveiling",0,0,0,1,1
"21120","revels",1,0,0,0,1
"21121","revengeful",1,0,0,0,1
"21122","revengefulhand",1,0,0,0,1
"21123","reverence.soon",1,0,0,0,1
"21124","reversed",0,1,0,0,1
"21125","reversed.they",1,0,0,0,1
"21126","reverses",0,1,0,0,1
"21127","reverseswhich",1,0,0,0,1
"21128","review",0,0,0,1,1
"21129","revising",1,0,0,0,1
"21130","revisits",1,0,0,0,1
"21131","revive",1,0,0,0,1
"21132","revived.some",1,0,0,0,1
"21133","reviveddemocratic",1,0,0,0,1
"21134","revoked",1,0,0,0,1
"21135","revoltingcruelty",1,0,0,0,1
"21136","revolutionaryconspirators",1,0,0,0,1
"21137","revolver",1,0,0,0,1
"21138","revs",1,0,0,0,1
"21139","rewarding",1,0,0,0,1
"21140","rewardwould",1,0,0,0,1
"21141","reynolds",1,0,0,0,1
"21142","rhodeisland",1,0,0,0,1
"21143","rhone",0,0,0,1,1
"21144","rialto",0,0,0,1,1
"21145","ribs",0,0,1,0,1
"21146","richdonations",1,0,0,0,1
"21147","richer",0,1,0,0,1
"21148","richetson’s",1,0,0,0,1
"21149","richmond’sbrass",1,0,0,0,1
"21150","richmondhad",1,0,0,0,1
"21151","ricketson’s",0,1,0,0,1
"21152","riddle",1,0,0,0,1
"21153","ride_",1,0,0,0,1
"21154","ridethe",1,0,0,0,1
"21155","ridiculed",0,0,1,0,1
"21156","ridiculousfigure",1,0,0,0,1
"21157","rifled",1,0,0,0,1
"21158","rig",1,0,0,0,1
"21159","rigging",0,1,0,0,1
"21160","rightand",1,0,0,0,1
"21161","righted",0,0,1,0,1
"21162","righteously",0,1,0,0,1
"21163","rightover",1,0,0,0,1
"21164","rightplace",1,0,0,0,1
"21165","rightprinciple",1,0,0,0,1
"21166","rightrelations",1,0,0,0,1
"21167","rights.a",1,0,0,0,1
"21168","rightsare",1,0,0,0,1
"21169","rightside",1,0,0,0,1
"21170","rightswas",1,0,0,0,1
"21171","rigidlymaintained",1,0,0,0,1
"21172","rigidvirtue",1,0,0,0,1
"21173","ringold",1,0,0,0,1
"21174","riot",1,0,0,0,1
"21175","riots",1,0,0,0,1
"21176","ripening",0,1,0,0,1
"21177","risked",1,0,0,0,1
"21178","risks",1,0,0,0,1
"21179","rite",1,0,0,0,1
"21180","rites",1,0,0,0,1
"21181","rivalryamong",1,0,0,0,1
"21182","riverand",1,0,0,0,1
"21183","riversteamer",1,0,0,0,1
"21184","rivitted",0,0,0,1,1
"21185","rivoli",0,0,0,1,1
"21186","roaches",1,0,0,0,1
"21187","roaming",1,0,0,0,1
"21188","rob’t",1,0,0,0,1
"21189","robbedof",1,0,0,0,1
"21190","robertj",1,0,0,0,1
"21191","robeson",1,0,0,0,1
"21192","robesons",1,0,0,0,1
"21193","rochdale",1,0,0,0,1
"21194","rochester.for",1,0,0,0,1
"21195","rochester.notwithstanding",1,0,0,0,1
"21196","rod",0,0,1,0,1
"21197","rodgers",1,0,0,0,1
"21198","rodmans",1,0,0,0,1
"21199","rolls",1,0,0,0,1
"21200","romance",1,0,0,0,1
"21201","romanism",0,0,0,1,1
"21202","romuluses",0,1,0,0,1
"21203","roomfor",1,0,0,0,1
"21204","rooms",0,0,0,1,1
"21205","roomwith",1,0,0,0,1
"21206","rooted",1,0,0,0,1
"21207","roothad",1,0,0,0,1
"21208","roscoe",1,0,0,0,1
"21209","roseto",1,0,0,0,1
"21210","rosetta",0,0,0,1,1
"21211","ross",1,0,0,0,1
"21212","rotunda",1,0,0,0,1
"21213","roughand",1,0,0,0,1
"21214","rougher",1,0,0,0,1
"21215","roundabout",1,0,0,0,1
"21216","rounding",1,0,0,0,1
"21217","rounds",0,1,0,0,1
"21218","rowe",0,0,1,0,1
"21219","rowed",0,0,0,1,1
"21220","rowena’s",0,1,0,0,1
"21221","rowlandt",1,0,0,0,1
"21222","royalty",0,0,0,1,1
"21223","rubbed",0,0,1,0,1
"21224","rubbish",1,0,0,0,1
"21225","ruddy",1,0,0,0,1
"21226","rudeness",0,1,0,0,1
"21227","rudiments",0,1,0,0,1
"21228","ruffian",0,1,0,0,1
"21229","ruffled",0,0,0,1,1
"21230","ruggles_",0,0,1,0,1
"21231","ruled",1,0,0,0,1
"21232","ruleor",1,0,0,0,1
"21233","ruler",1,0,0,0,1
"21234","rulingprovidence",1,0,0,0,1
"21235","rumored",1,0,0,0,1
"21236","rumors",1,0,0,0,1
"21237","runaways",0,0,1,0,1
"21238","rushes",0,1,0,0,1
"21239","russia",1,0,0,0,1
"21240","russworm",0,1,0,0,1
"21241","russwurms",1,0,0,0,1
"21242","rust",0,1,0,0,1
"21243","rusting",0,1,0,0,1
"21244","rustoff",1,0,0,0,1
"21245","rutherfordb",1,0,0,0,1
"21246","rye",0,0,1,0,1
"21247","rynders",1,0,0,0,1
"21248","s.grant",1,0,0,0,1
"21249","sackcloth",0,1,0,0,1
"21250","sackwell",1,0,0,0,1
"21251","saco",1,0,0,0,1
"21252","sacredleather",1,0,0,0,1
"21253","sacredscriptures",1,0,0,0,1
"21254","sacrificeof",1,0,0,0,1
"21255","sacrificethe",1,0,0,0,1
"21256","sacrificing",0,1,0,0,1
"21257","sacrilegious",0,1,0,0,1
"21258","sad ",0,0,0,1,1
"21259","sadlybefore",1,0,0,0,1
"21260","sadness.i",1,0,0,0,1
"21261","sadthing",1,0,0,0,1
"21262","safeguard",0,0,1,0,1
"21263","safejourney",1,0,0,0,1
"21264","safeto",1,0,0,0,1
"21265","saidabout",1,0,0,0,1
"21266","saidby",1,0,0,0,1
"21267","saidhe",1,0,0,0,1
"21268","saidthree",1,0,0,0,1
"21269","saidto",1,0,0,0,1
"21270","sailor.the",1,0,0,0,1
"21271","sakar",0,0,0,1,1
"21272","sakes",0,1,0,0,1
"21273","salamis",0,0,0,1,1
"21274","salaries",1,0,0,0,1
"21275","salaries.standing",1,0,0,0,1
"21276","saleable",0,1,0,0,1
"21277","saleableproduce",1,0,0,0,1
"21278","salem",1,0,0,0,1
"21279","sallied",0,1,0,0,1
"21280","sallow",1,0,0,0,1
"21281","salmon",1,0,0,0,1
"21282","saloonoalan",0,0,0,1,1
"21283","salts_",0,1,0,0,1
"21284","saluted",0,1,0,0,1
"21285","sam",0,0,1,0,1
"21286","sam.beck",1,0,0,0,1
"21287","sam’l",1,0,0,0,1
"21288","samand",1,0,0,0,1
"21289","samechannel",1,0,0,0,1
"21290","samecoarse",1,0,0,0,1
"21291","sameinternal",1,0,0,0,1
"21292","samemeasure",1,0,0,0,1
"21293","sameplunderers",1,0,0,0,1
"21294","sample",0,0,1,0,1
"21295","samuelr",1,0,0,0,1
"21296","sanborn",1,0,0,0,1
"21297","sanctified",0,1,0,0,1
"21298","sanctioned",0,1,0,0,1
"21299","sanctioner",0,1,0,0,1
"21300","sanctioning",0,1,0,0,1
"21301","sanctions",0,1,0,0,1
"21302","sandals",0,0,0,1,1
"21303","sandwiched",1,0,0,0,1
"21304","sandyjenkins",1,0,0,0,1
"21305","sandylived",1,0,0,0,1
"21306","sangfor",1,0,0,0,1
"21307","sanguine",0,0,1,0,1
"21308","santodomingo",1,0,0,0,1
"21309","sap",1,0,0,0,1
"21310","sapping",0,1,0,0,1
"21311","saratoga",1,0,0,0,1
"21312","sargent",0,0,0,1,1
"21313","sash",0,1,0,0,1
"21314","saticfaction",0,1,0,0,1
"21315","satiety",0,1,0,0,1
"21316","satiety.behind",1,0,0,0,1
"21317","satire",0,1,0,0,1
"21318","satisfaction.it",1,0,0,0,1
"21319","satisfactionhave",1,0,0,0,1
"21320","satisfactorily",1,0,0,0,1
"21321","satisfiedher",1,0,0,0,1
"21322","saucy",0,1,0,0,1
"21323","sauntered",0,1,0,0,1
"21324","savagely",0,0,1,0,1
"21325","savageness",0,1,0,0,1
"21326","savageness.tobacco",1,0,0,0,1
"21327","savages",0,1,0,0,1
"21328","saveits",1,0,0,0,1
"21329","savetheir",1,0,0,0,1
"21330","savingsinstitution.it",1,0,0,0,1
"21331","savor",1,0,0,0,1
"21332","saw ",0,0,0,1,1
"21333","sawa",1,0,0,0,1
"21334","sawbefore",1,0,0,0,1
"21335","sawgen",1,0,0,0,1
"21336","sawno",1,0,0,0,1
"21337","sawnothing",1,0,0,0,1
"21338","sawthat",1,0,0,0,1
"21339","sayeverything",1,0,0,0,1
"21340","sayi",1,0,0,0,1
"21341","scaffold",1,0,0,0,1
"21342","scaffolding",1,0,0,0,1
"21343","scales",0,1,0,0,1
"21344","scalp",1,0,0,0,1
"21345","scampered",0,1,0,0,1
"21346","scampering",1,0,0,0,1
"21347","scandalized",1,0,0,0,1
"21348","scape",0,1,0,0,1
"21349","scapegoat",1,0,0,0,1
"21350","scarcelynecessary",1,0,0,0,1
"21351","scarcelyneeded",1,0,0,0,1
"21352","scarlet",1,0,0,0,1
"21353","scathing",0,0,1,0,1
"21354","scatteredpages",1,0,0,0,1
"21355","scatters",0,0,1,0,1
"21356","scene.i",1,0,0,0,1
"21357","scene.the",1,0,0,0,1
"21358","scenehere",1,0,0,0,1
"21359","sceneoccurred",1,0,0,0,1
"21360","scenesof",1,0,0,0,1
"21361","scent",0,1,0,0,1
"21362","sceptre",1,0,0,0,1
"21363","schemeby",1,0,0,0,1
"21364","schemefor",1,0,0,0,1
"21365","schemes",1,0,0,0,1
"21366","scheother",0,0,0,1,1
"21367","schoolif",1,0,0,0,1
"21368","schoolpossible",1,0,0,0,1
"21369","schooner",0,0,1,0,1
"21370","scientists",1,0,0,0,1
"21371","scoars",0,0,0,1,1
"21372","scoffer",0,1,0,0,1
"21373","scool",0,0,0,1,1
"21374","scopeand",1,0,0,0,1
"21375","scorns",0,1,0,0,1
"21376","scotia",1,0,0,0,1
"21377","scotland’s",0,1,0,0,1
"21378","scott_",1,0,0,0,1
"21379","scottdecision",1,0,0,0,1
"21380","scottish",0,1,0,0,1
"21381","scourgeof",1,0,0,0,1
"21382","scouts",1,0,0,0,1
"21383","screamed",0,0,1,0,1
"21384","scripturally",0,0,1,0,1
"21385","scrub",0,1,0,0,1
"21386","scruples",0,1,0,0,1
"21387","scrupulous",0,1,0,0,1
"21388","scrupulousregard",1,0,0,0,1
"21389","scrutiny",1,0,0,0,1
"21390","sculpturer",0,0,0,1,1
"21391","scutari",0,1,0,0,1
"21392","scythe",1,0,0,0,1
"21393","sea ",0,0,0,1,1
"21394","seaman’s",1,0,0,0,1
"21395","seamanship",1,0,0,0,1
"21396","seamed",1,0,0,0,1
"21397","seams",0,1,0,0,1
"21398","seaports",1,0,0,0,1
"21399","searchedfor",1,0,0,0,1
"21400","sears.but",1,0,0,0,1
"21401","seasoned",0,1,0,0,1
"21402","seasonengaged",1,0,0,0,1
"21403","seato",1,0,0,0,1
"21404","seatsin",1,0,0,0,1
"21405","seatsprovided",1,0,0,0,1
"21406","seatthe",1,0,0,0,1
"21407","secerts",0,1,0,0,1
"21408","seclusion",0,1,0,0,1
"21409","secondcabin",1,0,0,0,1
"21410","seconded",0,0,1,0,1
"21411","secondinauguration",1,0,0,0,1
"21412","secretaryseward",1,0,0,0,1
"21413","secretarywilliam",1,0,0,0,1
"21414","secretfeeling",1,0,0,0,1
"21415","secretive",1,0,0,0,1
"21416","sect",0,1,0,0,1
"21417","sectarianism",1,0,0,0,1
"21418","sectarism",0,1,0,0,1
"21419","sectionwhen",1,0,0,0,1
"21420","securelegislation",1,0,0,0,1
"21421","security.it",1,0,0,0,1
"21422","seeand",1,0,0,0,1
"21423","seeany",1,0,0,0,1
"21424","seefor",1,0,0,0,1
"21425","seehis",1,0,0,0,1
"21426","seekers",0,0,1,0,1
"21427","seemeda",1,0,0,0,1
"21428","seemedever",1,0,0,0,1
"21429","seemedin",1,0,0,0,1
"21430","seemings",0,1,0,0,1
"21431","seemingto",1,0,0,0,1
"21432","seen.as",1,0,0,0,1
"21433","seen.esther’s",1,0,0,0,1
"21434","seencaptain",1,0,0,0,1
"21435","seenin",1,0,0,0,1
"21436","seenme",1,0,0,0,1
"21437","seenthat",1,0,0,0,1
"21438","seeor",1,0,0,0,1
"21439","sees",0,0,0,1,1
"21440","seesuch",1,0,0,0,1
"21441","seething",0,1,0,0,1
"21442","seizedwith",1,0,0,0,1
"21443","seizes",0,0,1,0,1
"21444","selden",1,0,0,0,1
"21445","seldomcalled",1,0,0,0,1
"21446","seldomdiscovered",1,0,0,0,1
"21447","seldomin",1,0,0,0,1
"21448","seldommet",1,0,0,0,1
"21449","seldomshowed",1,0,0,0,1
"21450","selection.by",1,0,0,0,1
"21451","selectionof",1,0,0,0,1
"21452","selections",1,0,0,0,1
"21453","selerno",0,0,0,1,1
"21454","selfishor",1,0,0,0,1
"21455","sellers",0,1,0,0,1
"21456","sells",0,0,1,0,1
"21457","sellthem",1,0,0,0,1
"21458","semblance",0,0,1,0,1
"21459","senate.this",1,0,0,0,1
"21460","senatorcharles",1,0,0,0,1
"21461","senatorhamlin",1,0,0,0,1
"21462","senatorscott",1,0,0,0,1
"21463","sending ",0,0,0,1,1
"21464","sendingsome",1,0,0,0,1
"21465","sends",0,1,0,0,1
"21466","sensationsof",1,0,0,0,1
"21467","sensationswhich",1,0,0,0,1
"21468","senses",0,1,0,0,1
"21469","sensible",0,0,0,1,1
"21470","sent_",1,0,0,0,1
"21471","sentaway",1,0,0,0,1
"21472","sentencethat",1,0,0,0,1
"21473","sentimentand",1,0,0,0,1
"21474","sentimentof",1,0,0,0,1
"21475","sentimentthan",1,0,0,0,1
"21476","sentimentwhen",1,0,0,0,1
"21477","sentimentwhich",1,0,0,0,1
"21478","sentto",1,0,0,0,1
"21479","separatedfrom",1,0,0,0,1
"21480","separates",1,0,0,0,1
"21481","sept_",0,0,1,0,1
"21482","sepulchres",0,0,1,0,1
"21483","serenity",1,0,0,0,1
"21484","serento",0,0,0,1,1
"21485","serfs",1,0,0,0,1
"21486","servant_",0,1,0,0,1
"21487","servant.rolling",1,0,0,0,1
"21488","servants.it",1,0,0,0,1
"21489","servantswhen",1,0,0,0,1
"21490","servedas",1,0,0,0,1
"21491","serveyou",1,0,0,0,1
"21492","service.after",1,0,0,0,1
"21493","serviceableto",1,0,0,0,1
"21494","services.mr",1,0,0,0,1
"21495","servicesof",1,0,0,0,1
"21496","session.i",1,0,0,0,1
"21497","setabout",1,0,0,0,1
"21498","setall",1,0,0,0,1
"21499","setdown",1,0,0,0,1
"21500","setsthat",1,0,0,0,1
"21501","settembre",0,0,0,1,1
"21502","settinga",1,0,0,0,1
"21503","settledfor",1,0,0,0,1
"21504","settles",1,0,0,0,1
"21505","sevenmiles",1,0,0,0,1
"21506","seventh",1,0,0,0,1
"21507","severalnights",1,0,0,0,1
"21508","severalslaves",1,0,0,0,1
"21509","severe’s",0,0,1,0,1
"21510","severebeating",1,0,0,0,1
"21511","severedthe",1,0,0,0,1
"21512","severities",1,0,0,0,1
"21513","sewell",1,0,0,0,1
"21514","sewing",1,0,0,0,1
"21515","sex.in",1,0,0,0,1
"21516","seynagauge",0,0,0,1,1
"21517","shadeof",1,0,0,0,1
"21518","shadesof",1,0,0,0,1
"21519","shading",1,0,0,0,1
"21520","shadowof",1,0,0,0,1
"21521","shadows.an",1,0,0,0,1
"21522","shadowy",0,1,0,0,1
"21523","shakeoff",1,0,0,0,1
"21524","shakes",0,1,0,0,1
"21525","shaketh",0,1,0,0,1
"21526","shallattend",1,0,0,0,1
"21527","shallforget",1,0,0,0,1
"21528","shalli",1,0,0,0,1
"21529","shallnever",1,0,0,0,1
"21530","shallow",1,0,0,0,1
"21531","shallowplea",1,0,0,0,1
"21532","shallsoon",1,0,0,0,1
"21533","shamed",1,0,0,0,1
"21534","shan’t",1,0,0,0,1
"21535","shankland",0,0,0,1,1
"21536","shapeof",1,0,0,0,1
"21537","sharehis",1,0,0,0,1
"21538","sharein",1,0,0,0,1
"21539","shareof",1,0,0,0,1
"21540","sharpen",1,0,0,0,1
"21541","sharpened",1,0,0,0,1
"21542","shatteredinstitutions",1,0,0,0,1
"21543","shaved",1,0,0,0,1
"21544","shawl",1,0,0,0,1
"21545","shebawhen",1,0,0,0,1
"21546","shebound",1,0,0,0,1
"21547","shechopped",1,0,0,0,1
"21548","shecould",1,0,0,0,1
"21549","sheesteemed",1,0,0,0,1
"21550","sheexpected",1,0,0,0,1
"21551","shekept",1,0,0,0,1
"21552","shelters",0,0,0,1,1
"21553","shelterunder",1,0,0,0,1
"21554","shenandoah",1,0,0,0,1
"21555","sheoften",1,0,0,0,1
"21556","shepherd",0,1,0,0,1
"21557","sheriffof",1,0,0,0,1
"21558","shesupposed",1,0,0,0,1
"21559","shielded",1,0,0,0,1
"21560","shilling",0,1,0,0,1
"21561","shillings",0,1,0,0,1
"21562","shillingssterling",1,0,0,0,1
"21563","shin",0,0,0,1,1
"21564","shinesfor",1,0,0,0,1
"21565","shingle",0,0,1,0,1
"21566","ship.my",1,0,0,0,1
"21567","shipboard",0,0,0,1,1
"21568","shipfor",1,0,0,0,1
"21569","shipinto",1,0,0,0,1
"21570","shipsin",1,0,0,0,1
"21571","shipwork",1,0,0,0,1
"21572","shipyards",0,1,0,0,1
"21573","shiveredinto",1,0,0,0,1
"21574","shockingto",1,0,0,0,1
"21575","shod",1,0,0,0,1
"21576","shoe",0,0,0,1,1
"21577","shoeing",0,1,0,0,1
"21578","shoelesscrowd",1,0,0,0,1
"21579","shoemaker’s",1,0,0,0,1
"21580","shoemaking",0,0,1,0,1
"21581","shoesof",1,0,0,0,1
"21582","shone",0,0,1,0,1
"21583","shoot_",1,0,0,0,1
"21584","shorebeen",1,0,0,0,1
"21585","shoreof",1,0,0,0,1
"21586","shorn",1,0,0,0,1
"21587","shortof",1,0,0,0,1
"21588","shoulddisturb",1,0,0,0,1
"21589","shoulders.we",1,0,0,0,1
"21590","shouldfind",1,0,0,0,1
"21591","shouldget",1,0,0,0,1
"21592","shouldin",1,0,0,0,1
"21593","shouldknow",1,0,0,0,1
"21594","shouldleave",1,0,0,0,1
"21595","shouldlose",1,0,0,0,1
"21596","shouldmeet",1,0,0,0,1
"21597","shouldperform",1,0,0,0,1
"21598","shouldreach",1,0,0,0,1
"21599","shouldsurvive",1,0,0,0,1
"21600","shouldthink",1,0,0,0,1
"21601","shouting",1,0,0,0,1
"21602","shoutsof",1,0,0,0,1
"21603","shoveling",1,0,0,0,1
"21604","shovels",1,0,0,0,1
"21605","showed",0,0,0,1,1
"21606","showeda",1,0,0,0,1
"21607","showedsigns",1,0,0,0,1
"21608","showedthat",1,0,0,0,1
"21609","showered",1,0,0,0,1
"21610","showing",0,0,0,1,1
"21611","shownso",1,0,0,0,1
"21612","showy",0,1,0,0,1
"21613","shroudedghosts",1,0,0,0,1
"21614","shrubbery",0,1,0,0,1
"21615","shrunk",0,1,0,0,1
"21616","shunnedwere",1,0,0,0,1
"21617","shuns",1,0,0,0,1
"21618","shy",0,1,0,0,1
"21619","sibley",1,0,0,0,1
"21620","sibleyhall",1,0,0,0,1
"21621","sicilily",0,0,0,1,1
"21622","sicily",0,0,0,1,1
"21623","sicken",0,1,0,0,1
"21624","sickens",0,1,0,0,1
"21625","sicknessand",1,0,0,0,1
"21626","side_",0,1,0,0,1
"21627","side.as",1,0,0,0,1
"21628","side.the",1,0,0,0,1
"21629","sidewalk",1,0,0,0,1
"21630","sidney",0,0,0,1,1
"21631","siever",0,1,0,0,1
"21632","sight ",0,0,0,1,1
"21633","sight.notwithstanding",1,0,0,0,1
"21634","sign.these",1,0,0,0,1
"21635","signally",1,0,0,0,1
"21636","signature",0,1,0,0,1
"21637","signification",0,1,0,0,1
"21638","signifying",1,0,0,0,1
"21639","signing",1,0,0,0,1
"21640","silenceand",1,0,0,0,1
"21641","similarexperience",1,0,0,0,1
"21642","simms",1,0,0,0,1
"21643","simon",1,0,0,0,1
"21644","simpleand",1,0,0,0,1
"21645","simplecarrying",1,0,0,0,1
"21646","simplereward",1,0,0,0,1
"21647","simultaneouspresentiment",1,0,0,0,1
"21648","since.some",1,0,0,0,1
"21649","sinceabby",1,0,0,0,1
"21650","sincebecome",1,0,0,0,1
"21651","sincei",1,0,0,0,1
"21652","sinceit",1,0,0,0,1
"21653","sincerety",0,0,0,1,1
"21654","sinew",1,0,0,0,1
"21655","sinewy",1,0,0,0,1
"21656","singingunder",1,0,0,0,1
"21657","singingwhen",1,0,0,0,1
"21658","singleexception",1,0,0,0,1
"21659","singleindividuality",1,0,0,0,1
"21660","singleremove",1,0,0,0,1
"21661","sings",0,1,0,0,1
"21662","singularlyfortunate",1,0,0,0,1
"21663","singularwisdom",1,0,0,0,1
"21664","sinks",0,1,0,0,1
"21665","sip",0,0,1,0,1
"21666","sire",0,1,0,0,1
"21667","sires",0,0,1,0,1
"21668","sirjohn’s",1,0,0,0,1
"21669","sissons",1,0,0,0,1
"21670","sisterly",0,1,0,0,1
"21671","site",0,0,0,1,1
"21672","sites",1,0,0,0,1
"21673","sits",0,0,1,0,1
"21674","situation.unlike",1,0,0,0,1
"21675","situationseveral",1,0,0,0,1
"21676","sixdollars",1,0,0,0,1
"21677","sixmen",1,0,0,0,1
"21678","sixmonths",1,0,0,0,1
"21679","sixteenth",0,1,0,0,1
"21680","sixth",0,1,0,0,1
"21681","sjour",0,0,0,1,1
"21682","skeptical",1,0,0,0,1
"21683","skeptics",0,0,1,0,1
"21684","sketching",0,1,0,0,1
"21685","skilful",0,0,1,0,1
"21686","skilfully",1,0,0,0,1
"21687","skilland",1,0,0,0,1
"21688","skilled",0,1,0,0,1
"21689","skillfulphysician",1,0,0,0,1
"21690","skinoff",1,0,0,0,1
"21691","skins.the",1,0,0,0,1
"21692","skintaken",1,0,0,0,1
"21693","skipped",0,1,0,0,1
"21694","skirmish",0,1,0,0,1
"21695","skirt",0,0,0,1,1
"21696","skirts_",0,1,0,0,1
"21697","skirtslest",1,0,0,0,1
"21698","sky_",1,0,0,0,1
"21699","slanderer",0,1,0,0,1
"21700","slanderously",1,0,0,0,1
"21701","slang",1,0,0,0,1
"21702","slashing",0,0,1,0,1
"21703","slat",0,0,1,0,1
"21704","slaughtered",1,0,0,0,1
"21705","slaughterhouse",0,0,1,0,1
"21706","slaughterof",1,0,0,0,1
"21707","slave.chapter",1,0,0,0,1
"21708","slave.i",1,0,0,0,1
"21709","slave.many",1,0,0,0,1
"21710","slave.there",1,0,0,0,1
"21711","slave.well",1,0,0,0,1
"21712","slave.when",1,0,0,0,1
"21713","slave’sanswer",1,0,0,0,1
"21714","slaveas",1,0,0,0,1
"21715","slavebill",1,0,0,0,1
"21716","slavefor",1,0,0,0,1
"21717","slavefound",1,0,0,0,1
"21718","slaveholder.established",1,0,0,0,1
"21719","slaveholder.i",1,0,0,0,1
"21720","slaveholders.it",1,0,0,0,1
"21721","slaveholders.the",1,0,0,0,1
"21722","slaveholdershall",1,0,0,0,1
"21723","slaveholdersnot",1,0,0,0,1
"21724","slaveholdersregarded",1,0,0,0,1
"21725","slaveholdersserving",1,0,0,0,1
"21726","slaveholdersthere",1,0,0,0,1
"21727","slaveholderwas",1,0,0,0,1
"21728","slaveholdinginstrument",1,0,0,0,1
"21729","slaveholdingladies",1,0,0,0,1
"21730","slaveholdingrebellion",1,0,0,0,1
"21731","slaveholdingrebellion.under",1,0,0,0,1
"21732","slaveholdingsouth",1,0,0,0,1
"21733","slaveholdingstates",1,0,0,0,1
"21734","slavehounds",1,0,0,0,1
"21735","slavehunt",0,0,0,1,1
"21736","slaveman",0,1,0,0,1
"21737","slavemasters",0,1,0,0,1
"21738","slaveof",1,0,0,0,1
"21739","slaveoverseer",1,0,0,0,1
"21740","slavepower",1,0,0,0,1
"21741","slaveproperty",1,0,0,0,1
"21742","slaverejoins",1,0,0,0,1
"21743","slavery_always_",1,0,0,0,1
"21744","slavery.at",1,0,0,0,1
"21745","slavery.from",1,0,0,0,1
"21746","slavery.it",1,0,0,0,1
"21747","slavery.observing",1,0,0,0,1
"21748","slavery.so",1,0,0,0,1
"21749","slavery.they",1,0,0,0,1
"21750","slavery.to",1,0,0,0,1
"21751","slavery’s",0,1,0,0,1
"21752","slaveryall",1,0,0,0,1
"21753","slaverybanner",1,0,0,0,1
"21754","slaveryconvention",1,0,0,0,1
"21755","slaveryconventions",1,0,0,0,1
"21756","slaveryextension",1,0,0,0,1
"21757","slaveryforce",1,0,0,0,1
"21758","slaveryitself",1,0,0,0,1
"21759","slaverymeetings",1,0,0,0,1
"21760","slaverymen",1,0,0,0,1
"21761","slaverymovement",1,0,0,0,1
"21762","slaveryplatform",1,0,0,0,1
"21763","slaverypress",1,0,0,0,1
"21764","slaveryshould",1,0,0,0,1
"21765","slaveryspirit",1,0,0,0,1
"21766","slaverystruggle",1,0,0,0,1
"21767","slaverythan",1,0,0,0,1
"21768","slaverywhatever",1,0,0,0,1
"21769","slaves.chapter",1,0,0,0,1
"21770","slaves.practical",1,0,0,0,1
"21771","slaves.to",1,0,0,0,1
"21772","slaves’religious",1,0,0,0,1
"21773","slavesand",1,0,0,0,1
"21774","slavesemancipated",1,0,0,0,1
"21775","slavesociety",1,0,0,0,1
"21776","slavesof",1,0,0,0,1
"21777","slaveson",1,0,0,0,1
"21778","slavesor",1,0,0,0,1
"21779","slavestate",1,0,0,0,1
"21780","slavestates",1,0,0,0,1
"21781","slavesthereafter.the",1,0,0,0,1
"21782","slavesthis",1,0,0,0,1
"21783","slaveswho",1,0,0,0,1
"21784","slaveswith",1,0,0,0,1
"21785","slavesystem.chapter",1,0,0,0,1
"21786","slaveto",1,0,0,0,1
"21787","slavewas",1,0,0,0,1
"21788","slavewith",1,0,0,0,1
"21789","slavewomen",0,1,0,0,1
"21790","slavewould",1,0,0,0,1
"21791","slay",1,0,0,0,1
"21792","slayers",1,0,0,0,1
"21793","slazily",0,1,0,0,1
"21794","slearce",0,0,0,1,1
"21795","sledge",1,0,0,0,1
"21796","sleepingapartments",1,0,0,0,1
"21797","sleepingthere",1,0,0,0,1
"21798","sleepwithin",1,0,0,0,1
"21799","sleigh",1,0,0,0,1
"21800","slew",1,0,0,0,1
"21801","slice",0,1,0,0,1
"21802","slidden",1,0,0,0,1
"21803","slide",1,0,0,0,1
"21804","slightdegree",1,0,0,0,1
"21805","slighted",1,0,0,0,1
"21806","slightedor",1,0,0,0,1
"21807","slightestwarning",1,0,0,0,1
"21808","slightnor",1,0,0,0,1
"21809","slipping",1,0,0,0,1
"21810","slowness",1,0,0,0,1
"21811","smallestpossible",1,0,0,0,1
"21812","smallindividual",1,0,0,0,1
"21813","smallness",1,0,0,0,1
"21814","smallthe",1,0,0,0,1
"21815","smalltree",1,0,0,0,1
"21816","smelling",1,0,0,0,1
"21817","smith’swharf",1,0,0,0,1
"21818","smitted",0,1,0,0,1
"21819","smittenwith",1,0,0,0,1
"21820","smoke.the",1,0,0,0,1
"21821","smoking",0,0,0,1,1
"21822","smyth",1,0,0,0,1
"21823","snapped",0,1,0,0,1
"21824","snatches",0,1,0,0,1
"21825","snatching",0,1,0,0,1
"21826","snowflakes",1,0,0,0,1
"21827","snubbed",0,1,0,0,1
"21828","snuffed",0,1,0,0,1
"21829","so.bent",1,0,0,0,1
"21830","so.the",1,0,0,0,1
"21831","soagain",1,0,0,0,1
"21832","soalso",1,0,0,0,1
"21833","soane",0,0,0,1,1
"21834","soaptly",1,0,0,0,1
"21835","soars",0,1,0,0,1
"21836","soas",1,0,0,0,1
"21837","soberlyresent",1,0,0,0,1
"21838","soberthinking",1,0,0,0,1
"21839","socialimprovement",1,0,0,0,1
"21840","socialoffice",1,0,0,0,1
"21841","socialreformers",1,0,0,0,1
"21842","socialscience",1,0,0,0,1
"21843","society.they",1,0,0,0,1
"21844","societyas",1,0,0,0,1
"21845","societyin",1,0,0,0,1
"21846","societymust",1,0,0,0,1
"21847","socompletely",1,0,0,0,1
"21848","socratic",0,1,0,0,1
"21849","sodereni",0,0,0,1,1
"21850","soearnest",1,0,0,0,1
"21851","soexamined",1,0,0,0,1
"21852","sofortunate",1,0,0,0,1
"21853","sofree",1,0,0,0,1
"21854","softest",0,1,0,0,1
"21855","softwhite",1,0,0,0,1
"21856","sogoaded",1,0,0,0,1
"21857","sogreat",1,0,0,0,1
"21858","sohappened",1,0,0,0,1
"21859","sohis",1,0,0,0,1
"21860","soilconvention",1,0,0,0,1
"21861","soilers",1,0,0,0,1
"21862","soinduce",1,0,0,0,1
"21863","sojournertruth",1,0,0,0,1
"21864","sojourning",1,0,0,0,1
"21865","sokind",1,0,0,0,1
"21866","sol.law’s",1,0,0,0,1
"21867","solace",0,1,0,0,1
"21868","soldierly",1,0,0,0,1
"21869","soldierof",1,0,0,0,1
"21870","soldiersdid",1,0,0,0,1
"21871","soldoff",1,0,0,0,1
"21872","solemn.from",1,0,0,0,1
"21873","solemnand",1,0,0,0,1
"21874","solemnity.the",1,0,0,0,1
"21875","solemnshades",1,0,0,0,1
"21876","solicitude",1,0,0,0,1
"21877","solidmake",1,0,0,0,1
"21878","solidmen",1,0,0,0,1
"21879","solidpurpose",1,0,0,0,1
"21880","soliloquizing",0,0,1,0,1
"21881","solitudewith",1,0,0,0,1
"21882","solution",0,1,0,0,1
"21883","solve",0,1,0,0,1
"21884","somalia",0,0,0,1,1
"21885","somebody’schild",1,0,0,0,1
"21886","somecolored",1,0,0,0,1
"21887","somecourage",1,0,0,0,1
"21888","somecrime",1,0,0,0,1
"21889","somedistant",1,0,0,0,1
"21890","somefeeling",1,0,0,0,1
"21891","somegentlemen",1,0,0,0,1
"21892","somehow",0,0,0,1,1
"21893","somemonster",1,0,0,0,1
"21894","someobjection",1,0,0,0,1
"21895","somerespects",1,0,0,0,1
"21896","somesense",1,0,0,0,1
"21897","someslaveholders",1,0,0,0,1
"21898","somestartling",1,0,0,0,1
"21899","somethinga",1,0,0,0,1
"21900","somethingelse",1,0,0,0,1
"21901","somethingfor",1,0,0,0,1
"21902","somethingmissionary",1,0,0,0,1
"21903","somethingoccurred",1,0,0,0,1
"21904","somethingof",1,0,0,0,1
"21905","somethingstartling",1,0,0,0,1
"21906","sometimes",0,0,0,1,1
"21907","sometimesdid",1,0,0,0,1
"21908","sometimesmade",1,0,0,0,1
"21909","sometimespersons",1,0,0,0,1
"21910","sometimesrub",1,0,0,0,1
"21911","sometimesthought",1,0,0,0,1
"21912","someting",0,0,0,1,1
"21913","sometransgression",1,0,0,0,1
"21914","somewhatrelented",1,0,0,0,1
"21915","somewhatsimilar",1,0,0,0,1
"21916","sonandrew",1,0,0,0,1
"21917","songsgreatly",1,0,0,0,1
"21918","sonicely",1,0,0,0,1
"21919","sonthomas",1,0,0,0,1
"21920","sonumerous",1,0,0,0,1
"21921","sonumerously",1,0,0,0,1
"21922","soonafter",1,0,0,0,1
"21923","soonerseated",1,0,0,0,1
"21924","soonready",1,0,0,0,1
"21925","soonwore",1,0,0,0,1
"21926","sophia’s",0,1,0,0,1
"21927","sophiawas",1,0,0,0,1
"21928","sophy",0,1,0,0,1
"21929","sorely",0,1,0,0,1
"21930","sorrow.there",1,0,0,0,1
"21931","sorrowful",1,0,0,0,1
"21932","sorrownor",1,0,0,0,1
"21933","sortof",1,0,0,0,1
"21934","sothat",1,0,0,0,1
"21935","soughtme",1,0,0,0,1
"21936","soul.from",1,0,0,0,1
"21937","soulhe",1,0,0,0,1
"21938","soulless",1,0,0,0,1
"21939","soulof",1,0,0,0,1
"21940","souls.the",1,0,0,0,1
"21941","soulsand",1,0,0,0,1
"21942","soulthan",1,0,0,0,1
"21943","soundhis",1,0,0,0,1
"21944","soundprofounder",1,0,0,0,1
"21945","soundsleep",1,0,0,0,1
"21946","soundwhipping",1,0,0,0,1
"21947","soup",1,0,0,0,1
"21948","sourman",1,0,0,0,1
"21949","south.the",1,0,0,0,1
"21950","southeast",1,0,0,0,1
"21951","southeasterly",1,0,0,0,1
"21952","southernchristian",1,0,0,0,1
"21953","southernfeeling",1,0,0,0,1
"21954","southerngrievances",1,0,0,0,1
"21955","southernlife",1,0,0,0,1
"21956","southernport",1,0,0,0,1
"21957","southernproperty",1,0,0,0,1
"21958","southernsentiment",1,0,0,0,1
"21959","southneeded",1,0,0,0,1
"21960","southward",0,0,1,0,1
"21961","southwas",1,0,0,0,1
"21962","southwere",1,0,0,0,1
"21963","southwest",1,0,0,0,1
"21964","southwestcorner",1,0,0,0,1
"21965","southwesterly",1,0,0,0,1
"21966","southwick",1,0,0,0,1
"21967","southwicks",1,0,0,0,1
"21968","sovigorously",1,0,0,0,1
"21969","sow",1,0,0,0,1
"21970","sowould",1,0,0,0,1
"21971","sowthey",1,0,0,0,1
"21972","spades",1,0,0,0,1
"21973","spake",1,0,0,0,1
"21974","spans",1,0,0,0,1
"21975","sparingly",0,0,1,0,1
"21976","sparkled",0,1,0,0,1
"21977","sparkling",0,1,0,0,1
"21978","sparrow",1,0,0,0,1
"21979","sparta",0,0,0,1,1
"21980","spartan",0,0,1,0,1
"21981","spartan.it",1,0,0,0,1
"21982","speak_",1,0,0,0,1
"21983","speakaltogether",1,0,0,0,1
"21984","speakat",1,0,0,0,1
"21985","speaker’s",1,0,0,0,1
"21986","speaketh",0,1,0,0,1
"21987","speakingin",1,0,0,0,1
"21988","speakingwith",1,0,0,0,1
"21989","speakthan",1,0,0,0,1
"21990","speakto",1,0,0,0,1
"21991","specialinterest",1,0,0,0,1
"21992","specialmeasures",1,0,0,0,1
"21993","specialrelation",1,0,0,0,1
"21994","specious",0,0,1,0,1
"21995","speck",0,1,0,0,1
"21996","spectacles",1,0,0,0,1
"21997","spectator",0,1,0,0,1
"21998","spectators",0,0,0,1,1
"21999","speculate",0,1,0,0,1
"22000","speculation",0,1,0,0,1
"22001","speculations",0,1,0,0,1
"22002","speculationsconcerning",1,0,0,0,1
"22003","sped",1,0,0,0,1
"22004","speech.but",1,0,0,0,1
"22005","speech.this",1,0,0,0,1
"22006","speechesmade",1,0,0,0,1
"22007","speechesof",1,0,0,0,1
"22008","speecheswas",1,0,0,0,1
"22009","speecheswere",1,0,0,0,1
"22010","speechin",1,0,0,0,1
"22011","speechless",1,0,0,0,1
"22012","speechwas",1,0,0,0,1
"22013","speeding",1,0,0,0,1
"22014","spellwords",1,0,0,0,1
"22015","spended",0,0,0,1,1
"22016","spends",1,0,0,0,1
"22017","spendthe",1,0,0,0,1
"22018","spentabroad",1,0,0,0,1
"22019","spentmuch",1,0,0,0,1
"22020","spenton",1,0,0,0,1
"22021","spentthe",1,0,0,0,1
"22022","spenttheir",1,0,0,0,1
"22023","spheres",0,1,0,0,1
"22024","spicy",0,1,0,0,1
"22025","spicydialogues",1,0,0,0,1
"22026","spirit.on",1,0,0,0,1
"22027","spiritan",1,0,0,0,1
"22028","spiritedwoman",1,0,0,0,1
"22029","spiritevinced",1,0,0,0,1
"22030","spiritnecessary",1,0,0,0,1
"22031","spirits.to",1,0,0,0,1
"22032","spiteful",1,0,0,0,1
"22033","splender",0,0,0,1,1
"22034","splendidvehemence",1,0,0,0,1
"22035","splendour",0,0,0,1,1
"22036","spoil.a",1,0,0,0,1
"22037","spoilfrom",1,0,0,0,1
"22038","spoke.foster",1,0,0,0,1
"22039","spokehis",1,0,0,0,1
"22040","spoken.the",1,0,0,0,1
"22041","spokenbetween",1,0,0,0,1
"22042","spokesman",1,0,0,0,1
"22043","spoon",0,1,0,0,1
"22044","spooner",1,0,0,0,1
"22045","spooners",1,0,0,0,1
"22046","sportsman’s",0,1,0,0,1
"22047","spotted",0,0,0,1,1
"22048","spouse",0,1,0,0,1
"22049","spouted",0,0,0,1,1
"22050","sprague",1,0,0,0,1
"22051","sprang",0,0,1,0,1
"22052","sprawling",0,0,1,0,1
"22053","spray",0,0,0,1,1
"22054","spreadall",1,0,0,0,1
"22055","springfieldwithout",1,0,0,0,1
"22056","springfor",1,0,0,0,1
"22057","springingrace",1,0,0,0,1
"22058","springling",0,0,0,1,1
"22059","springof",1,0,0,0,1
"22060","springsfrom",1,0,0,0,1
"22061","springsupply",1,0,0,0,1
"22062","springy",0,1,0,0,1
"22063","sprungfrom",1,0,0,0,1
"22064","spung",0,0,0,1,1
"22065","spurgeon",0,0,0,1,1
"22066","spurning",1,0,0,0,1
"22067","squad.hating",1,0,0,0,1
"22068","squadron",0,1,0,0,1
"22069","squaler",0,0,0,1,1
"22070","squandered",1,0,0,0,1
"22071","squanderingin",1,0,0,0,1
"22072","squares",0,0,0,1,1
"22073","squatter",1,0,0,0,1
"22074","squirming",1,0,0,0,1
"22075","stableformerly",1,0,0,0,1
"22076","stablehad",1,0,0,0,1
"22077","stages",1,0,0,0,1
"22078","staggeredme",1,0,0,0,1
"22079","staggers",0,0,1,0,1
"22080","stain",0,1,0,0,1
"22081","stains",0,1,0,0,1
"22082","stairs",1,0,0,0,1
"22083","stakes",1,0,0,0,1
"22084","stalk",1,0,0,0,1
"22085","stalwartanti",1,0,0,0,1
"22086","stamina",0,1,0,0,1
"22087","stamps",0,1,0,0,1
"22088","standardbearer",1,0,0,0,1
"22089","standards",0,1,0,0,1
"22090","standers",0,1,0,0,1
"22091","standing.only",1,0,0,0,1
"22092","standing.the",1,0,0,0,1
"22093","standingthere",1,0,0,0,1
"22094","standit",1,0,0,0,1
"22095","stanley",0,0,1,0,1
"22096","stanton’s",1,0,0,0,1
"22097","stantons",0,0,0,1,1
"22098","starch",0,1,0,0,1
"22099","starsbut",1,0,0,0,1
"22100","starsin",1,0,0,0,1
"22101","start.early",1,0,0,0,1
"22102","startledand",1,0,0,0,1
"22103","startlingcolors",1,0,0,0,1
"22104","starves",0,0,1,0,1
"22105","state",0,0,0,1,1
"22106","state.about",1,0,0,0,1
"22107","stated.after",1,0,0,0,1
"22108","stateis",1,0,0,0,1
"22109","statelyveranda",1,0,0,0,1
"22110","statementdid",1,0,0,0,1
"22111","statepaper",1,0,0,0,1
"22112","stateroom",0,0,0,1,1
"22113","states.an",1,0,0,0,1
"22114","states.as",1,0,0,0,1
"22115","states.fellow",1,0,0,0,1
"22116","states.he",1,0,0,0,1
"22117","states.mrs",1,0,0,0,1
"22118","states.my",1,0,0,0,1
"22119","states.this",1,0,0,0,1
"22120","states.when",1,0,0,0,1
"22121","statesettlers",1,0,0,0,1
"22122","statesgranting",1,0,0,0,1
"22123","stateshould",1,0,0,0,1
"22124","statesmanto",1,0,0,0,1
"22125","statesmenof",1,0,0,0,1
"22126","statespirit",1,0,0,0,1
"22127","stateswhere",1,0,0,0,1
"22128","statewere",1,0,0,0,1
"22129","statistics",1,0,0,0,1
"22130","status",0,0,0,1,1
"22131","statusof",1,0,0,0,1
"22132","stayand",1,0,0,0,1
"22133","stayon",1,0,0,0,1
"22134","steadiness",1,0,0,0,1
"22135","steamed",1,0,0,0,1
"22136","steamships",0,1,0,0,1
"22137","stearnspoured",1,0,0,0,1
"22138","steelwere",1,0,0,0,1
"22139","steer",1,0,0,0,1
"22140","steet",0,0,0,1,1
"22141","stem",1,0,0,0,1
"22142","stephensmith",1,0,0,0,1
"22143","stepon",1,0,0,0,1
"22144","stepout",1,0,0,0,1
"22145","stepping",1,0,0,0,1
"22146","stepspreparatory",1,0,0,0,1
"22147","stepsternly",1,0,0,0,1
"22148","stereotype",0,0,1,0,1
"22149","stereotyped",0,0,1,0,1
"22150","sterner",1,0,0,0,1
"22151","sternwill",1,0,0,0,1
"22152","sterrotyped",0,0,0,1,1
"22153","steve",0,1,0,0,1
"22154","stevens",1,0,0,0,1
"22155","steward",1,0,0,0,1
"22156","stickin",1,0,0,0,1
"22157","stickney",1,0,0,0,1
"22158","stickwhich",1,0,0,0,1
"22159","stigmatized",0,1,0,0,1
"22160","stilldefensive",1,0,0,0,1
"22161","stillmore",1,0,0,0,1
"22162","stillnessabout",1,0,0,0,1
"22163","stimulatedthe",1,0,0,0,1
"22164","stimulates",0,1,0,0,1
"22165","stinting",0,0,1,0,1
"22166","stipulate",1,0,0,0,1
"22167","stirs",1,0,0,0,1
"22168","stock.we",1,0,0,0,1
"22169","stockedwith",1,0,0,0,1
"22170","stocks",0,1,0,0,1
"22171","stolid",0,1,0,0,1
"22172","stomach",1,0,0,0,1
"22173","stonington",1,0,0,0,1
"22174","stoodby",1,0,0,0,1
"22175","stooped",1,0,0,0,1
"22176","stop.i",1,0,0,0,1
"22177","stoppedon",1,0,0,0,1
"22178","stopthe",1,0,0,0,1
"22179","store.this",1,0,0,0,1
"22180","storehouses",1,0,0,0,1
"22181","storer",1,0,0,0,1
"22182","storercollege",1,0,0,0,1
"22183","stormy.before",1,0,0,0,1
"22184","storrs",1,0,0,0,1
"22185","storyis",1,0,0,0,1
"22186","stoutly",0,1,0,0,1
"22187","stoutrope",1,0,0,0,1
"22188","stowe.about",1,0,0,0,1
"22189","stoweall",1,0,0,0,1
"22190","stowed",0,0,1,0,1
"22191","straightened",1,0,0,0,1
"22192","straightway",0,0,1,0,1
"22193","strains",0,0,0,1,1
"22194","strand",0,0,0,1,1
"22195","strangeand",1,0,0,0,1
"22196","strangeexperiences",1,0,0,0,1
"22197","strangelywandering",1,0,0,0,1
"22198","strangeness",0,1,0,0,1
"22199","strangenoises",1,0,0,0,1
"22200","strangerswho",1,0,0,0,1
"22201","strangerthan",1,0,0,0,1
"22202","strangethat",1,0,0,0,1
"22203","strangething",1,0,0,0,1
"22204","straps",1,0,0,0,1
"22205","strata",1,0,0,0,1
"22206","stratford",0,0,0,1,1
"22207","straying",1,0,0,0,1
"22208","streaded",0,0,0,1,1
"22209","streamer",0,0,0,1,1
"22210","streams",1,0,0,0,1
"22211","streetsof",1,0,0,0,1
"22212","strengthand",1,0,0,0,1
"22213","strengthenedfor",1,0,0,0,1
"22214","strengthof",1,0,0,0,1
"22215","strengthwas",1,0,0,0,1
"22216","stretch",1,0,0,0,1
"22217","stretchingits",1,0,0,0,1
"22218","strew",1,0,0,0,1
"22219","strewed",0,1,0,0,1
"22220","strickenhaste",1,0,0,0,1
"22221","strickenvirginia",1,0,0,0,1
"22222","strictest",0,1,0,0,1
"22223","strictness",0,0,1,0,1
"22224","strikingcontrast",1,0,0,0,1
"22225","string",0,1,0,0,1
"22226","stringent.and",1,0,0,0,1
"22227","stringing",0,1,0,0,1
"22228","stripesat",1,0,0,0,1
"22229","stripped",0,0,1,0,1
"22230","stroll",0,0,0,1,1
"22231","strolled",0,0,1,0,1
"22232","strong.when",1,0,0,0,1
"22233","strongerand",1,0,0,0,1
"22234","strongindignation",1,0,0,0,1
"22235","stronglyfavoring",1,0,0,0,1
"22236","stronglyguarded",1,0,0,0,1
"22237","stronglythan",1,0,0,0,1
"22238","struckme",1,0,0,0,1
"22239","structural",0,1,0,0,1
"22240","strugglecame",1,0,0,0,1
"22241","struggledwith",1,0,0,0,1
"22242","struggles",0,1,0,0,1
"22243","strumboli",0,0,0,1,1
"22244","strut",1,0,0,0,1
"22245","struts",0,1,0,0,1
"22246","strutting",1,0,0,0,1
"22247","stuart",1,0,0,0,1
"22248","stubborn",0,1,0,0,1
"22249","stubbornly",0,0,1,0,1
"22250","stuckthemselves",1,0,0,0,1
"22251","student",1,0,0,0,1
"22252","studies",0,1,0,0,1
"22253","stuggle",0,0,0,1,1
"22254","stultified",0,0,1,0,1
"22255","stumbled",0,1,0,0,1
"22256","stumbles",0,1,0,0,1
"22257","stumbling",1,0,0,0,1
"22258","stunnedand",1,0,0,0,1
"22259","stupidindifference",1,0,0,0,1
"22260","stupidity",0,0,1,0,1
"22261","sturdymanhood",1,0,0,0,1
"22262","sturge",0,1,0,0,1
"22263","styee",0,0,0,1,1
"22264","styled",1,0,0,0,1
"22265","suasionwould",1,0,0,0,1
"22266","subdividing",0,1,0,0,1
"22267","subdue",0,1,0,0,1
"22268","subjectin",1,0,0,0,1
"22269","subjectingthem",1,0,0,0,1
"22270","subjectionto",1,0,0,0,1
"22271","subjectively",1,0,0,0,1
"22272","subjectsof",1,0,0,0,1
"22273","subjectthemselves",1,0,0,0,1
"22274","sublimeenthusiasm",1,0,0,0,1
"22275","sublimespectacle",1,0,0,0,1
"22276","sublimity",0,0,1,0,1
"22277","submittedto",1,0,0,0,1
"22278","subordinates",1,0,0,0,1
"22279","subra",0,0,0,1,1
"22280","subsequentdevelopments",1,0,0,0,1
"22281","subsequentexperience",1,0,0,0,1
"22282","subsequently",1,0,0,0,1
"22283","subsequentlychanged",1,0,0,0,1
"22284","subsequentpolitical",1,0,0,0,1
"22285","subservient",1,0,0,0,1
"22286","subsistence",1,0,0,0,1
"22287","substancethan",1,0,0,0,1
"22288","substitute",1,0,0,0,1
"22289","substituted",0,1,0,0,1
"22290","substitutes",1,0,0,0,1
"22291","substitution",1,0,0,0,1
"22292","subversion",0,0,1,0,1
"22293","subversive",0,1,0,0,1
"22294","success.from",1,0,0,0,1
"22295","successes",1,0,0,0,1
"22296","successfulefforts",1,0,0,0,1
"22297","successfuloperation",1,0,0,0,1
"22298","succession",0,1,0,0,1
"22299","successive",1,0,0,0,1
"22300","successof",1,0,0,0,1
"22301","successors",1,0,0,0,1
"22302","successwhich",1,0,0,0,1
"22303","succumbed",0,1,0,0,1
"22304","sucessfully",0,1,0,0,1
"22305","such_",0,1,0,0,1
"22306","such.in",1,0,0,0,1
"22307","suchbeams",1,0,0,0,1
"22308","suchbecause",1,0,0,0,1
"22309","suchcompany",1,0,0,0,1
"22310","suchdeclaration",1,0,0,0,1
"22311","suchdenunciation",1,0,0,0,1
"22312","suchfacts",1,0,0,0,1
"22313","suchfrom",1,0,0,0,1
"22314","suchideas",1,0,0,0,1
"22315","suchmen",1,0,0,0,1
"22316","suchmention",1,0,0,0,1
"22317","suchpurpose.just",1,0,0,0,1
"22318","suchqualities",1,0,0,0,1
"22319","suchquestions",1,0,0,0,1
"22320","suchruling",1,0,0,0,1
"22321","suchtaking",1,0,0,0,1
"22322","suchthat",1,0,0,0,1
"22323","suchthings",1,0,0,0,1
"22324","suchtroops",1,0,0,0,1
"22325","sud",0,0,0,1,1
"22326","suddenabandonment",1,0,0,0,1
"22327","sufficientimportance",1,0,0,0,1
"22328","sufficientlyblunted",1,0,0,0,1
"22329","sufficing",1,0,0,0,1
"22330","suffrage.but",1,0,0,0,1
"22331","suffrage.gratitude",1,0,0,0,1
"22332","suffrageuniversal",1,0,0,0,1
"22333","suffragewere",1,0,0,0,1
"22334","suggested.on",1,0,0,0,1
"22335","suggesteddestitution",1,0,0,0,1
"22336","suggestedin",1,0,0,0,1
"22337","suggesting",1,0,0,0,1
"22338","suggestionswere",1,0,0,0,1
"22339","suggests",0,1,0,0,1
"22340","suitors",0,1,0,0,1
"22341","sullenly",1,0,0,0,1
"22342","sum_",0,1,0,0,1
"22343","summarily",1,0,0,0,1
"22344","summermorning",1,0,0,0,1
"22345","summit",0,0,0,1,1
"22346","summitslean",1,0,0,0,1
"22347","summon",0,1,0,0,1
"22348","summonedby",1,0,0,0,1
"22349","sumner.these",1,0,0,0,1
"22350","sumnersincerely",1,0,0,0,1
"22351","sumof",1,0,0,0,1
"22352","sumptuously",0,1,0,0,1
"22353","sumptuouslyevery",1,0,0,0,1
"22354","sumregularly",1,0,0,0,1
"22355","sumter",1,0,0,0,1
"22356","sund",0,0,0,1,1
"22357","sundaybest",1,0,0,0,1
"22358","sundayevening",1,0,0,0,1
"22359","sundaytrain",1,0,0,0,1
"22360","sundering",0,0,1,0,1
"22361","sunken",1,0,0,0,1
"22362","sunshine.one",1,0,0,0,1
"22363","sunshinein",1,0,0,0,1
"22364","superb",1,0,0,0,1
"22365","superbly",0,1,0,0,1
"22366","supererogation",1,0,0,0,1
"22367","superfluity",1,0,0,0,1
"22368","superfluous",1,0,0,0,1
"22369","superiorintelligence",1,0,0,0,1
"22370","superiorsin",1,0,0,0,1
"22371","superiorto",1,0,0,0,1
"22372","supernatural",0,1,0,0,1
"22373","superstitions",1,0,0,0,1
"22374","supplanting",1,0,0,0,1
"22375","suppliedthe",1,0,0,0,1
"22376","supplythem",1,0,0,0,1
"22377","supportedby",1,0,0,0,1
"22378","supports",0,1,0,0,1
"22379","supportwhich",1,0,0,0,1
"22380","supposable",1,0,0,0,1
"22381","supposedcomplicity",1,0,0,0,1
"22382","supposedinattention",1,0,0,0,1
"22383","supposedto",1,0,0,0,1
"22384","supremelaw",1,0,0,0,1
"22385","sure",0,0,0,1,1
"22386","sureenough",1,0,0,0,1
"22387","surethat",1,0,0,0,1
"22388","surethere",1,0,0,0,1
"22389","surged",1,0,0,0,1
"22390","surpassingit",1,0,0,0,1
"22391","surpassingly",0,0,0,1,1
"22392","surplus",0,1,0,0,1
"22393","surpriseand",1,0,0,0,1
"22394","surpriseswhich",1,0,0,0,1
"22395","surroundhim",1,0,0,0,1
"22396","surroundings.greatness",1,0,0,0,1
"22397","surveyingthe",1,0,0,0,1
"22398","susceptibilities",0,1,0,0,1
"22399","susceptible",0,1,0,0,1
"22400","suspected_one_",1,0,0,0,1
"22401","suspectedsomething",1,0,0,0,1
"22402","suspects",0,0,1,0,1
"22403","suspend",1,0,0,0,1
"22404","suspendany",1,0,0,0,1
"22405","suspicion.he",1,0,0,0,1
"22406","suspicionand",1,0,0,0,1
"22407","suspicious",0,1,0,0,1
"22408","suspiciously",1,0,0,0,1
"22409","susquehanna",1,0,0,0,1
"22410","sustainedthat",1,0,0,0,1
"22411","sustains",0,0,1,0,1
"22412","sustenance",0,1,0,0,1
"22413","sustentation",0,1,0,0,1
"22414","swaggeringvanity",1,0,0,0,1
"22415","swallows",1,0,0,0,1
"22416","swaphorses",1,0,0,0,1
"22417","swarms",0,0,1,0,1
"22418","swash",1,0,0,0,1
"22419","sway",0,0,1,0,1
"22420","swaying",1,0,0,0,1
"22421","swear",0,0,1,0,1
"22422","swede",1,0,0,0,1
"22423","swedish",1,0,0,0,1
"22424","sweepingover",1,0,0,0,1
"22425","sweeps",0,0,1,0,1
"22426","sweetcontent",1,0,0,0,1
"22427","sweetened",0,0,1,0,1
"22428","swelled",1,0,0,0,1
"22429","swelling",0,1,0,0,1
"22430","swifthorseman",1,0,0,0,1
"22431","swindled",1,0,0,0,1
"22432","swiss",0,0,0,1,1
"22433","switches_",0,1,0,0,1
"22434","switches.i",1,0,0,0,1
"22435","swollen",0,0,1,0,1
"22436","sword.to",1,0,0,0,1
"22437","sydneyhoward",1,0,0,0,1
"22438","syllables",0,1,0,0,1
"22439","symbol",1,0,0,0,1
"22440","symmetry",1,0,0,0,1
"22441","sympathizer",1,0,0,0,1
"22442","sympathizes",0,1,0,0,1
"22443","sympathywith",1,0,0,0,1
"22444","synagoguesof",1,0,0,0,1
"22445","system.in",1,0,0,0,1
"22446","system.it",1,0,0,0,1
"22447","systematictyranny",1,0,0,0,1
"22448","systemhas",1,0,0,0,1
"22449","systemof",1,0,0,0,1
"22450","t.downing",1,0,0,0,1
"22451","taberand",1,0,0,0,1
"22452","tabernacle",1,0,0,0,1
"22453","table.from",1,0,0,0,1
"22454","tableannounced",1,0,0,0,1
"22455","tablets ",0,0,0,1,1
"22456","tablewas",1,0,0,0,1
"22457","tablewhere",1,0,0,0,1
"22458","tabooed",0,1,0,0,1
"22459","taccillo",0,0,0,1,1
"22460","tactics",1,0,0,0,1
"22461","taints",0,1,0,0,1
"22462","take.i",1,0,0,0,1
"22463","takean",1,0,0,0,1
"22464","takedifferent",1,0,0,0,1
"22465","taken.teaching",1,0,0,0,1
"22466","takenfrom",1,0,0,0,1
"22467","takenprisoners",1,0,0,0,1
"22468","takeplace",1,0,0,0,1
"22469","takepleasure",1,0,0,0,1
"22470","taketea",1,0,0,0,1
"22471","taketheir",1,0,0,0,1
"22472","takingme",1,0,0,0,1
"22473","takingthe",1,0,0,0,1
"22474","talbotcounty",1,0,0,0,1
"22475","talentand",1,0,0,0,1
"22476","talkedabout",1,0,0,0,1
"22477","talker",0,0,0,1,1
"22478","talkof",1,0,0,0,1
"22479","talks",0,0,0,1,1
"22480","tallcorn",1,0,0,0,1
"22481","taller",0,1,0,0,1
"22482","tamboreenes",0,0,0,1,1
"22483","tangled",1,0,0,0,1
"22484","tank’ee",0,1,0,0,1
"22485","tapering",0,1,0,0,1
"22486","tapers",0,1,0,0,1
"22487","tapped",1,0,0,0,1
"22488","target",1,0,0,0,1
"22489","tarpaulin",1,0,0,0,1
"22490","tarried",1,0,0,0,1
"22491","tarring",0,0,1,0,1
"22492","tasked",0,0,1,0,1
"22493","taskmasters",1,0,0,0,1
"22494","tasks",1,0,0,0,1
"22495","tasted",1,0,0,0,1
"22496","tatters",1,0,0,0,1
"22497","taughtme",1,0,0,0,1
"22498","taughtthat",1,0,0,0,1
"22499","taughttheir",1,0,0,0,1
"22500","tavern",1,0,0,0,1
"22501","taxesupon",1,0,0,0,1
"22502","taxupon",1,0,0,0,1
"22503","teache",0,0,0,1,1
"22504","teachher",1,0,0,0,1
"22505","teachings",0,1,0,0,1
"22506","teachme",1,0,0,0,1
"22507","teams",0,0,1,0,1
"22508","tearfuleye",1,0,0,0,1
"22509","teaspoon",1,0,0,0,1
"22510","tech",0,1,0,0,1
"22511","teemed",1,0,0,0,1
"22512","teetotal",1,0,0,0,1
"22513","teh",0,0,0,1,1
"22514","telegraphed",0,0,0,1,1
"22515","tell",0,0,0,1,1
"22516","tellyour",1,0,0,0,1
"22517","temperand",1,0,0,0,1
"22518","temperately",1,0,0,0,1
"22519","temperedand",1,0,0,0,1
"22520","temporalwell",1,0,0,0,1
"22521","temporizing",0,1,0,0,1
"22522","temptedto",1,0,0,0,1
"22523","tenacity",0,1,0,0,1
"22524","tend",1,0,0,0,1
"22525","tended",1,0,0,0,1
"22526","tendedto",1,0,0,0,1
"22527","tenderedme",1,0,0,0,1
"22528","tendernesswith",1,0,0,0,1
"22529","tendollars",1,0,0,0,1
"22530","tenn",1,0,0,0,1
"22531","tennessee",1,0,0,0,1
"22532","tens",0,1,0,0,1
"22533","tension",1,0,0,0,1
"22534","tenth",0,1,0,0,1
"22535","term.i",1,0,0,0,1
"22536","term.mr",1,0,0,0,1
"22537","termed",0,1,0,0,1
"22538","terminated",0,1,0,0,1
"22539","termson",1,0,0,0,1
"22540","termswith",1,0,0,0,1
"22541","terrace",0,0,0,1,1
"22542","terraced",0,0,0,1,1
"22543","terrapin",0,1,0,0,1
"22544","terrapinwere",1,0,0,0,1
"22545","terribleyears",1,0,0,0,1
"22546","terrific",1,0,0,0,1
"22547","terrifyand",1,0,0,0,1
"22548","territorialgovernment",1,0,0,0,1
"22549","territoryembraced",1,0,0,0,1
"22550","territorywould",1,0,0,0,1
"22551","terrorfrom",1,0,0,0,1
"22552","terseness",0,1,0,0,1
"22553","tes",0,0,0,1,1
"22554","testimonycombined",1,0,0,0,1
"22555","testmy",1,0,0,0,1
"22556","tests",0,0,1,0,1
"22557","teuck",0,0,0,1,1
"22558","th ",0,0,0,1,1
"22559","th took",0,0,0,1,1
"22560","thana",1,0,0,0,1
"22561","thanabout",1,0,0,0,1
"22562","thanagainst",1,0,0,0,1
"22563","thanbetween",1,0,0,0,1
"22564","thandid",1,0,0,0,1
"22565","thaneither",1,0,0,0,1
"22566","thanfiction",1,0,0,0,1
"22567","thanhalf",1,0,0,0,1
"22568","thani",1,0,0,0,1
"22569","thanit",1,0,0,0,1
"22570","thankfully",0,1,0,0,1
"22571","thanking",1,0,0,0,1
"22572","thankingyou",1,0,0,0,1
"22573","thanks.it",1,0,0,0,1
"22574","thanksgivingat",1,0,0,0,1
"22575","thanksgivings",0,1,0,0,1
"22576","thanone",1,0,0,0,1
"22577","thanrome",1,0,0,0,1
"22578","thansunday",1,0,0,0,1
"22579","thanthat",1,0,0,0,1
"22580","thantheir",1,0,0,0,1
"22581","thanthis",1,0,0,0,1
"22582","thanto",1,0,0,0,1
"22583","thanyou",1,0,0,0,1
"22584","that_mistake_",1,0,0,0,1
"22585","that.i",1,0,0,0,1
"22586","that.the",1,0,0,0,1
"22587","that’s",0,1,0,0,1
"22588","thatafter",1,0,0,0,1
"22589","thatagreement.from",1,0,0,0,1
"22590","thatalmost",1,0,0,0,1
"22591","thatamerica",1,0,0,0,1
"22592","thatare",1,0,0,0,1
"22593","thatbetween",1,0,0,0,1
"22594","thatcan",1,0,0,0,1
"22595","thatcity",1,0,0,0,1
"22596","thatcity.master",1,0,0,0,1
"22597","thatconvenient",1,0,0,0,1
"22598","thatconvention",1,0,0,0,1
"22599","thatdenby",1,0,0,0,1
"22600","thatdoctors",1,0,0,0,1
"22601","thatdoctrine",1,0,0,0,1
"22602","thateaston",1,0,0,0,1
"22603","thateffect",1,0,0,0,1
"22604","thatends",1,0,0,0,1
"22605","thatevent",1,0,0,0,1
"22606","thatever",1,0,0,0,1
"22607","thatfell",1,0,0,0,1
"22608","thatgod",1,0,0,0,1
"22609","thatgrandmother",1,0,0,0,1
"22610","thathad",1,0,0,0,1
"22611","thathappy",1,0,0,0,1
"22612","thathard",1,0,0,0,1
"22613","thathereafter",1,0,0,0,1
"22614","thathis",1,0,0,0,1
"22615","thathour",1,0,0,0,1
"22616","thathousehold",1,0,0,0,1
"22617","thathughes",1,0,0,0,1
"22618","thatignorant",1,0,0,0,1
"22619","thatimpressive",1,0,0,0,1
"22620","thatit",1,0,0,0,1
"22621","thatjustice",1,0,0,0,1
"22622","thatlingered",1,0,0,0,1
"22623","thatmost",1,0,0,0,1
"22624","thatmr",1,0,0,0,1
"22625","thatmrs",1,0,0,0,1
"22626","thatno",1,0,0,0,1
"22627","thatnot",1,0,0,0,1
"22628","thatour",1,0,0,0,1
"22629","thatpainful",1,0,0,0,1
"22630","thatpart",1,0,0,0,1
"22631","thatparty",1,0,0,0,1
"22632","thatperhaps",1,0,0,0,1
"22633","thatplatform",1,0,0,0,1
"22634","thatpoint",1,0,0,0,1
"22635","thatseason",1,0,0,0,1
"22636","thatservant",1,0,0,0,1
"22637","thatslavery",1,0,0,0,1
"22638","thatsociety",1,0,0,0,1
"22639","thatsort",1,0,0,0,1
"22640","thatsurround",1,0,0,0,1
"22641","thattaking",1,0,0,0,1
"22642","thatterm",1,0,0,0,1
"22643","thatthereafter",1,0,0,0,1
"22644","thatto",1,0,0,0,1
"22645","thatwas",1,0,0,0,1
"22646","thatway",1,0,0,0,1
"22647","thatwhen",1,0,0,0,1
"22648","thatwhich",1,0,0,0,1
"22649","thatwhile",1,0,0,0,1
"22650","thatwhoever",1,0,0,0,1
"22651","thawed",1,0,0,0,1
"22652","thayer",1,0,0,0,1
"22653","the_abolitionists_",1,0,0,0,1
"22654","the_anti",1,0,0,0,1
"22655","the_bounteous_",1,0,0,0,1
"22656","the_liberator_",1,0,0,0,1
"22657","the_north_",1,0,0,0,1
"22658","theability",1,0,0,0,1
"22659","theaccomplishment",1,0,0,0,1
"22660","theadjoining",1,0,0,0,1
"22661","theadvocates",1,0,0,0,1
"22662","theafternoon",1,0,0,0,1
"22663","theagent",1,0,0,0,1
"22664","theaisles",1,0,0,0,1
"22665","thealliance",1,0,0,0,1
"22666","thealmost",1,0,0,0,1
"22667","theample",1,0,0,0,1
"22668","theanguish",1,0,0,0,1
"22669","theannexation",1,0,0,0,1
"22670","theanniversary",1,0,0,0,1
"22671","theannouncement",1,0,0,0,1
"22672","theanswer",1,0,0,0,1
"22673","theanxious",1,0,0,0,1
"22674","theapproval",1,0,0,0,1
"22675","thearistocratic",1,0,0,0,1
"22676","thearmy",1,0,0,0,1
"22677","theashes",1,0,0,0,1
"22678","theassassin’s",1,0,0,0,1
"22679","theassembly",1,0,0,0,1
"22680","theatre",1,0,0,0,1
"22681","theatricals",0,0,0,1,1
"22682","theatrocity",1,0,0,0,1
"22683","theattributes",1,0,0,0,1
"22684","theaudacity",1,0,0,0,1
"22685","theaudience",1,0,0,0,1
"22686","theauthor",1,0,0,0,1
"22687","theawful",1,0,0,0,1
"22688","theback",1,0,0,0,1
"22689","thebald",1,0,0,0,1
"22690","theballot",1,0,0,0,1
"22691","thebank",1,0,0,0,1
"22692","thebanks",1,0,0,0,1
"22693","thebargain",1,0,0,0,1
"22694","thebasis",1,0,0,0,1
"22695","thebattle",1,0,0,0,1
"22696","thebay",1,0,0,0,1
"22697","thebell",1,0,0,0,1
"22698","thebellows",1,0,0,0,1
"22699","thebells",1,0,0,0,1
"22700","thebenefit",1,0,0,0,1
"22701","theblacks",1,0,0,0,1
"22702","thebody",1,0,0,0,1
"22703","thebottom",1,0,0,0,1
"22704","theboy",1,0,0,0,1
"22705","thebrave",1,0,0,0,1
"22706","thebravery",1,0,0,0,1
"22707","thebreaking",1,0,0,0,1
"22708","thebridge",1,0,0,0,1
"22709","thebritish",1,0,0,0,1
"22710","thebroad",1,0,0,0,1
"22711","thebusiness",1,0,0,0,1
"22712","thecabin",1,0,0,0,1
"22713","thecamp",1,0,0,0,1
"22714","thecapitalist",1,0,0,0,1
"22715","thecar",1,0,0,0,1
"22716","thecarpenters",1,0,0,0,1
"22717","thecarriages",1,0,0,0,1
"22718","thecase",1,0,0,0,1
"22719","thecast",1,0,0,0,1
"22720","thecenter",1,0,0,0,1
"22721","theceremonies",1,0,0,0,1
"22722","thecertainty",1,0,0,0,1
"22723","thechairman",1,0,0,0,1
"22724","thechampions",1,0,0,0,1
"22725","thechapter",1,0,0,0,1
"22726","thechesapeake",1,0,0,0,1
"22727","thechief",1,0,0,0,1
"22728","thechristian",1,0,0,0,1
"22729","thechurches",1,0,0,0,1
"22730","thecity",1,0,0,0,1
"22731","theclouds",1,0,0,0,1
"22732","thecommunity",1,0,0,0,1
"22733","thecomplaints",1,0,0,0,1
"22734","thecondition",1,0,0,0,1
"22735","theconditions",1,0,0,0,1
"22736","theconduct",1,0,0,0,1
"22737","theconfederate",1,0,0,0,1
"22738","theconscience",1,0,0,0,1
"22739","theconsequences",1,0,0,0,1
"22740","theconservatives",1,0,0,0,1
"22741","theconstable",1,0,0,0,1
"22742","thecontrary",1,0,0,0,1
"22743","theconvention.i",1,0,0,0,1
"22744","thecopperhead",1,0,0,0,1
"22745","thecorners",1,0,0,0,1
"22746","thecornfield",1,0,0,0,1
"22747","thecouncil",1,0,0,0,1
"22748","thecouncils",1,0,0,0,1
"22749","thecounty",1,0,0,0,1
"22750","thecradle",1,0,0,0,1
"22751","thecross",1,0,0,0,1
"22752","thecruel",1,0,0,0,1
"22753","thecruelty",1,0,0,0,1
"22754","thecutter",1,0,0,0,1
"22755","thedangers",1,0,0,0,1
"22756","thedaughter",1,0,0,0,1
"22757","thedawn",1,0,0,0,1
"22758","theday",1,0,0,0,1
"22759","thedear",1,0,0,0,1
"22760","thedecision",1,0,0,0,1
"22761","thedeepest",1,0,0,0,1
"22762","thedefence",1,0,0,0,1
"22763","thedeficiencies",1,0,0,0,1
"22764","thedelegation",1,0,0,0,1
"22765","thedemocratic",1,0,0,0,1
"22766","thedemonstrations",1,0,0,0,1
"22767","thedepartment",1,0,0,0,1
"22768","thedestruction",1,0,0,0,1
"22769","thedictionary",1,0,0,0,1
"22770","thedifference",1,0,0,0,1
"22771","thediscipline",1,0,0,0,1
"22772","thedistance",1,0,0,0,1
"22773","thedistinguished",1,0,0,0,1
"22774","thedoctrine",1,0,0,0,1
"22775","thedog",1,0,0,0,1
"22776","thedoor",1,0,0,0,1
"22777","thedressed",1,0,0,0,1
"22778","thedrill",1,0,0,0,1
"22779","theearth",1,0,0,0,1
"22780","theeastern",1,0,0,0,1
"22781","theeffort",1,0,0,0,1
"22782","theelection",1,0,0,0,1
"22783","theeminent",1,0,0,0,1
"22784","theend",1,0,0,0,1
"22785","theends",1,0,0,0,1
"22786","theenslavement",1,0,0,0,1
"22787","theensuing",1,0,0,0,1
"22788","theenthusiasm",1,0,0,0,1
"22789","theequal",1,0,0,0,1
"22790","theestate",1,0,0,0,1
"22791","theevangelical",1,0,0,0,1
"22792","theevents",1,0,0,0,1
"22793","theevidence",1,0,0,0,1
"22794","theexalted",1,0,0,0,1
"22795","theexclusion",1,0,0,0,1
"22796","theexecutive",1,0,0,0,1
"22797","theexit",1,0,0,0,1
"22798","theexpectations",1,0,0,0,1
"22799","theexpedition",1,0,0,0,1
"22800","theexperience",1,0,0,0,1
"22801","theexperiment",1,0,0,0,1
"22802","theexplosive",1,0,0,0,1
"22803","theextent",1,0,0,0,1
"22804","theextirpation",1,0,0,0,1
"22805","thefacility",1,0,0,0,1
"22806","thefall",1,0,0,0,1
"22807","thefamous",1,0,0,0,1
"22808","thefan",1,0,0,0,1
"22809","thefarm",1,0,0,0,1
"22810","thefast",1,0,0,0,1
"22811","thefather",1,0,0,0,1
"22812","thefavor",1,0,0,0,1
"22813","thefeasibility",1,0,0,0,1
"22814","thefeeling",1,0,0,0,1
"22815","thefeelings",1,0,0,0,1
"22816","thefellow",1,0,0,0,1
"22817","thefeminine",1,0,0,0,1
"22818","thefifteenth",1,0,0,0,1
"22819","thefight",1,0,0,0,1
"22820","thefinal",1,0,0,0,1
"22821","thefinance",1,0,0,0,1
"22822","thefine",1,0,0,0,1
"22823","thefinest",1,0,0,0,1
"22824","thefire",1,0,0,0,1
"22825","theflood",1,0,0,0,1
"22826","theforegoing",1,0,0,0,1
"22827","theforehead",1,0,0,0,1
"22828","theforemost",1,0,0,0,1
"22829","thefour",1,0,0,0,1
"22830","thefree",1,0,0,0,1
"22831","thefreedman",1,0,0,0,1
"22832","thefreedmen’s",1,0,0,0,1
"22833","thefriends",1,0,0,0,1
"22834","thefront",1,0,0,0,1
"22835","thefrosts",1,0,0,0,1
"22836","thegenerous",1,0,0,0,1
"22837","thegeorgia",1,0,0,0,1
"22838","thegovernor",1,0,0,0,1
"22839","thegraceful",1,0,0,0,1
"22840","thegradation",1,0,0,0,1
"22841","thegradations",1,0,0,0,1
"22842","thegrand",1,0,0,0,1
"22843","thegratitude",1,0,0,0,1
"22844","thegrave",1,0,0,0,1
"22845","thegrossest",1,0,0,0,1
"22846","thegrounds",1,0,0,0,1
"22847","thegulf",1,0,0,0,1
"22848","thehair",1,0,0,0,1
"22849","thehall",1,0,0,0,1
"22850","thehand",1,0,0,0,1
"22851","theharbinger",1,0,0,0,1
"22852","theheading",1,0,0,0,1
"22853","theheartiness",1,0,0,0,1
"22854","theheavy",1,0,0,0,1
"22855","thehell",1,0,0,0,1
"22856","thehelpless",1,0,0,0,1
"22857","thehindermost",1,0,0,0,1
"22858","thehome",1,0,0,0,1
"22859","thehope",1,0,0,0,1
"22860","thehorn",1,0,0,0,1
"22861","thehorrid",1,0,0,0,1
"22862","thehorses",1,0,0,0,1
"22863","thehounds",1,0,0,0,1
"22864","thehuman",1,0,0,0,1
"22865","thehunters",1,0,0,0,1
"22866","thehusband",1,0,0,0,1
"22867","theideal",1,0,0,0,1
"22868","theignorant",1,0,0,0,1
"22869","theimagination",1,0,0,0,1
"22870","theimportant",1,0,0,0,1
"22871","theimpression",1,0,0,0,1
"22872","theinauguration",1,0,0,0,1
"22873","theincreasing",1,0,0,0,1
"22874","theinfamous",1,0,0,0,1
"22875","theinfernal",1,0,0,0,1
"22876","theinfluence",1,0,0,0,1
"22877","theinformation",1,0,0,0,1
"22878","theinhabitants",1,0,0,0,1
"22879","theinquirer",1,0,0,0,1
"22880","theinsolent",1,0,0,0,1
"22881","theinspector",1,0,0,0,1
"22882","theinstitution",1,0,0,0,1
"22883","theintensity",1,0,0,0,1
"22884","theinterests",1,0,0,0,1
"22885","theinvincible",1,0,0,0,1
"22886","theinvitation",1,0,0,0,1
"22887","theirappearance",1,0,0,0,1
"22888","theirapprehensions",1,0,0,0,1
"22889","theirbeds",1,0,0,0,1
"22890","theirbibles",1,0,0,0,1
"22891","theirbondage",1,0,0,0,1
"22892","theircandor",1,0,0,0,1
"22893","theirchildren",1,0,0,0,1
"22894","theirconfidence",1,0,0,0,1
"22895","theircontributions",1,0,0,0,1
"22896","theircourse",1,0,0,0,1
"22897","theirdaily",1,0,0,0,1
"22898","theirdancing",1,0,0,0,1
"22899","theirdesigns",1,0,0,0,1
"22900","theirdifference",1,0,0,0,1
"22901","theirenlistment",1,0,0,0,1
"22902","theirformer",1,0,0,0,1
"22903","theirhate",1,0,0,0,1
"22904","theirhearts",1,0,0,0,1
"22905","theirhigh",1,0,0,0,1
"22906","theirignorance",1,0,0,0,1
"22907","theirincorporation",1,0,0,0,1
"22908","theirkind",1,0,0,0,1
"22909","theirlittle",1,0,0,0,1
"22910","theirlives",1,0,0,0,1
"22911","theirliving",1,0,0,0,1
"22912","theirmeeting",1,0,0,0,1
"22913","theirminds",1,0,0,0,1
"22914","theirmoney",1,0,0,0,1
"22915","theirmoral",1,0,0,0,1
"22916","theirmouths",1,0,0,0,1
"22917","theirnaked",1,0,0,0,1
"22918","theirnotoriously",1,0,0,0,1
"22919","theiroffices.on",1,0,0,0,1
"22920","theirowners",1,0,0,0,1
"22921","theirpersonal",1,0,0,0,1
"22922","theirplaces",1,0,0,0,1
"22923","theirpork",1,0,0,0,1
"22924","theirpoverty",1,0,0,0,1
"22925","theirprivileges",1,0,0,0,1
"22926","theirprojectors",1,0,0,0,1
"22927","theirreasons",1,0,0,0,1
"22928","theirrespect",1,0,0,0,1
"22929","theirrights",1,0,0,0,1
"22930","theirscanty",1,0,0,0,1
"22931","theirskin",1,0,0,0,1
"22932","theirsorrows",1,0,0,0,1
"22933","theirstand",1,0,0,0,1
"22934","theirstory",1,0,0,0,1
"22935","theirstrange",1,0,0,0,1
"22936","theirsystem",1,0,0,0,1
"22937","theirteams",1,0,0,0,1
"22938","theirvictories",1,0,0,0,1
"22939","theirwords",1,0,0,0,1
"22940","thejeers",1,0,0,0,1
"22941","thejob",1,0,0,0,1
"22942","thejoyful",1,0,0,0,1
"22943","thejudgment",1,0,0,0,1
"22944","thelake",1,0,0,0,1
"22945","thelamb",1,0,0,0,1
"22946","thelanded",1,0,0,0,1
"22947","thelargest",1,0,0,0,1
"22948","thelegitimate",1,0,0,0,1
"22949","theless",1,0,0,0,1
"22950","theliberties",1,0,0,0,1
"22951","theliberty",1,0,0,0,1
"22952","thelious",0,0,0,1,1
"22953","thelloyds",1,0,0,0,1
"22954","thelong",1,0,0,0,1
"22955","thelord",1,0,0,0,1
"22956","theloving",1,0,0,0,1
"22957","thelyceum",1,0,0,0,1
"22958","them_",0,1,0,0,1
"22959","them.according",1,0,0,0,1
"22960","them.he",1,0,0,0,1
"22961","them.in",1,0,0,0,1
"22962","them.soon",1,0,0,0,1
"22963","them.we",1,0,0,0,1
"22964","themaiming",1,0,0,0,1
"22965","themajority",1,0,0,0,1
"22966","themand",1,0,0,0,1
"22967","themass",1,0,0,0,1
"22968","themassive",1,0,0,0,1
"22969","themasters",1,0,0,0,1
"22970","thematerial",1,0,0,0,1
"22971","themcould",1,0,0,0,1
"22972","theme",0,1,0,0,1
"22973","themeanest",1,0,0,0,1
"22974","themeeting",1,0,0,0,1
"22975","themelsewhere",1,0,0,0,1
"22976","themembers",1,0,0,0,1
"22977","themen",1,0,0,0,1
"22978","themencouraged",1,0,0,0,1
"22979","themerest",1,0,0,0,1
"22980","themexican",1,0,0,0,1
"22981","themfor",1,0,0,0,1
"22982","themhad",1,0,0,0,1
"22983","themill",1,0,0,0,1
"22984","theminto",1,0,0,0,1
"22985","themississippi",1,0,0,0,1
"22986","themlay",1,0,0,0,1
"22987","themoney",1,0,0,0,1
"22988","themotive",1,0,0,0,1
"22989","themotives",1,0,0,0,1
"22990","themountain",1,0,0,0,1
"22991","themselves.chapter",1,0,0,0,1
"22992","themselves.such",1,0,0,0,1
"22993","themselvesand",1,0,0,0,1
"22994","themselvesgrandly",1,0,0,0,1
"22995","themselveson",1,0,0,0,1
"22996","themselvesto",1,0,0,0,1
"22997","themselvesvery",1,0,0,0,1
"22998","themselveswith",1,0,0,0,1
"22999","themso",1,0,0,0,1
"23000","themsucceeded",1,0,0,0,1
"23001","themsuch",1,0,0,0,1
"23002","themuntil",1,0,0,0,1
"23003","themurderer",1,0,0,0,1
"23004","themush",1,0,0,0,1
"23005","themutterance",1,0,0,0,1
"23006","themwarm",1,0,0,0,1
"23007","themwhere",1,0,0,0,1
"23008","themwherever",1,0,0,0,1
"23009","themwith",1,0,0,0,1
"23010","then_",0,1,0,0,1
"23011","thenail",1,0,0,0,1
"23012","thenat",1,0,0,0,1
"23013","thenation",1,0,0,0,1
"23014","thenatural",1,0,0,0,1
"23015","thenbe",1,0,0,0,1
"23016","thenceforward",1,0,0,0,1
"23017","thenegro.it",1,0,0,0,1
"23018","thenegro’s",1,0,0,0,1
"23019","theneighborhood",1,0,0,0,1
"23020","thenewspapers",1,0,0,0,1
"23021","thenexisted",1,0,0,0,1
"23022","thenext",1,0,0,0,1
"23023","thenhere",1,0,0,0,1
"23024","thenif",1,0,0,0,1
"23025","theniggers",1,0,0,0,1
"23026","thenlay",1,0,0,0,1
"23027","thenoccurring",1,0,0,0,1
"23028","thenorthern",1,0,0,0,1
"23029","thenowned",1,0,0,0,1
"23030","thenpresent",1,0,0,0,1
"23031","thentoo",1,0,0,0,1
"23032","theobject",1,0,0,0,1
"23033","theobjections",1,0,0,0,1
"23034","theoccasion",1,0,0,0,1
"23035","theofficers",1,0,0,0,1
"23036","theological",0,1,0,0,1
"23037","theoperation",1,0,0,0,1
"23038","theopportunity",1,0,0,0,1
"23039","theopposition",1,0,0,0,1
"23040","theoppressed",1,0,0,0,1
"23041","theorder",1,0,0,0,1
"23042","theorthodox",1,0,0,0,1
"23043","theostler",1,0,0,0,1
"23044","theout",1,0,0,0,1
"23045","theoutrage",1,0,0,0,1
"23046","theoutset",1,0,0,0,1
"23047","theover",1,0,0,0,1
"23048","theoverseers",1,0,0,0,1
"23049","theoverthrow",1,0,0,0,1
"23050","thepainful",1,0,0,0,1
"23051","thepark",1,0,0,0,1
"23052","thepast",1,0,0,0,1
"23053","thepath",1,0,0,0,1
"23054","thepatriotic",1,0,0,0,1
"23055","thepenalty",1,0,0,0,1
"23056","thepermanent",1,0,0,0,1
"23057","theplatform",1,0,0,0,1
"23058","thepolicy",1,0,0,0,1
"23059","thepolitical",1,0,0,0,1
"23060","thepolls",1,0,0,0,1
"23061","thepoor",1,0,0,0,1
"23062","thepopular",1,0,0,0,1
"23063","thepopulation",1,0,0,0,1
"23064","theposition",1,0,0,0,1
"23065","thepositiveness",1,0,0,0,1
"23066","thepossession",1,0,0,0,1
"23067","thepossibilities",1,0,0,0,1
"23068","thepostponement",1,0,0,0,1
"23069","thepractice",1,0,0,0,1
"23070","thepreacher’s",1,0,0,0,1
"23071","theprecious",1,0,0,0,1
"23072","theprejudice",1,0,0,0,1
"23073","theprejudices",1,0,0,0,1
"23074","thepresident",1,0,0,0,1
"23075","thepresident’s",1,0,0,0,1
"23076","thepress",1,0,0,0,1
"23077","thepride",1,0,0,0,1
"23078","theprobable",1,0,0,0,1
"23079","theprocession",1,0,0,0,1
"23080","theproffered",1,0,0,0,1
"23081","theprominent",1,0,0,0,1
"23082","thepropagandists",1,0,0,0,1
"23083","theproscribed",1,0,0,0,1
"23084","theproscriptive",1,0,0,0,1
"23085","theprospect",1,0,0,0,1
"23086","theprovocation",1,0,0,0,1
"23087","thepunishment",1,0,0,0,1
"23088","thepuzzling",1,0,0,0,1
"23089","thequondam",1,0,0,0,1
"23090","therace",1,0,0,0,1
"23091","therains",1,0,0,0,1
"23092","therank",1,0,0,0,1
"23093","therapid",1,0,0,0,1
"23094","therby",0,1,0,0,1
"23095","there_",1,0,0,0,1
"23096","there.i",1,0,0,0,1
"23097","there.in",1,0,0,0,1
"23098","there.thus",1,0,0,0,1
"23099","there’s",1,0,0,0,1
"23100","thereach",1,0,0,0,1
"23101","thereafteralmost",1,0,0,0,1
"23102","thereagain",1,0,0,0,1
"23103","thereasoning",1,0,0,0,1
"23104","thereat",0,1,0,0,1
"23105","therecan",1,0,0,0,1
"23106","therecould",1,0,0,0,1
"23107","theredeemed",1,0,0,0,1
"23108","thereflections",1,0,0,0,1
"23109","therefore",0,0,0,1,1
"23110","thereforecompelled",1,0,0,0,1
"23111","thereforehours",1,0,0,0,1
"23112","theregoes",1,0,0,0,1
"23113","therehad",1,0,0,0,1
"23114","therehas",1,0,0,0,1
"23115","thereligious",1,0,0,0,1
"23116","theremoval",1,0,0,0,1
"23117","therenunciation",1,0,0,0,1
"23118","therepeal",1,0,0,0,1
"23119","thereprimand",1,0,0,0,1
"23120","therepublican",1,0,0,0,1
"23121","thereputation",1,0,0,0,1
"23122","therequirement",1,0,0,0,1
"23123","thereshould",1,0,0,0,1
"23124","theresistance",1,0,0,0,1
"23125","therestood",1,0,0,0,1
"23126","therestricted",1,0,0,0,1
"23127","theresult",1,0,0,0,1
"23128","theretention",1,0,0,0,1
"23129","therethat",1,0,0,0,1
"23130","therethey",1,0,0,0,1
"23131","theretofore",1,0,0,0,1
"23132","therev",1,0,0,0,1
"23133","thereverend",1,0,0,0,1
"23134","therewithout",1,0,0,0,1
"23135","therigor",1,0,0,0,1
"23136","therule",1,0,0,0,1
"23137","thesake",1,0,0,0,1
"23138","thesallie",1,0,0,0,1
"23139","thesavage",1,0,0,0,1
"23140","thesawing",1,0,0,0,1
"23141","thesaying",1,0,0,0,1
"23142","thescale",1,0,0,0,1
"23143","thescenes",1,0,0,0,1
"23144","thescholars",1,0,0,0,1
"23145","theschool",1,0,0,0,1
"23146","thescriptures",1,0,0,0,1
"23147","theseall",1,0,0,0,1
"23148","theseare",1,0,0,0,1
"23149","thesecretary",1,0,0,0,1
"23150","theseduties",1,0,0,0,1
"23151","thesefavored",1,0,0,0,1
"23152","thesefriends",1,0,0,0,1
"23153","theseholy",1,0,0,0,1
"23154","theselaborers",1,0,0,0,1
"23155","theselittle",1,0,0,0,1
"23156","theselong",1,0,0,0,1
"23157","thesemen",1,0,0,0,1
"23158","theseno",1,0,0,0,1
"23159","thesenotable",1,0,0,0,1
"23160","thesentiment",1,0,0,0,1
"23161","theseparticulars",1,0,0,0,1
"23162","thesepeople",1,0,0,0,1
"23163","theseplausible",1,0,0,0,1
"23164","thesequalities",1,0,0,0,1
"23165","theserious",1,0,0,0,1
"23166","theservant",1,0,0,0,1
"23167","theservants",1,0,0,0,1
"23168","thesetimes",1,0,0,0,1
"23169","thesewas",1,0,0,0,1
"23170","theshortest",1,0,0,0,1
"23171","theshoulder",1,0,0,0,1
"23172","theshoulders",1,0,0,0,1
"23173","thesight",1,0,0,0,1
"23174","theslave’s",1,0,0,0,1
"23175","theslaves",1,0,0,0,1
"23176","theslaves.to",1,0,0,0,1
"23177","theslender",1,0,0,0,1
"23178","theslightest",1,0,0,0,1
"23179","thesolemnity",1,0,0,0,1
"23180","theson",1,0,0,0,1
"23181","thesophistical",1,0,0,0,1
"23182","thesoul",1,0,0,0,1
"23183","thespacious",1,0,0,0,1
"23184","thespanish",1,0,0,0,1
"23185","thespeaking",1,0,0,0,1
"23186","thespecial",1,0,0,0,1
"23187","thespectacle",1,0,0,0,1
"23188","thesphere",1,0,0,0,1
"23189","thesport",1,0,0,0,1
"23190","thespring",1,0,0,0,1
"23191","thest",1,0,0,0,1
"23192","thestable",1,0,0,0,1
"23193","thestanding",1,0,0,0,1
"23194","thestreet",1,0,0,0,1
"23195","thesubject",1,0,0,0,1
"23196","thesuccess",1,0,0,0,1
"23197","thesugar",1,0,0,0,1
"23198","thesunny",1,0,0,0,1
"23199","thesuperior",1,0,0,0,1
"23200","thesupposed",1,0,0,0,1
"23201","thesurrender",1,0,0,0,1
"23202","theswedish",1,0,0,0,1
"23203","thesweetness",1,0,0,0,1
"23204","thesword",1,0,0,0,1
"23205","thesystem",1,0,0,0,1
"23206","thetaking",1,0,0,0,1
"23207","theteeth",1,0,0,0,1
"23208","thetelegraph",1,0,0,0,1
"23209","thetempest",1,0,0,0,1
"23210","thetender",1,0,0,0,1
"23211","theterritorial",1,0,0,0,1
"23212","thetest",1,0,0,0,1
"23213","thething",1,0,0,0,1
"23214","thethings",1,0,0,0,1
"23215","thethought",1,0,0,0,1
"23216","thethoughtful",1,0,0,0,1
"23217","thethreat",1,0,0,0,1
"23218","thethroat",1,0,0,0,1
"23219","thetops",1,0,0,0,1
"23220","thetorrents",1,0,0,0,1
"23221","thetorture",1,0,0,0,1
"23222","thetrack",1,0,0,0,1
"23223","thetrade",1,0,0,0,1
"23224","thetragic",1,0,0,0,1
"23225","thetrain",1,0,0,0,1
"23226","thetreachery",1,0,0,0,1
"23227","thetrip",1,0,0,0,1
"23228","thetropics",1,0,0,0,1
"23229","thetroubled",1,0,0,0,1
"23230","thetruth",1,0,0,0,1
"23231","thetwo",1,0,0,0,1
"23232","theultimate",1,0,0,0,1
"23233","theunbounded",1,0,0,0,1
"23234","theunconstitutionality",1,0,0,0,1
"23235","theunsuccessful",1,0,0,0,1
"23236","theupper",1,0,0,0,1
"23237","theutmost",1,0,0,0,1
"23238","thevalue",1,0,0,0,1
"23239","thevery",1,0,0,0,1
"23240","thevices",1,0,0,0,1
"23241","thevictim",1,0,0,0,1
"23242","thevirago",1,0,0,0,1
"23243","thevirtues",1,0,0,0,1
"23244","thevision",1,0,0,0,1
"23245","thewaiters",1,0,0,0,1
"23246","thewaves",1,0,0,0,1
"23247","theweaknesses",1,0,0,0,1
"23248","theweek",1,0,0,0,1
"23249","theweekly",1,0,0,0,1
"23250","theweston",1,0,0,0,1
"23251","thewheat",1,0,0,0,1
"23252","thewhites",1,0,0,0,1
"23253","thewilburs",1,0,0,0,1
"23254","thewinds",1,0,0,0,1
"23255","thewish",1,0,0,0,1
"23256","theworld’s",1,0,0,0,1
"23257","theworship",1,0,0,0,1
"23258","thewound",1,0,0,0,1
"23259","thewounds",1,0,0,0,1
"23260","thewrath",1,0,0,0,1
"23261","thewye",1,0,0,0,1
"23262","they_",0,1,0,0,1
"23263","they.i",1,0,0,0,1
"23264","theyall",1,0,0,0,1
"23265","theycalled",1,0,0,0,1
"23266","theydespised",1,0,0,0,1
"23267","theydid",1,0,0,0,1
"23268","theyear",1,0,0,0,1
"23269","theyfelt",1,0,0,0,1
"23270","theyhave",1,0,0,0,1
"23271","theyheld",1,0,0,0,1
"23272","theylend",1,0,0,0,1
"23273","theylist",1,0,0,0,1
"23274","theymade",1,0,0,0,1
"23275","theyneeded",1,0,0,0,1
"23276","theyneither",1,0,0,0,1
"23277","theyoung",1,0,0,0,1
"23278","theypenetrate",1,0,0,0,1
"23279","theypreferred",1,0,0,0,1
"23280","theypulled",1,0,0,0,1
"23281","theypursued",1,0,0,0,1
"23282","theyran",1,0,0,0,1
"23283","theyreceived",1,0,0,0,1
"23284","theyskipped",1,0,0,0,1
"23285","theysubmit",1,0,0,0,1
"23286","thezeal",1,0,0,0,1
"23287","thickwood",1,0,0,0,1
"23288","thieve",0,0,1,0,1
"23289","thingdone",1,0,0,0,1
"23290","thingi",1,0,0,0,1
"23291","thingmore",1,0,0,0,1
"23292","thingof",1,0,0,0,1
"23293","things.whether",1,0,0,0,1
"23294","thingsare",1,0,0,0,1
"23295","thingshas",1,0,0,0,1
"23296","thingssmooth",1,0,0,0,1
"23297","thingsthan",1,0,0,0,1
"23298","thingswas",1,0,0,0,1
"23299","thingswhich",1,0,0,0,1
"23300","thinkit",1,0,0,0,1
"23301","thinknow",1,0,0,0,1
"23302","thinkof",1,0,0,0,1
"23303","thinned",0,1,0,0,1
"23304","thirsted",0,1,0,0,1
"23305","thirstypropagandists",1,0,0,0,1
"23306","this.fellow",1,0,0,0,1
"23307","this.when",1,0,0,0,1
"23308","thisapprehension",1,0,0,0,1
"23309","thisassault",1,0,0,0,1
"23310","thisaudience",1,0,0,0,1
"23311","thisbenevolent",1,0,0,0,1
"23312","thisbuilding",1,0,0,0,1
"23313","thiscase",1,0,0,0,1
"23314","thischange",1,0,0,0,1
"23315","thischapter",1,0,0,0,1
"23316","thiscommunity",1,0,0,0,1
"23317","thiscompliment",1,0,0,0,1
"23318","thisconduct",1,0,0,0,1
"23319","thiscontest",1,0,0,0,1
"23320","thiscontradiction",1,0,0,0,1
"23321","thiscontrolling",1,0,0,0,1
"23322","thiscontroversy",1,0,0,0,1
"23323","thiscouple",1,0,0,0,1
"23324","thiscustom",1,0,0,0,1
"23325","thisdelay",1,0,0,0,1
"23326","thisdiscipline",1,0,0,0,1
"23327","thisdoctrine",1,0,0,0,1
"23328","thisdone",1,0,0,0,1
"23329","thisestablishment",1,0,0,0,1
"23330","thisfall",1,0,0,0,1
"23331","thisfamily",1,0,0,0,1
"23332","thisfatal",1,0,0,0,1
"23333","thisfiendish",1,0,0,0,1
"23334","thisfitting",1,0,0,0,1
"23335","thisflogging",1,0,0,0,1
"23336","thisformula",1,0,0,0,1
"23337","thisgrand",1,0,0,0,1
"23338","thisholy",1,0,0,0,1
"23339","thishotel",1,0,0,0,1
"23340","thishumble",1,0,0,0,1
"23341","thisi",1,0,0,0,1
"23342","thisincident",1,0,0,0,1
"23343","thisinstance",1,0,0,0,1
"23344","thisintelligence",1,0,0,0,1
"23345","thisinvitation",1,0,0,0,1
"23346","thisknowledge",1,0,0,0,1
"23347","thislatter",1,0,0,0,1
"23348","thislaw",1,0,0,0,1
"23349","thislegislative",1,0,0,0,1
"23350","thismemorable",1,0,0,0,1
"23351","thisoccasion",1,0,0,0,1
"23352","thisorder",1,0,0,0,1
"23353","thispart",1,0,0,0,1
"23354","thisposition",1,0,0,0,1
"23355","thisprimary",1,0,0,0,1
"23356","thisproclamation",1,0,0,0,1
"23357","thisprofessedly",1,0,0,0,1
"23358","thisreflection",1,0,0,0,1
"23359","thisreply",1,0,0,0,1
"23360","thisrepublic",1,0,0,0,1
"23361","thisscepticism",1,0,0,0,1
"23362","thissemi",1,0,0,0,1
"23363","thisseparation",1,0,0,0,1
"23364","thissingularly",1,0,0,0,1
"23365","thissouthern",1,0,0,0,1
"23366","thisstate",1,0,0,0,1
"23367","thisstep",1,0,0,0,1
"23368","thisthreat",1,0,0,0,1
"23369","thisto",1,0,0,0,1
"23370","thisvolume",1,0,0,0,1
"23371","thisway",1,0,0,0,1
"23372","thiswe",1,0,0,0,1
"23373","thiswicked",1,0,0,0,1
"23374","thiswill",1,0,0,0,1
"23375","thisworld’s",1,0,0,0,1
"23376","thomasauld",1,0,0,0,1
"23377","thomascame",1,0,0,0,1
"23378","thomasfowell",1,0,0,0,1
"23379","thomasin",1,0,0,0,1
"23380","thomassuspected",1,0,0,0,1
"23381","thong",0,1,0,0,1
"23382","thoroughacquaintance",1,0,0,0,1
"23383","thoroughlyimbued",1,0,0,0,1
"23384","thosechurches",1,0,0,0,1
"23385","thosedays",1,0,0,0,1
"23386","thoseof",1,0,0,0,1
"23387","thoseoverseers",1,0,0,0,1
"23388","thoseprofounder",1,0,0,0,1
"23389","thoserude",1,0,0,0,1
"23390","thosewhich",1,0,0,0,1
"23391","though ",0,0,0,1,1
"23392","thoughall",1,0,0,0,1
"23393","thoughcivilization",1,0,0,0,1
"23394","thoughhe",1,0,0,0,1
"23395","thoughnever",1,0,0,0,1
"23396","thoughnot",1,0,0,0,1
"23397","thoughseparated",1,0,0,0,1
"23398","thoughspecial",1,0,0,0,1
"23399","thoughtand",1,0,0,0,1
"23400","thoughtbefore",1,0,0,0,1
"23401","thoughtfavorably",1,0,0,0,1
"23402","thoughtfully",0,1,0,0,1
"23403","thoughti",1,0,0,0,1
"23404","thoughtlessness",0,0,1,0,1
"23405","thoughtof",1,0,0,0,1
"23406","thoughts.liberty",1,0,0,0,1
"23407","thoughtscould",1,0,0,0,1
"23408","thoughtsin",1,0,0,0,1
"23409","thoughtsof",1,0,0,0,1
"23410","thoughtwas",1,0,0,0,1
"23411","thousand.one",1,0,0,0,1
"23412","thousands.kindred",1,0,0,0,1
"23413","thralled",1,0,0,0,1
"23414","threaded",0,0,0,1,1
"23415","threat.mr",1,0,0,0,1
"23416","threatenedto",1,0,0,0,1
"23417","threateningand",1,0,0,0,1
"23418","threatens",1,0,0,0,1
"23419","threatmight",1,0,0,0,1
"23420","threatre",0,0,0,1,1
"23421","threeand",1,0,0,0,1
"23422","threehundred",1,0,0,0,1
"23423","threemen",1,0,0,0,1
"23424","threequarters",1,0,0,0,1
"23425","threevoices",1,0,0,0,1
"23426","threeweeks",1,0,0,0,1
"23427","threshold",0,1,0,0,1
"23428","thrift",1,0,0,0,1
"23429","thrist",0,1,0,0,1
"23430","thrives",0,1,0,0,1
"23431","thriving",1,0,0,0,1
"23432","throats",0,0,1,0,1
"23433","throats.at",1,0,0,0,1
"23434","throatthat",1,0,0,0,1
"23435","throbbing",0,0,1,0,1
"23436","throne.but",1,0,0,0,1
"23437","througha",1,0,0,0,1
"23438","throughaunt",1,0,0,0,1
"23439","throughchestnut",1,0,0,0,1
"23440","throughdelaware",1,0,0,0,1
"23441","throughhim",1,0,0,0,1
"23442","throughlife",1,0,0,0,1
"23443","throughwhat",1,0,0,0,1
"23444","throughwhich",1,0,0,0,1
"23445","throughwith",1,0,0,0,1
"23446","throve",1,0,0,0,1
"23447","throwit",1,0,0,0,1
"23448","thrownall",1,0,0,0,1
"23449","thrust",1,0,0,0,1
"23450","thugs",1,0,0,0,1
"23451","thump",1,0,0,0,1
"23452","thunderous",1,0,0,0,1
"23453","thunderstruck",1,0,0,0,1
"23454","thurlow",0,1,0,0,1
"23455","thusexercised",1,0,0,0,1
"23456","thusfairly",1,0,0,0,1
"23457","thusleave",1,0,0,0,1
"23458","tick",1,0,0,0,1
"23459","ticket.considering",1,0,0,0,1
"23460","tie.in",1,0,0,0,1
"23461","tied_",0,1,0,0,1
"23462","tiedup",1,0,0,0,1
"23463","tight",0,1,0,0,1
"23464","tightgrasp",1,0,0,0,1
"23465","tilgman",0,1,0,0,1
"23466","tillage",1,0,0,0,1
"23467","tilli",1,0,0,0,1
"23468","tillthe",1,0,0,0,1
"23469","tiltagainst",1,0,0,0,1
"23470","tilton_",1,0,0,0,1
"23471","timbers.my",1,0,0,0,1
"23472","timberto",1,0,0,0,1
"23473","timberyonder",1,0,0,0,1
"23474","timbrel",1,0,0,0,1
"23475","time_",0,1,0,0,1
"23476","time.chapter",1,0,0,0,1
"23477","time.few",1,0,0,0,1
"23478","time.when",1,0,0,0,1
"23479","timeboth",1,0,0,0,1
"23480","timed",1,0,0,0,1
"23481","timefor",1,0,0,0,1
"23482","timehad",1,0,0,0,1
"23483","timehis",1,0,0,0,1
"23484","timein",1,0,0,0,1
"23485","timepublished",1,0,0,0,1
"23486","times:at",1,0,0,0,1
"23487","timesassigned",1,0,0,0,1
"23488","timeshall",1,0,0,0,1
"23489","timeshave",1,0,0,0,1
"23490","timesmore",1,0,0,0,1
"23491","timesslightly",1,0,0,0,1
"23492","timethat",1,0,0,0,1
"23493","timeto",1,0,0,0,1
"23494","timewas",1,0,0,0,1
"23495","timing",1,0,0,0,1
"23496","tinge",0,1,0,0,1
"23497","tirade",1,0,0,0,1
"23498","tire",1,0,0,0,1
"23499","tiredof",1,0,0,0,1
"23500","tithe",0,0,1,0,1
"23501","titles",1,0,0,0,1
"23502","to_anti_",1,0,0,0,1
"23503","toabolitionize",1,0,0,0,1
"23504","toact",1,0,0,0,1
"23505","toadmit",1,0,0,0,1
"23506","toadopt",1,0,0,0,1
"23507","toadvantage",1,0,0,0,1
"23508","toall",1,0,0,0,1
"23509","toallow",1,0,0,0,1
"23510","toameliorate",1,0,0,0,1
"23511","toan",1,0,0,0,1
"23512","toanti",1,0,0,0,1
"23513","toappeal",1,0,0,0,1
"23514","tobark",1,0,0,0,1
"23515","tobehave",1,0,0,0,1
"23516","tobondage",1,0,0,0,1
"23517","toboston",1,0,0,0,1
"23518","tobrood",1,0,0,0,1
"23519","tocamp",1,0,0,0,1
"23520","tocapt",1,0,0,0,1
"23521","toclose",1,0,0,0,1
"23522","tocol",1,0,0,0,1
"23523","tocompel",1,0,0,0,1
"23524","tocomplain",1,0,0,0,1
"23525","toconcealment",1,0,0,0,1
"23526","toconfine",1,0,0,0,1
"23527","toconscience",1,0,0,0,1
"23528","tocovey’s",1,0,0,0,1
"23529","tocriticise",1,0,0,0,1
"23530","tocumber",1,0,0,0,1
"23531","todangerous",1,0,0,0,1
"23532","today",0,0,0,1,1
"23533","todefend",1,0,0,0,1
"23534","todeliver",1,0,0,0,1
"23535","todescribe",1,0,0,0,1
"23536","todiscontinue",1,0,0,0,1
"23537","todiscover",1,0,0,0,1
"23538","toeach",1,0,0,0,1
"23539","toeither",1,0,0,0,1
"23540","toemancipate",1,0,0,0,1
"23541","toemploy",1,0,0,0,1
"23542","toencourage",1,0,0,0,1
"23543","toenforce",1,0,0,0,1
"23544","toengland",1,0,0,0,1
"23545","toenlist",1,0,0,0,1
"23546","toes",0,0,1,0,1
"23547","toescape",1,0,0,0,1
"23548","toestablish",1,0,0,0,1
"23549","toexaggeration",1,0,0,0,1
"23550","toexalt",1,0,0,0,1
"23551","toexercise",1,0,0,0,1
"23552","toexhibit",1,0,0,0,1
"23553","toexpect",1,0,0,0,1
"23554","toexpress",1,0,0,0,1
"23555","tofaith",1,0,0,0,1
"23556","tofall",1,0,0,0,1
"23557","tofan",1,0,0,0,1
"23558","toforce",1,0,0,0,1
"23559","tofriends",1,0,0,0,1
"23560","tofrighten",1,0,0,0,1
"23561","togeorge",1,0,0,0,1
"23562","together.these",1,0,0,0,1
"23563","together.variance",1,0,0,0,1
"23564","toglean",1,0,0,0,1
"23565","togovernor",1,0,0,0,1
"23566","toguard",1,0,0,0,1
"23567","tohave",1,0,0,0,1
"23568","tohear",1,0,0,0,1
"23569","toheighten",1,0,0,0,1
"23570","tohim.very",1,0,0,0,1
"23571","tohimself",1,0,0,0,1
"23572","tohold",1,0,0,0,1
"23573","tohow",1,0,0,0,1
"23574","toiling",1,0,0,0,1
"23575","toinaugurate",1,0,0,0,1
"23576","toincrease",1,0,0,0,1
"23577","toinduce",1,0,0,0,1
"23578","toinjudicious",1,0,0,0,1
"23579","toinquire",1,0,0,0,1
"23580","toinspire",1,0,0,0,1
"23581","toinsult",1,0,0,0,1
"23582","tointroduce",1,0,0,0,1
"23583","toissue",1,0,0,0,1
"23584","toit",1,0,0,0,1
"23585","toits",1,0,0,0,1
"23586","toitself",1,0,0,0,1
"23587","tojohn",1,0,0,0,1
"23588","tokens",0,1,0,0,1
"23589","toknow",1,0,0,0,1
"23590","tolaunch",1,0,0,0,1
"23591","toldby",1,0,0,0,1
"23592","toldher",1,0,0,0,1
"23593","toldthat",1,0,0,0,1
"23594","toldthe",1,0,0,0,1
"23595","toldtoo",1,0,0,0,1
"23596","tolean",1,0,0,0,1
"23597","tolearn",1,0,0,0,1
"23598","tolecture",1,0,0,0,1
"23599","tolerant",1,0,0,0,1
"23600","toleranttowards",1,0,0,0,1
"23601","tolook",1,0,0,0,1
"23602","tomaintain",1,0,0,0,1
"23603","tomine",1,0,0,0,1
"23604","tomove",1,0,0,0,1
"23605","tonesand",1,0,0,0,1
"23606","tonew",1,0,0,0,1
"23607","toney",1,0,0,0,1
"23608","tongued",0,1,0,0,1
"23609","tonne",0,0,0,1,1
"23610","tonote",1,0,0,0,1
"23611","tookadvantage",1,0,0,0,1
"23612","tookme",1,0,0,0,1
"23613","tookmy",1,0,0,0,1
"23614","tookno",1,0,0,0,1
"23615","tookoccasion",1,0,0,0,1
"23616","tookone",1,0,0,0,1
"23617","tookpossession",1,0,0,0,1
"23618","toooften",1,0,0,0,1
"23619","toopen",1,0,0,0,1
"23620","toosolicitous",1,0,0,0,1
"23621","tootransparent",1,0,0,0,1
"23622","toparley",1,0,0,0,1
"23623","topart",1,0,0,0,1
"23624","toparticipate",1,0,0,0,1
"23625","topeople",1,0,0,0,1
"23626","tophiladelphia",1,0,0,0,1
"23627","topic",0,1,0,0,1
"23628","toplease",1,0,0,0,1
"23629","topmostheight",1,0,0,0,1
"23630","toportland",1,0,0,0,1
"23631","topp",0,1,0,0,1
"23632","toprocure",1,0,0,0,1
"23633","toproduce",1,0,0,0,1
"23634","toquestion",1,0,0,0,1
"23635","toreach",1,0,0,0,1
"23636","torebellion",1,0,0,0,1
"23637","torecapture",1,0,0,0,1
"23638","torecruit",1,0,0,0,1
"23639","torenew",1,0,0,0,1
"23640","torespect",1,0,0,0,1
"23641","toreturn",1,0,0,0,1
"23642","toreturning",1,0,0,0,1
"23643","torise",1,0,0,0,1
"23644","torivet",1,0,0,0,1
"23645","tormentedme",1,0,0,0,1
"23646","tormentof",1,0,0,0,1
"23647","tormentors.mr",1,0,0,0,1
"23648","tornado",0,1,0,0,1
"23649","tornmy",1,0,0,0,1
"23650","torrey",1,0,0,0,1
"23651","tortureand",1,0,0,0,1
"23652","tortures",0,0,1,0,1
"23653","torun",1,0,0,0,1
"23654","tory",1,0,0,0,1
"23655","tosatisfy",1,0,0,0,1
"23656","toseek",1,0,0,0,1
"23657","tosell",1,0,0,0,1
"23658","toshields",1,0,0,0,1
"23659","toshrink",1,0,0,0,1
"23660","tosleep",1,0,0,0,1
"23661","tospeak",1,0,0,0,1
"23662","tospend",1,0,0,0,1
"23663","tost",1,0,0,0,1
"23664","tostart",1,0,0,0,1
"23665","tostep",1,0,0,0,1
"23666","tosubscribe",1,0,0,0,1
"23667","tosucceed",1,0,0,0,1
"23668","tosuccor",1,0,0,0,1
"23669","tosuch",1,0,0,0,1
"23670","toswarm",1,0,0,0,1
"23671","totaldestruction",1,0,0,0,1
"23672","totalk",1,0,0,0,1
"23673","totax",1,0,0,0,1
"23674","totech",1,0,0,0,1
"23675","toteing",1,0,0,0,1
"23676","toten",1,0,0,0,1
"23677","tothat",1,0,0,0,1
"23678","tothem",1,0,0,0,1
"23679","tothere",1,0,0,0,1
"23680","tothese",1,0,0,0,1
"23681","totime",1,0,0,0,1
"23682","toting",0,1,0,0,1
"23683","totranscend",1,0,0,0,1
"23684","totravel",1,0,0,0,1
"23685","totrifle",1,0,0,0,1
"23686","touchedall",1,0,0,0,1
"23687","touchingand",1,0,0,0,1
"23688","toughness",1,0,0,0,1
"23689","tought",0,0,0,1,1
"23690","tounderstand",1,0,0,0,1
"23691","towarda",1,0,0,0,1
"23692","towardhenry",1,0,0,0,1
"23693","towardhim",1,0,0,0,1
"23694","towards",0,0,0,1,1
"23695","towardst",1,0,0,0,1
"23696","toweaken",1,0,0,0,1
"23697","towelfare",1,0,0,0,1
"23698","towels",0,1,0,0,1
"23699","towered",0,1,0,0,1
"23700","towers",0,0,0,1,1
"23701","towhip",1,0,0,0,1
"23702","towilliam",1,0,0,0,1
"23703","towitness",1,0,0,0,1
"23704","town.cut",1,0,0,0,1
"23705","townsend",0,0,1,0,1
"23706","townsin",1,0,0,0,1
"23707","townsvisited",1,0,0,0,1
"23708","towrite",1,0,0,0,1
"23709","tracks.so",1,0,0,0,1
"23710","trade_",0,1,0,0,1
"23711","traderat",1,0,0,0,1
"23712","traderhanged",1,0,0,0,1
"23713","traditional",1,0,0,0,1
"23714","traditions",1,0,0,0,1
"23715","trafficers",1,0,0,0,1
"23716","trafficker",0,0,1,0,1
"23717","trafficking",0,1,0,0,1
"23718","trail",0,1,0,0,1
"23719","trainers",0,1,0,0,1
"23720","trajen",0,0,0,1,1
"23721","trammel",0,1,0,0,1
"23722","tramp",1,0,0,0,1
"23723","tramples",0,1,0,0,1
"23724","tranquility",1,0,0,0,1
"23725","tranquillity",0,1,0,0,1
"23726","transact",0,1,0,0,1
"23727","transactionas",1,0,0,0,1
"23728","transatlantic",1,0,0,0,1
"23729","transcended",0,0,0,1,1
"23730","transgression",1,0,0,0,1
"23731","transientcharacter",1,0,0,0,1
"23732","transientinfluence",1,0,0,0,1
"23733","translated",1,0,0,0,1
"23734","transpiring",1,0,0,0,1
"23735","transport",1,0,0,0,1
"23736","transported",0,1,0,0,1
"23737","trap",1,0,0,0,1
"23738","trash",1,0,0,0,1
"23739","trash_",0,1,0,0,1
"23740","traveland",1,0,0,0,1
"23741","travelled",0,0,1,0,1
"23742","traveller",0,0,0,1,1
"23743","treatedas",1,0,0,0,1
"23744","treatedit",1,0,0,0,1
"23745","treatedlike",1,0,0,0,1
"23746","treatmentof",1,0,0,0,1
"23747","treatmenton",1,0,0,0,1
"23748","treatmentwhich",1,0,0,0,1
"23749","treats",1,0,0,0,1
"23750","treatto",1,0,0,0,1
"23751","treeand",1,0,0,0,1
"23752","trembledin",1,0,0,0,1
"23753","tremblingly",1,0,0,0,1
"23754","tremendous.i",1,0,0,0,1
"23755","tremendoussensation",1,0,0,0,1
"23756","trenched",0,1,0,0,1
"23757","trenches",1,0,0,0,1
"23758","tres",0,0,0,1,1
"23759","trespassed",1,0,0,0,1
"23760","trespassers",1,0,0,0,1
"23761","trialhour",1,0,0,0,1
"23762","tribes",0,1,0,0,1
"23763","tribunals",0,1,0,0,1
"23764","tribune",0,1,0,0,1
"23765","tried",0,0,0,1,1
"23766","trifler",1,0,0,0,1
"23767","trifling_",0,1,0,0,1
"23768","trigger",0,0,1,0,1
"23769","trimmers",1,0,0,0,1
"23770","trimming",0,0,1,0,1
"23771","trips",1,0,0,0,1
"23772","trite",1,0,0,0,1
"23773","troddenof",1,0,0,0,1
"23774","troop",0,1,0,0,1
"23775","troopsunder",1,0,0,0,1
"23776","tropics",0,1,0,0,1
"23777","trot",0,1,0,0,1
"23778","trouble ",0,0,0,1,1
"23779","troublesome",1,0,0,0,1
"23780","truant",0,1,0,0,1
"23781","true.had",1,0,0,0,1
"23782","true.there",1,0,0,0,1
"23783","truecharacters",1,0,0,0,1
"23784","trueview",1,0,0,0,1
"23785","trustcompany",1,0,0,0,1
"23786","trusting",1,0,0,0,1
"23787","trusty",0,0,1,0,1
"23788","truth.the",1,0,0,0,1
"23789","truth.while",1,0,0,0,1
"23790","truthand",1,0,0,0,1
"23791","truthcompels",1,0,0,0,1
"23792","truthfulimpression",1,0,0,0,1
"23793","truthis",1,0,0,0,1
"23794","truthof",1,0,0,0,1
"23795","truthpenetrating",1,0,0,0,1
"23796","try",0,0,0,1,1
"23797","trying",0,0,0,1,1
"23798","tucel",0,0,0,1,1
"23799","tuckahoedistrict",1,0,0,0,1
"23800","tuckahoeto",1,0,0,0,1
"23801","tucked",0,0,0,1,1
"23802","tuesd",0,0,0,1,1
"23803","tumblers",1,0,0,0,1
"23804","tumultand",1,0,0,0,1
"23805","tune",0,0,1,0,1
"23806","turbined",0,0,0,1,1
"23807","turmoil",1,0,0,0,1
"23808","turn",0,0,0,1,1
"23809","turn.every",1,0,0,0,1
"23810","turner’s",0,1,0,0,1
"23811","twilight",0,0,1,0,1
"23812","twin",1,0,0,0,1
"23813","twinethemselves",1,0,0,0,1
"23814","twinkle",1,0,0,0,1
"23815","twisting",1,0,0,0,1
"23816","twoamericas",1,0,0,0,1
"23817","twofold",0,0,1,0,1
"23818","twoof",1,0,0,0,1
"23819","tworegiments",1,0,0,0,1
"23820","tyler",1,0,0,0,1
"23821","tyler’s",1,0,0,0,1
"23822","typical",0,0,0,1,1
"23823","ufizzi",0,0,0,1,1
"23824","ultra_",1,0,0,0,1
"23825","ultraist",1,0,0,0,1
"23826","ulysses",1,0,0,0,1
"23827","umberella",0,0,0,1,1
"23828","umbrl",0,0,0,1,1
"23829","unabated",0,0,1,0,1
"23830","unaccountable",0,0,1,0,1
"23831","unannounced",1,0,0,0,1
"23832","unanswered",1,0,0,0,1
"23833","unascertained",1,0,0,0,1
"23834","unassailable",1,0,0,0,1
"23835","unassailed",1,0,0,0,1
"23836","unbending",0,0,1,0,1
"23837","unborn",1,0,0,0,1
"23838","uncared",0,1,0,0,1
"23839","unceasingprogress",1,0,0,0,1
"23840","uncertainties",0,1,0,0,1
"23841","unchanging",1,0,0,0,1
"23842","unchecked",0,1,0,0,1
"23843","unchristian.at",1,0,0,0,1
"23844","uncivil",1,0,0,0,1
"23845","uncivilized",1,0,0,0,1
"23846","uncleanness",0,0,1,0,1
"23847","unclenoah",1,0,0,0,1
"23848","uncletom’s",1,0,0,0,1
"23849","unconditional",0,1,0,0,1
"23850","uncongenial",1,0,0,0,1
"23851","unconquerable",0,1,0,0,1
"23852","unconsciously",1,0,0,0,1
"23853","unconsidered",1,0,0,0,1
"23854","unconstitutionality",0,1,0,0,1
"23855","uncontrolled",0,1,0,0,1
"23856","uncorrupted",1,0,0,0,1
"23857","uncoverted",0,1,0,0,1
"23858","uncultivatedand",1,0,0,0,1
"23859","uncursedby",1,0,0,0,1
"23860","undaunted",0,1,0,0,1
"23861","undecipherable.everything",1,0,0,0,1
"23862","undefinable",1,0,0,0,1
"23863","underdifficulties",1,0,0,0,1
"23864","underdiscouragements",1,0,0,0,1
"23865","undergoing",0,1,0,0,1
"23866","undergoingthe",1,0,0,0,1
"23867","underhim",1,0,0,0,1
"23868","underling",0,1,0,0,1
"23869","underlings",1,0,0,0,1
"23870","undermining",0,1,0,0,1
"23871","undersix",1,0,0,0,1
"23872","understandfrederick",1,0,0,0,1
"23873","understandings",0,1,0,0,1
"23874","understands",0,1,0,0,1
"23875","undersuch",1,0,0,0,1
"23876","undertake.after",1,0,0,0,1
"23877","undertakes",0,1,0,0,1
"23878","undertaking.our",1,0,0,0,1
"23879","undertakings",1,0,0,0,1
"23880","undeserved",0,1,0,0,1
"23881","undeservedly",1,0,0,0,1
"23882","undesirableness",1,0,0,0,1
"23883","undevotional",0,1,0,0,1
"23884","undistinguishable",0,1,0,0,1
"23885","undreamed",1,0,0,0,1
"23886","undressing",0,1,0,0,1
"23887","undying",0,1,0,0,1
"23888","unearthed",0,0,0,1,1
"23889","uneasinessabout",1,0,0,0,1
"23890","unenlightened",0,1,0,0,1
"23891","unequalled",0,0,0,1,1
"23892","unextinguished",1,0,0,0,1
"23893","unfair",1,0,0,0,1
"23894","unfairness",1,0,0,0,1
"23895","unfaithful",1,0,0,0,1
"23896","unfaithfulness",1,0,0,0,1
"23897","unfaltering",0,1,0,0,1
"23898","unfeigned",0,0,1,0,1
"23899","unfinished",1,0,0,0,1
"23900","unfitness",1,0,0,0,1
"23901","unfits",0,1,0,0,1
"23902","unfitsa",1,0,0,0,1
"23903","unfolded",0,1,0,0,1
"23904","unfortunately",0,0,0,1,1
"23905","unfortunatelythe",1,0,0,0,1
"23906","unfurl",0,0,1,0,1
"23907","unfurled",1,0,0,0,1
"23908","ungentlemanly",0,1,0,0,1
"23909","unhealed",0,1,0,0,1
"23910","unhealthy",1,0,0,0,1
"23911","unhealthylocalities",1,0,0,0,1
"23912","unheard.it",1,0,0,0,1
"23913","unhesitatingly_",0,1,0,0,1
"23914","unhesitatinglyrefused",1,0,0,0,1
"23915","uniforms",1,0,0,0,1
"23916","unimpeachable",0,0,1,0,1
"23917","unimportant",0,1,0,0,1
"23918","unimproved",1,0,0,0,1
"23919","unintentionally",0,0,1,0,1
"23920","uninviting",1,0,0,0,1
"23921","union.no",1,0,0,0,1
"23922","unionand",1,0,0,0,1
"23923","unioncause",1,0,0,0,1
"23924","unioncould",1,0,0,0,1
"23925","unionmight",1,0,0,0,1
"23926","unitarian",1,0,0,0,1
"23927","unitedkingdom",1,0,0,0,1
"23928","unitedrepublican",1,0,0,0,1
"23929","unites",0,1,0,0,1
"23930","univers",0,0,0,1,1
"23931","universally",0,0,1,0,1
"23932","universe_",0,1,0,0,1
"23933","unjustand",1,0,0,0,1
"23934","unkindness",1,0,0,0,1
"23935","unknownto",1,0,0,0,1
"23936","unlessit",1,0,0,0,1
"23937","unload",0,1,0,0,1
"23938","unloaded",1,0,0,0,1
"23939","unloadvessels",1,0,0,0,1
"23940","unlock",1,0,0,0,1
"23941","unlocked",1,0,0,0,1
"23942","unmade",1,0,0,0,1
"23943","unmake",0,1,0,0,1
"23944","unmannerly",0,0,1,0,1
"23945","unmarked",0,1,0,0,1
"23946","unmeaning",0,0,1,0,1
"23947","unmeasuredapplause",1,0,0,0,1
"23948","unmistakably",1,0,0,0,1
"23949","unmotherly",0,1,0,0,1
"23950","unmoved",0,0,1,0,1
"23951","unobservedeven",1,0,0,0,1
"23952","unobserving",1,0,0,0,1
"23953","unobtrusive",1,0,0,0,1
"23954","unparalleled",0,1,0,0,1
"23955","unpopularity",1,0,0,0,1
"23956","unpracticalif",1,0,0,0,1
"23957","unprecedented",1,0,0,0,1
"23958","unprejudiced",1,0,0,0,1
"23959","unpropitious",0,1,0,0,1
"23960","unquestioned",1,0,0,0,1
"23961","unraveled",0,1,0,0,1
"23962","unreasonably",0,1,0,0,1
"23963","unrecognized",1,0,0,0,1
"23964","unrepentant",0,1,0,0,1
"23965","unrequited",0,1,0,0,1
"23966","unresisted",1,0,0,0,1
"23967","unrestrained",0,1,0,0,1
"23968","unrestricted",0,1,0,0,1
"23969","unrighteous",0,1,0,0,1
"23970","unruly",1,0,0,0,1
"23971","unsaintly",1,0,0,0,1
"23972","unselfish",1,0,0,0,1
"23973","unsettle",1,0,0,0,1
"23974","unskilled",0,1,0,0,1
"23975","unsophisticated",0,1,0,0,1
"23976","unsound",1,0,0,0,1
"23977","unsparing",0,1,0,0,1
"23978","unsparingly",1,0,0,0,1
"23979","unsteady",0,1,0,0,1
"23980","unstinted",1,0,0,0,1
"23981","unsubjected",1,0,0,0,1
"23982","unsuccessfully",0,1,0,0,1
"23983","unsuccessfulrunaway",1,0,0,0,1
"23984","unsuitable",0,0,1,0,1
"23985","unsupplied",1,0,0,0,1
"23986","unsupported",1,0,0,0,1
"23987","unsurpassed",1,0,0,0,1
"23988","unswerving",1,0,0,0,1
"23989","unsystematized",1,0,0,0,1
"23990","untanned",0,1,0,0,1
"23991","untilall",1,0,0,0,1
"23992","untimely",0,0,1,0,1
"23993","untoward",0,1,0,0,1
"23994","untowardinfluence",1,0,0,0,1
"23995","untroddenroad",1,0,0,0,1
"23996","untutored",1,0,0,0,1
"23997","unusualcircumstances",1,0,0,0,1
"23998","unvarnished",1,0,0,0,1
"23999","unvarying",0,1,0,0,1
"24000","unveiled",1,0,0,0,1
"24001","unwarrantable",0,1,0,0,1
"24002","unwarrantableambition",1,0,0,0,1
"24003","unwavering",1,0,0,0,1
"24004","unwearied",1,0,0,0,1
"24005","unwise",1,0,0,0,1
"24006","upall",1,0,0,0,1
"24007","upappearances",1,0,0,0,1
"24008","upelectoral",1,0,0,0,1
"24009","upheavalwhich",1,0,0,0,1
"24010","uphis",1,0,0,0,1
"24011","upholds",0,1,0,0,1
"24012","upmy",1,0,0,0,1
"24013","uponas",1,0,0,0,1
"24014","uponharper’s",1,0,0,0,1
"24015","uponhearing",1,0,0,0,1
"24016","uponher",1,0,0,0,1
"24017","uponhis",1,0,0,0,1
"24018","uponin",1,0,0,0,1
"24019","uponits",1,0,0,0,1
"24020","uponmany",1,0,0,0,1
"24021","uponone",1,0,0,0,1
"24022","uponreaching",1,0,0,0,1
"24023","uponsea",1,0,0,0,1
"24024","uponthem",1,0,0,0,1
"24025","uponwhich",1,0,0,0,1
"24026","upper_",0,1,0,0,1
"24027","uprightly",0,1,0,0,1
"24028","uprising",1,0,0,0,1
"24029","uprisingof",1,0,0,0,1
"24030","uproarious",0,1,0,0,1
"24031","upstairs",0,1,0,0,1
"24032","upthe",1,0,0,0,1
"24033","upthose",1,0,0,0,1
"24034","urch",0,0,0,1,1
"24035","urgent",0,1,0,0,1
"24036","urges",0,0,0,1,1
"24037","urging",1,0,0,0,1
"24038","us_",0,1,0,0,1
"24039","us.as",1,0,0,0,1
"24040","us.leaving",1,0,0,0,1
"24041","us.men",1,0,0,0,1
"24042","us.monroe",1,0,0,0,1
"24043","us.sleeping",1,0,0,0,1
"24044","us.these",1,0,0,0,1
"24045","us.to",1,0,0,0,1
"24046","usand",1,0,0,0,1
"24047","usby",1,0,0,0,1
"24048","useduring",1,0,0,0,1
"24049","usefulto",1,0,0,0,1
"24050","useto",1,0,0,0,1
"24051","usthat",1,0,0,0,1
"24052","usthrough",1,0,0,0,1
"24053","usto",1,0,0,0,1
"24054","usual.i",1,0,0,0,1
"24055","usualcustom",1,0,0,0,1
"24056","usuallyis",1,0,0,0,1
"24057","usuallyled",1,0,0,0,1
"24058","usualpretext",1,0,0,0,1
"24059","usualstrength",1,0,0,0,1
"24060","usualwhen",1,0,0,0,1
"24061","uswith",1,0,0,0,1
"24062","uswould",1,0,0,0,1
"24063","utensils",0,1,0,0,1
"24064","utility",0,0,0,1,1
"24065","utilizing",1,0,0,0,1
"24066","utmostfury",1,0,0,0,1
"24067","utteringthat",1,0,0,0,1
"24068","utterlyimpracticable",1,0,0,0,1
"24069","v.a",1,0,0,0,1
"24070","v.one",1,0,0,0,1
"24071","va",1,0,0,0,1
"24072","vacated",1,0,0,0,1
"24073","valentine",1,0,0,0,1
"24074","valid",0,1,0,0,1
"24075","valuableof",1,0,0,0,1
"24076","valueof",1,0,0,0,1
"24077","vanishbefore",1,0,0,0,1
"24078","vanishes",0,1,0,0,1
"24079","vanities",1,0,0,0,1
"24080","vanquished400",1,0,0,0,1
"24081","vapear",0,0,0,1,1
"24082","variegated",1,0,0,0,1
"24083","varietyof",1,0,0,0,1
"24084","various",0,0,0,1,1
"24085","variousdevices",1,0,0,0,1
"24086","variouslyshaped",1,0,0,0,1
"24087","variousnames",1,0,0,0,1
"24088","varnish",1,0,0,0,1
"24089","vary",0,1,0,0,1
"24090","vastlysuperior",1,0,0,0,1
"24091","vastness",0,0,0,1,1
"24092","vaucluse",0,0,0,1,1
"24093","vault",0,1,0,0,1
"24094","vaults",1,0,0,0,1
"24095","vaultsabout",1,0,0,0,1
"24096","vaultsto",1,0,0,0,1
"24097","vechies",0,0,0,1,1
"24098","vegetable",0,1,0,0,1
"24099","vegetables",0,0,1,0,1
"24100","vegetation",0,0,0,1,1
"24101","veneering",1,0,0,0,1
"24102","vengeance.my",1,0,0,0,1
"24103","vengeful",1,0,0,0,1
"24104","venomous",0,1,0,0,1
"24105","venti sep",0,0,0,1,1
"24106","venturedat",1,0,0,0,1
"24107","venturedout",1,0,0,0,1
"24108","veracity",0,0,1,0,1
"24109","verandas",1,0,0,0,1
"24110","verbal",0,1,0,0,1
"24111","veretable",0,0,0,1,1
"24112","vergingtowards",1,0,0,0,1
"24113","veriest",0,1,0,0,1
"24114","versatility",0,1,0,0,1
"24115","verses",0,1,0,0,1
"24116","versionof",1,0,0,0,1
"24117","verybadly",1,0,0,0,1
"24118","veryclass",1,0,0,0,1
"24119","verydifficult",1,0,0,0,1
"24120","verydistinct",1,0,0,0,1
"24121","verydistinctly",1,0,0,0,1
"24122","veryevidently",1,0,0,0,1
"24123","veryfine",1,0,0,0,1
"24124","veryhard",1,0,0,0,1
"24125","veryimposing",1,0,0,0,1
"24126","veryindefinite",1,0,0,0,1
"24127","verykindly",1,0,0,0,1
"24128","verylow",1,0,0,0,1
"24129","verymuch",1,0,0,0,1
"24130","veryplain",1,0,0,0,1
"24131","veryplainly",1,0,0,0,1
"24132","veryquestion",1,0,0,0,1
"24133","veryseverely",1,0,0,0,1
"24134","verytempting",1,0,0,0,1
"24135","verytop",1,0,0,0,1
"24136","verytranquilizing",1,0,0,0,1
"24137","verywell",1,0,0,0,1
"24138","vesey",1,0,0,0,1
"24139","vessel.the",1,0,0,0,1
"24140","vessuvious",0,0,0,1,1
"24141","vesuvious",0,0,0,1,1
"24142","veteran",1,0,0,0,1
"24143","vex",0,1,0,0,1
"24144","vexing",0,1,0,0,1
"24145","vi.a",1,0,0,0,1
"24146","vi.impressions",1,0,0,0,1
"24147","via",0,0,0,1,1
"24148","viands",1,0,0,0,1
"24149","vibrations",0,1,0,0,1
"24150","vicchio",0,0,0,1,1
"24151","vicclieo",0,0,0,1,1
"24152","victim.when",1,0,0,0,1
"24153","victimand",1,0,0,0,1
"24154","victimsthemselves.the",1,0,0,0,1
"24155","victimwas",1,0,0,0,1
"24156","victorea",0,0,0,1,1
"24157","victoria",0,0,0,1,1
"24158","victoria’s",0,1,0,0,1
"24159","victoriouscrime",1,0,0,0,1
"24160","viewcemetery",1,0,0,0,1
"24161","viewingit",1,0,0,0,1
"24162","viewson",1,0,0,0,1
"24163","viewsrespectfully",1,0,0,0,1
"24164","vigorousconstitution",1,0,0,0,1
"24165","vigorouslypressed",1,0,0,0,1
"24166","vii.luxuries",1,0,0,0,1
"24167","vii.triumphs",1,0,0,0,1
"24168","viii.john",1,0,0,0,1
"24169","viiicharacteristics",1,0,0,0,1
"24170","vilepersons",1,0,0,0,1
"24171","vilest",0,1,0,0,1
"24172","villainmight",1,0,0,0,1
"24173","ville",0,0,0,1,1
"24174","vincibility",1,0,0,0,1
"24175","vindication.the",1,0,0,0,1
"24176","vindictiveeyes",1,0,0,0,1
"24177","vinegar",0,1,0,0,1
"24178","vines",0,0,0,1,1
"24179","violate",0,1,0,0,1
"24180","violated.william",1,0,0,0,1
"24181","violatethat",1,0,0,0,1
"24182","violatethem",1,0,0,0,1
"24183","violating",0,1,0,0,1
"24184","violationof",1,0,0,0,1
"24185","violenceand",1,0,0,0,1
"24186","violets",0,0,0,1,1
"24187","viper",0,1,0,0,1
"24188","virago",0,1,0,0,1
"24189","virgil",0,0,0,1,1
"24190","virginia.the",1,0,0,0,1
"24191","virginian",0,1,0,0,1
"24192","virtues.he",1,0,0,0,1
"24193","visaged",0,0,1,0,1
"24194","visible.the",1,0,0,0,1
"24195","visibleshadow",1,0,0,0,1
"24196","visibly",1,0,0,0,1
"24197","visiblyaffected",1,0,0,0,1
"24198","visionsof",1,0,0,0,1
"24199","visitedby",1,0,0,0,1
"24200","visitedthe",1,0,0,0,1
"24201","visitthat",1,0,0,0,1
"24202","vitoriea",0,0,0,1,1
"24203","vitriori",0,0,0,1,1
"24204","vivacious",0,1,0,0,1
"24205","vividly.besides",1,0,0,0,1
"24206","vividness",0,0,0,1,1
"24207","vocalists",0,1,0,0,1
"24208","vocalpower",1,0,0,0,1
"24209","vociferated",0,1,0,0,1
"24210","vol",1,0,0,0,1
"24211","volcanic",0,0,0,1,1
"24212","volume.after",1,0,0,0,1
"24213","volume.amongst",1,0,0,0,1
"24214","volumefar",1,0,0,0,1
"24215","volumesexposing",1,0,0,0,1
"24216","voluntarily",1,0,0,0,1
"24217","voluntary",0,0,1,0,1
"24218","voter",1,0,0,0,1
"24219","votesfor",1,0,0,0,1
"24220","votingabolitionist",1,0,0,0,1
"24221","vulgarcoarseness",1,0,0,0,1
"24222","w.h",0,1,0,0,1
"24223","w.julian",1,0,0,0,1
"24224","wading",0,1,0,0,1
"24225","waft",0,1,0,0,1
"24226","waging",1,0,0,0,1
"24227","wagon",1,0,0,0,1
"24228","wagoners",0,0,0,1,1
"24229","wagons",0,1,0,0,1
"24230","waif",0,1,0,0,1
"24231","wails",0,1,0,0,1
"24232","waitingonly",1,0,0,0,1
"24233","waitlong",1,0,0,0,1
"24234","waittill",1,0,0,0,1
"24235","waken",0,0,1,0,1
"24236","waleswere",1,0,0,0,1
"24237","walkat",1,0,0,0,1
"24238","walkby",1,0,0,0,1
"24239","walkedi",1,0,0,0,1
"24240","walkednearly",1,0,0,0,1
"24241","walketh",0,1,0,0,1
"24242","wallwitnessing",1,0,0,0,1
"24243","walnutfinishings",1,0,0,0,1
"24244","wanderer",0,1,0,0,1
"24245","wanderings",0,1,0,0,1
"24246","wanders",0,0,1,0,1
"24247","wane",0,0,0,1,1
"24248","wanfism",0,0,0,1,1
"24249","want",0,0,0,1,1
"24250","wanted",0,0,0,1,1
"24251","wanteda",1,0,0,0,1
"24252","wanting.there",1,0,0,0,1
"24253","wantto",1,0,0,0,1
"24254","war.but",1,0,0,0,1
"24255","war.chapter",1,0,0,0,1
"24256","war.i",1,0,0,0,1
"24257","war.the",1,0,0,0,1
"24258","waras",1,0,0,0,1
"24259","warassumed",1,0,0,0,1
"24260","warbecame",1,0,0,0,1
"24261","warby",1,0,0,0,1
"24262","wards",1,0,0,0,1
"24263","ware",0,0,0,1,1
"24264","wares",0,0,0,1,1
"24265","warfare",1,0,0,0,1
"24266","warmand",1,0,0,0,1
"24267","warmblood",1,0,0,0,1
"24268","warmer",0,0,0,1,1
"24269","warmfriend",1,0,0,0,1
"24270","warmhearted",0,0,1,0,1
"24271","warmthof",1,0,0,0,1
"24272","warning.early",1,0,0,0,1
"24273","warnings",0,1,0,0,1
"24274","warrior",1,0,0,0,1
"24275","warthe",1,0,0,0,1
"24276","warupon",1,0,0,0,1
"24277","warwith",1,0,0,0,1
"24278","was.as",1,0,0,0,1
"24279","was.i",1,0,0,0,1
"24280","was.they",1,0,0,0,1
"24281","wasaccustomed",1,0,0,0,1
"24282","wasalso",1,0,0,0,1
"24283","wasaltogether",1,0,0,0,1
"24284","wasamong",1,0,0,0,1
"24285","wasapproached",1,0,0,0,1
"24286","wasas",1,0,0,0,1
"24287","wasat",1,0,0,0,1
"24288","wasbaptized",1,0,0,0,1
"24289","wasbesides",1,0,0,0,1
"24290","wascarefully",1,0,0,0,1
"24291","wascarried",1,0,0,0,1
"24292","waschafed",1,0,0,0,1
"24293","wasclearly",1,0,0,0,1
"24294","wascompletely",1,0,0,0,1
"24295","wasconcerned",1,0,0,0,1
"24296","wasconducted",1,0,0,0,1
"24297","wasdemanded",1,0,0,0,1
"24298","wasdenounced",1,0,0,0,1
"24299","wasdeprived",1,0,0,0,1
"24300","wasdoing",1,0,0,0,1
"24301","wasemphatic",1,0,0,0,1
"24302","wasenough",1,0,0,0,1
"24303","wasespecially",1,0,0,0,1
"24304","wasever",1,0,0,0,1
"24305","wasextremely",1,0,0,0,1
"24306","wasfearful",1,0,0,0,1
"24307","wasfinally",1,0,0,0,1
"24308","wasforgotten",1,0,0,0,1
"24309","wasfound",1,0,0,0,1
"24310","wasframed",1,0,0,0,1
"24311","wasfrom",1,0,0,0,1
"24312","wasfurious",1,0,0,0,1
"24313","wasgiven",1,0,0,0,1
"24314","wasgiving",1,0,0,0,1
"24315","washated",1,0,0,0,1
"24316","washer",1,0,0,0,1
"24317","washindered",1,0,0,0,1
"24318","washington ",0,0,0,1,1
"24319","washington_",0,1,0,0,1
"24320","washingtonto",1,0,0,0,1
"24321","washis",1,0,0,0,1
"24322","washot",1,0,0,0,1
"24323","wasinduced",1,0,0,0,1
"24324","wasjustified",1,0,0,0,1
"24325","waslargely",1,0,0,0,1
"24326","waslaziness",1,0,0,0,1
"24327","wasleading",1,0,0,0,1
"24328","waslike",1,0,0,0,1
"24329","waslikely",1,0,0,0,1
"24330","waslistened",1,0,0,0,1
"24331","wasliterally",1,0,0,0,1
"24332","waslittle",1,0,0,0,1
"24333","wasmade",1,0,0,0,1
"24334","wasmarked",1,0,0,0,1
"24335","wasmeeting",1,0,0,0,1
"24336","wasmodestly",1,0,0,0,1
"24337","wasmoney",1,0,0,0,1
"24338","wasmost",1,0,0,0,1
"24339","wasmoved",1,0,0,0,1
"24340","wasmurder",1,0,0,0,1
"24341","wasnecessary",1,0,0,0,1
"24342","wasneither",1,0,0,0,1
"24343","wasobliged",1,0,0,0,1
"24344","wasoften",1,0,0,0,1
"24345","wason",1,0,0,0,1
"24346","wasover",1,0,0,0,1
"24347","waspastor",1,0,0,0,1
"24348","waspractically",1,0,0,0,1
"24349","waspresent",1,0,0,0,1
"24350","wasprevented",1,0,0,0,1
"24351","wasprobably",1,0,0,0,1
"24352","wasproceeding",1,0,0,0,1
"24353","waspursued",1,0,0,0,1
"24354","wasready",1,0,0,0,1
"24355","wasreally",1,0,0,0,1
"24356","wasrecognized",1,0,0,0,1
"24357","wasregarded",1,0,0,0,1
"24358","wasrepaid",1,0,0,0,1
"24359","wasrepugnant",1,0,0,0,1
"24360","wasrequired",1,0,0,0,1
"24361","wasrevived",1,0,0,0,1
"24362","wassaid",1,0,0,0,1
"24363","wasscarcely",1,0,0,0,1
"24364","wasseldom",1,0,0,0,1
"24365","wasshocked",1,0,0,0,1
"24366","wassingularly",1,0,0,0,1
"24367","wasslavery’s",1,0,0,0,1
"24368","wasso",1,0,0,0,1
"24369","wassoon",1,0,0,0,1
"24370","wasspeaking",1,0,0,0,1
"24371","wassubject",1,0,0,0,1
"24372","wassuffering",1,0,0,0,1
"24373","wassuppressed",1,0,0,0,1
"24374","wassurprised",1,0,0,0,1
"24375","wassurprising",1,0,0,0,1
"24376","wastall",1,0,0,0,1
"24377","wastelegraphed",1,0,0,0,1
"24378","wasthat",1,0,0,0,1
"24379","wastheir",1,0,0,0,1
"24380","wastherefore",1,0,0,0,1
"24381","wasthus",1,0,0,0,1
"24382","wastold",1,0,0,0,1
"24383","wasunpopular",1,0,0,0,1
"24384","wasunshaken",1,0,0,0,1
"24385","wasup",1,0,0,0,1
"24386","wasutterly",1,0,0,0,1
"24387","wasvaluable",1,0,0,0,1
"24388","waswhere",1,0,0,0,1
"24389","waswholly",1,0,0,0,1
"24390","wasyoung",1,0,0,0,1
"24391","wasyounger",1,0,0,0,1
"24392","watchand",1,0,0,0,1
"24393","watchedthem",1,0,0,0,1
"24394","watchwords",0,0,1,0,1
"24395","wately",0,0,0,1,1
"24396","watering",1,0,0,0,1
"24397","waterloo",1,0,0,0,1
"24398","watermill",0,1,0,0,1
"24399","watermobocrats",1,0,0,0,1
"24400","watersof",1,0,0,0,1
"24401","watsonheard",1,0,0,0,1
"24402","waukerusia",1,0,0,0,1
"24403","waved",0,0,1,0,1
"24404","waving",0,1,0,0,1
"24405","wax",0,0,0,1,1
"24406","way ",0,0,0,1,1
"24407","way.after",1,0,0,0,1
"24408","waya",1,0,0,0,1
"24409","wayacross",1,0,0,0,1
"24410","wayfaring",0,1,0,0,1
"24411","wayof",1,0,0,0,1
"24412","wayplaces",1,0,0,0,1
"24413","ways",0,0,0,1,1
"24414","ways.but",1,0,0,0,1
"24415","waythrough",1,0,0,0,1
"24416","wayto",1,0,0,0,1
"24417","we’ll",1,0,0,0,1
"24418","we’ve",0,1,0,0,1
"24419","weak.slaves",1,0,0,0,1
"24420","weakand",1,0,0,0,1
"24421","wealth.from",1,0,0,0,1
"24422","wealthand",1,0,0,0,1
"24423","wealthiest",1,0,0,0,1
"24424","weaponsflying",1,0,0,0,1
"24425","weare",1,0,0,0,1
"24426","wearily",0,1,0,0,1
"24427","wearisome",0,1,0,0,1
"24428","wears",0,1,0,0,1
"24429","weath",0,0,0,1,1
"24430","weathe",0,0,0,1,1
"24431","weather.innocent",1,0,0,0,1
"24432","weathers.it",1,0,0,0,1
"24433","weaver",0,0,1,0,1
"24434","webster.the",1,0,0,0,1
"24435","webster’sspelling",1,0,0,0,1
"24436","websterian",1,0,0,0,1
"24437","wecelebrate",1,0,0,0,1
"24438","wedges",1,0,0,0,1
"24439","wednesdsay",0,0,0,1,1
"24440","weeden’s",0,1,0,0,1
"24441","weedens",0,1,0,0,1
"24442","week.my",1,0,0,0,1
"24443","weekafter",1,0,0,0,1
"24444","weekbefore",1,0,0,0,1
"24445","weekday",1,0,0,0,1
"24446","weeklynewspaper",1,0,0,0,1
"24447","weepingwillow",1,0,0,0,1
"24448","wefollowed",1,0,0,0,1
"24449","weigh",0,1,0,0,1
"24450","welabored",1,0,0,0,1
"24451","welcome.i",1,0,0,0,1
"24452","welcomedonly",1,0,0,0,1
"24453","welded",0,1,0,0,1
"24454","welearn",1,0,0,0,1
"24455","welfareof",1,0,0,0,1
"24456","welfareor",1,0,0,0,1
"24457","welfarewithin",1,0,0,0,1
"24458","well.history",1,0,0,0,1
"24459","well56",1,0,0,0,1
"24460","wellback",1,0,0,0,1
"24461","wellbeing",0,1,0,0,1
"24462","wellcalculated",1,0,0,0,1
"24463","wellknown",1,0,0,0,1
"24464","wellmight",1,0,0,0,1
"24465","wellon",1,0,0,0,1
"24466","wellpleased",1,0,0,0,1
"24467","wellrewarded",1,0,0,0,1
"24468","wellstricken",1,0,0,0,1
"24469","wemay",1,0,0,0,1
"24470","wentinto",1,0,0,0,1
"24471","wenton",1,0,0,0,1
"24472","wentover",1,0,0,0,1
"24473","wentup",1,0,0,0,1
"24474","wepassed",1,0,0,0,1
"24475","wepledged",1,0,0,0,1
"24476","wer",0,0,0,1,1
"24477","werea",1,0,0,0,1
"24478","wereabout",1,0,0,0,1
"24479","wereached",1,0,0,0,1
"24480","werealike",1,0,0,0,1
"24481","wereallowed",1,0,0,0,1
"24482","werealso",1,0,0,0,1
"24483","wereamazing",1,0,0,0,1
"24484","wereamong",1,0,0,0,1
"24485","werean",1,0,0,0,1
"24486","wereas",1,0,0,0,1
"24487","wereastonished",1,0,0,0,1
"24488","wereat",1,0,0,0,1
"24489","werebitter",1,0,0,0,1
"24490","werebrave",1,0,0,0,1
"24491","werebut",1,0,0,0,1
"24492","werecommitted",1,0,0,0,1
"24493","werecompletely",1,0,0,0,1
"24494","werecontemptible",1,0,0,0,1
"24495","werecowardly",1,0,0,0,1
"24496","werecruel",1,0,0,0,1
"24497","weredevoured",1,0,0,0,1
"24498","weredisgusted",1,0,0,0,1
"24499","weredivided",1,0,0,0,1
"24500","weredrawn",1,0,0,0,1
"24501","wereendeavoring",1,0,0,0,1
"24502","wereentangled",1,0,0,0,1
"24503","wereequally",1,0,0,0,1
"24504","wereevery",1,0,0,0,1
"24505","wereexerted",1,0,0,0,1
"24506","werefollowed",1,0,0,0,1
"24507","werefull",1,0,0,0,1
"24508","weregarded",1,0,0,0,1
"24509","weregiven",1,0,0,0,1
"24510","weregone",1,0,0,0,1
"24511","wereheroic",1,0,0,0,1
"24512","werehired",1,0,0,0,1
"24513","werehon",1,0,0,0,1
"24514","wereignorant",1,0,0,0,1
"24515","wereincompatible",1,0,0,0,1
"24516","werelearning",1,0,0,0,1
"24517","wereleaving",1,0,0,0,1
"24518","wereled",1,0,0,0,1
"24519","wereliterally",1,0,0,0,1
"24520","wereloosened",1,0,0,0,1
"24521","weremany",1,0,0,0,1
"24522","weremere",1,0,0,0,1
"24523","weremobbed",1,0,0,0,1
"24524","werenearest",1,0,0,0,1
"24525","wereoffered",1,0,0,0,1
"24526","wereover",1,0,0,0,1
"24527","werepermitted",1,0,0,0,1
"24528","wereprisoners",1,0,0,0,1
"24529","wereproportionally",1,0,0,0,1
"24530","wereproposed",1,0,0,0,1
"24531","werepuzzling",1,0,0,0,1
"24532","werereceived",1,0,0,0,1
"24533","wererepulsed",1,0,0,0,1
"24534","wereresponsible",1,0,0,0,1
"24535","wereruthlessly",1,0,0,0,1
"24536","werescarce",1,0,0,0,1
"24537","wereseparated",1,0,0,0,1
"24538","weresinks",1,0,0,0,1
"24539","wereso",1,0,0,0,1
"24540","werestolen",1,0,0,0,1
"24541","weresuffering",1,0,0,0,1
"24542","weresummoned",1,0,0,0,1
"24543","werethere",1,0,0,0,1
"24544","wereto",1,0,0,0,1
"24545","weretransported",1,0,0,0,1
"24546","werevery",1,0,0,0,1
"24547","werewell",1,0,0,0,1
"24548","werewhite",1,0,0,0,1
"24549","werewilling",1,0,0,0,1
"24550","wesailed",1,0,0,0,1
"24551","western ",0,0,0,1,1
"24552","westernstates",1,0,0,0,1
"24553","westindia",1,0,0,0,1
"24554","weston",0,1,0,0,1
"24555","wetherefore",1,0,0,0,1
"24556","wetting",0,1,0,0,1
"24557","weunderstood",1,0,0,0,1
"24558","wewaited",1,0,0,0,1
"24559","weymouth",0,1,0,0,1
"24560","whaling.my",1,0,0,0,1
"24561","whalingvoyages",1,0,0,0,1
"24562","wharvesof",1,0,0,0,1
"24563","what’s",0,1,0,0,1
"24564","whatcan",1,0,0,0,1
"24565","whatdepths",1,0,0,0,1
"24566","whateverperil",1,0,0,0,1
"24567","whathe",1,0,0,0,1
"24568","whatit",1,0,0,0,1
"24569","whatkind",1,0,0,0,1
"24570","whatlaws",1,0,0,0,1
"24571","whatsoever_",0,1,0,0,1
"24572","whatway",1,0,0,0,1
"24573","whatwe",1,0,0,0,1
"24574","whatwill",1,0,0,0,1
"24575","wheatfrom",1,0,0,0,1
"24576","wheelwright",1,0,0,0,1
"24577","whenall",1,0,0,0,1
"24578","whendenby",1,0,0,0,1
"24579","wheneight",1,0,0,0,1
"24580","whenhe",1,0,0,0,1
"24581","whenhenry",1,0,0,0,1
"24582","whenhungry",1,0,0,0,1
"24583","whenit",1,0,0,0,1
"24584","whenlistened",1,0,0,0,1
"24585","whenlooking",1,0,0,0,1
"24586","whenmaster",1,0,0,0,1
"24587","whennothing",1,0,0,0,1
"24588","whenpatience",1,0,0,0,1
"24589","whenquite",1,0,0,0,1
"24590","whenspeaking",1,0,0,0,1
"24591","whensubjected",1,0,0,0,1
"24592","whensufficiently",1,0,0,0,1
"24593","whenthere",1,0,0,0,1
"24594","whenthese",1,0,0,0,1
"24595","whentwenty",1,0,0,0,1
"24596","whenunited",1,0,0,0,1
"24597","whenwe",1,0,0,0,1
"24598","wher",0,0,0,1,1
"24599","whereall",1,0,0,0,1
"24600","wherelarge",1,0,0,0,1
"24601","whereon",0,1,0,0,1
"24602","whereone",1,0,0,0,1
"24603","whererabbits",1,0,0,0,1
"24604","whereslavery",1,0,0,0,1
"24605","wheresoever",1,0,0,0,1
"24606","wherethe",1,0,0,0,1
"24607","wherethere",1,0,0,0,1
"24608","wherethey",1,0,0,0,1
"24609","whereuntothis",1,0,0,0,1
"24610","wherever",0,0,0,1,1
"24611","whereversuch",1,0,0,0,1
"24612","whereverthe",1,0,0,0,1
"24613","whereverthis",1,0,0,0,1
"24614","whether",0,0,0,1,1
"24615","whetherfree",1,0,0,0,1
"24616","whetherhis",1,0,0,0,1
"24617","whetherwhite",1,0,0,0,1
"24618","whetstone",1,0,0,0,1
"24619","whichamerican",1,0,0,0,1
"24620","whichasks",1,0,0,0,1
"24621","whichawaited",1,0,0,0,1
"24622","whichbound",1,0,0,0,1
"24623","whichbrought",1,0,0,0,1
"24624","whichcan",1,0,0,0,1
"24625","whichcomprised",1,0,0,0,1
"24626","whichever",0,0,1,0,1
"24627","whicheverybody",1,0,0,0,1
"24628","whichfrederick",1,0,0,0,1
"24629","whichfriends",1,0,0,0,1
"24630","whichfrom",1,0,0,0,1
"24631","whichfurther",1,0,0,0,1
"24632","whichgod",1,0,0,0,1
"24633","whichgreatly",1,0,0,0,1
"24634","whichhad",1,0,0,0,1
"24635","whichhappened",1,0,0,0,1
"24636","whichhas",1,0,0,0,1
"24637","whichhuman",1,0,0,0,1
"24638","whichlaid",1,0,0,0,1
"24639","whichmany",1,0,0,0,1
"24640","whichmay",1,0,0,0,1
"24641","whichmore",1,0,0,0,1
"24642","whichmr",1,0,0,0,1
"24643","whichno",1,0,0,0,1
"24644","whichopened",1,0,0,0,1
"24645","whichrepresented",1,0,0,0,1
"24646","whichrequired",1,0,0,0,1
"24647","whichrose",1,0,0,0,1
"24648","whichseemed",1,0,0,0,1
"24649","whichso",1,0,0,0,1
"24650","whichsupposition",1,0,0,0,1
"24651","whichwe",1,0,0,0,1
"24652","whichwere",1,0,0,0,1
"24653","whichwill",1,0,0,0,1
"24654","whichwould",1,0,0,0,1
"24655","whigfriends",1,0,0,0,1
"24656","whileemployed",1,0,0,0,1
"24657","whilehe",1,0,0,0,1
"24658","whilehere",1,0,0,0,1
"24659","whileslavery",1,0,0,0,1
"24660","whilethe",1,0,0,0,1
"24661","whilethere",1,0,0,0,1
"24662","whilewinthrop",1,0,0,0,1
"24663","whileyou",1,0,0,0,1
"24664","whim",0,1,0,0,1
"24665","whining",0,0,1,0,1
"24666","whipburnt",1,0,0,0,1
"24667","whipfrederick",1,0,0,0,1
"24668","whiphim",1,0,0,0,1
"24669","whipped_",0,1,0,0,1
"24670","whippers",0,0,1,0,1
"24671","whipping.another",1,0,0,0,1
"24672","whippingsomebody",1,0,0,0,1
"24673","whipt",1,0,0,0,1
"24674","whirlwind.intoxicated",1,0,0,0,1
"24675","whisperings",1,0,0,0,1
"24676","whispers",0,1,0,0,1
"24677","whistle",0,1,0,0,1
"24678","whistled",1,0,0,0,1
"24679","whitbetter",1,0,0,0,1
"24680","white’s",0,1,0,0,1
"24681","whiteand",1,0,0,0,1
"24682","whitecarpenters",1,0,0,0,1
"24683","whitecravat",1,0,0,0,1
"24684","whited",0,0,1,0,1
"24685","whitefriends",1,0,0,0,1
"24686","whitekid",1,0,0,0,1
"24687","whiteman",1,0,0,0,1
"24688","whitemen",1,0,0,0,1
"24689","whitened",1,0,0,0,1
"24690","whiteperson",1,0,0,0,1
"24691","whitepopulation",1,0,0,0,1
"24692","whiting",1,0,0,0,1
"24693","whittle",1,0,0,0,1
"24694","who’s",1,0,0,0,1
"24695","whoa",1,0,0,0,1
"24696","whobetrayed",1,0,0,0,1
"24697","whocultivated",1,0,0,0,1
"24698","whodespise",1,0,0,0,1
"24699","whoenjoyed",1,0,0,0,1
"24700","whoforsook",1,0,0,0,1
"24701","whogathered",1,0,0,0,1
"24702","wholeappearance",1,0,0,0,1
"24703","wholeheap",1,0,0,0,1
"24704","wholeneighborhood",1,0,0,0,1
"24705","wholeplace",1,0,0,0,1
"24706","wholerace",1,0,0,0,1
"24707","wholescale",1,0,0,0,1
"24708","wholesome",0,1,0,0,1
"24709","wholesum",1,0,0,0,1
"24710","wholething",1,0,0,0,1
"24711","wholived",1,0,0,0,1
"24712","whollyeffected",1,0,0,0,1
"24713","whollyvanished",1,0,0,0,1
"24714","whommr",1,0,0,0,1
"24715","whomsoever",1,0,0,0,1
"24716","whoof",1,0,0,0,1
"24717","whopossessed",1,0,0,0,1
"24718","whoput",1,0,0,0,1
"24719","whoreclined",1,0,0,0,1
"24720","whoseacquaintance",1,0,0,0,1
"24721","whosebase",0,0,0,1,1
"24722","whoseearly",1,0,0,0,1
"24723","whoshall",1,0,0,0,1
"24724","whoshould",1,0,0,0,1
"24725","whoso",0,1,0,0,1
"24726","whowould",1,0,0,0,1
"24727","whyam",1,0,0,0,1
"24728","whyare",1,0,0,0,1
"24729","whygo",1,0,0,0,1
"24730","whythe",1,0,0,0,1
"24731","whythey",1,0,0,0,1
"24732","wickedly",0,1,0,0,1
"24733","wickedprovisions",1,0,0,0,1
"24734","wid",1,0,0,0,1
"24735","wifes",0,0,0,1,1
"24736","wildand",1,0,0,0,1
"24737","wildering",1,0,0,0,1
"24738","wildernessto",1,0,0,0,1
"24739","wilds",1,0,0,0,1
"24740","wilkes",0,0,1,0,1
"24741","will.all",1,0,0,0,1
"24742","will.the",1,0,0,0,1
"24743","willdisappear",1,0,0,0,1
"24744","willgive",1,0,0,0,1
"24745","william’s",0,1,0,0,1
"24746","williamadams",1,0,0,0,1
"24747","williamchase",1,0,0,0,1
"24748","williamm",1,0,0,0,1
"24749","williamslade",1,0,0,0,1
"24750","williamthomas",1,0,0,0,1
"24751","williamwilberforce",1,0,0,0,1
"24752","willinglyfling",1,0,0,0,1
"24753","willingnessto",1,0,0,0,1
"24754","willingto",1,0,0,0,1
"24755","willis",0,0,1,0,1
"24756","willselect",1,0,0,0,1
"24757","willthese",1,0,0,0,1
"24758","wilmarth",1,0,0,0,1
"24759","wilson.the",1,0,0,0,1
"24760","windsor",1,0,0,0,1
"24761","wink",1,0,0,0,1
"24762","winked",0,0,1,0,1
"24763","winter’s",1,0,0,0,1
"24764","winthropon",1,0,0,0,1
"24765","wipwell",0,0,0,1,1
"24766","wisdom.after",1,0,0,0,1
"24767","wisdomof",1,0,0,0,1
"24768","wise:the",1,0,0,0,1
"24769","wise.there",1,0,0,0,1
"24770","wisefor",1,0,0,0,1
"24771","wisest",0,1,0,0,1
"24772","wiseto",1,0,0,0,1
"24773","wishes.when",1,0,0,0,1
"24774","wishor",1,0,0,0,1
"24775","wishto",1,0,0,0,1
"24776","withabolitionists",1,0,0,0,1
"24777","withaches",1,0,0,0,1
"24778","withan",1,0,0,0,1
"24779","witharms",1,0,0,0,1
"24780","withastonishment",1,0,0,0,1
"24781","withcolored",1,0,0,0,1
"24782","withcomplete",1,0,0,0,1
"24783","withcurses",1,0,0,0,1
"24784","withdestruction",1,0,0,0,1
"24785","withdraw",1,0,0,0,1
"24786","witheach",1,0,0,0,1
"24787","witheager",1,0,0,0,1
"24788","witheither",1,0,0,0,1
"24789","wither",0,1,0,0,1
"24790","withered",0,1,0,0,1
"24791","witheredand",1,0,0,0,1
"24792","withering",0,1,0,0,1
"24793","withersoever",1,0,0,0,1
"24794","withfear",1,0,0,0,1
"24795","withfingers",1,0,0,0,1
"24796","withfriendly",1,0,0,0,1
"24797","withharrowing",1,0,0,0,1
"24798","withhaving",1,0,0,0,1
"24799","withhearts",1,0,0,0,1
"24800","withhenry",1,0,0,0,1
"24801","withher",1,0,0,0,1
"24802","withhim",1,0,0,0,1
"24803","withhimself",1,0,0,0,1
"24804","withholds",0,0,1,0,1
"24805","withhunger",1,0,0,0,1
"24806","withimportunities",1,0,0,0,1
"24807","withindifference.chapter",1,0,0,0,1
"24808","withinher",1,0,0,0,1
"24809","withinthe",1,0,0,0,1
"24810","withinventing",1,0,0,0,1
"24811","withits",1,0,0,0,1
"24812","withjust",1,0,0,0,1
"24813","withletters",1,0,0,0,1
"24814","withlightning",1,0,0,0,1
"24815","withmaster",1,0,0,0,1
"24816","withme",1,0,0,0,1
"24817","withmr",1,0,0,0,1
"24818","withmuskets",1,0,0,0,1
"24819","withouta",1,0,0,0,1
"24820","withoutan",1,0,0,0,1
"24821","withoutbeing",1,0,0,0,1
"24822","withoutbustle",1,0,0,0,1
"24823","withoutexposing",1,0,0,0,1
"24824","withoutfeeling",1,0,0,0,1
"24825","withouthindrance",1,0,0,0,1
"24826","withoutmaking",1,0,0,0,1
"24827","withoutpreparation",1,0,0,0,1
"24828","withoutredress",1,0,0,0,1
"24829","withouttaking",1,0,0,0,1
"24830","withoutthe",1,0,0,0,1
"24831","withoutthinking",1,0,0,0,1
"24832","withpersons",1,0,0,0,1
"24833","withpieces",1,0,0,0,1
"24834","withpromptness",1,0,0,0,1
"24835","withrain",1,0,0,0,1
"24836","withreproaches",1,0,0,0,1
"24837","withsaintly",1,0,0,0,1
"24838","withsandy",1,0,0,0,1
"24839","withserfdom",1,0,0,0,1
"24840","withsincere",1,0,0,0,1
"24841","withskilled",1,0,0,0,1
"24842","withslavery",1,0,0,0,1
"24843","withstand",0,1,0,0,1
"24844","withstartling",1,0,0,0,1
"24845","withsuch",1,0,0,0,1
"24846","withthese",1,0,0,0,1
"24847","withthree",1,0,0,0,1
"24848","withtrees",1,0,0,0,1
"24849","withunutterable",1,0,0,0,1
"24850","withvery",1,0,0,0,1
"24851","withwhich",1,0,0,0,1
"24852","withyou",1,0,0,0,1
"24853","witnessedthe",1,0,0,0,1
"24854","wits",1,0,0,0,1
"24855","wittingly",0,1,0,0,1
"24856","witty",0,0,1,0,1
"24857","wm.lloyd",1,0,0,0,1
"24858","wm.needles",1,0,0,0,1
"24859","woa",0,1,0,0,1
"24860","woes",0,1,0,0,1
"24861","wolfamong",1,0,0,0,1
"24862","woman.chapter",1,0,0,0,1
"24863","woman’sinfluence",1,0,0,0,1
"24864","woman’srights",1,0,0,0,1
"24865","woman’staking",1,0,0,0,1
"24866","womanand",1,0,0,0,1
"24867","womanhood",0,1,0,0,1
"24868","womanor",1,0,0,0,1
"24869","women’s",0,0,1,0,1
"24870","womenamong",1,0,0,0,1
"24871","womenwere",1,0,0,0,1
"24872","won’tdo",1,0,0,0,1
"24873","wondered",1,0,0,0,1
"24874","wonderfulart",1,0,0,0,1
"24875","wonderfulness",0,1,0,0,1
"24876","wonderfulpowers",1,0,0,0,1
"24877","wondering",1,0,0,0,1
"24878","wonderis",1,0,0,0,1
"24879","wonderous",0,0,0,1,1
"24880","wonted",0,1,0,0,1
"24881","wood’s",1,0,0,0,1
"24882","woodford",1,0,0,0,1
"24883","woodhouses",0,1,0,0,1
"24884","woodhull",0,0,0,1,1
"24885","woodsdrew",1,0,0,0,1
"24886","woodsmy",1,0,0,0,1
"24887","woodused",1,0,0,0,1
"24888","woodwhich",1,0,0,0,1
"24889","wooed",0,0,0,1,1
"24890","wool",0,0,1,0,1
"24891","woolenjacket",1,0,0,0,1
"24892","woolfolk",0,0,1,0,1
"24893","woolly",0,1,0,0,1
"24894","woonsocket",1,0,0,0,1
"24895","word_",0,1,0,0,1
"24896","word.the",1,0,0,0,1
"24897","worde",0,0,0,1,1
"24898","wordhad",1,0,0,0,1
"24899","wordof",1,0,0,0,1
"24900","words_",0,1,0,0,1
"24901","words.he",1,0,0,0,1
"24902","wordsand",1,0,0,0,1
"24903","wordssounded",1,0,0,0,1
"24904","wordthat",1,0,0,0,1
"24905","work.republics",1,0,0,0,1
"24906","workaccomplished",1,0,0,0,1
"24907","workbefore",1,0,0,0,1
"24908","worked",0,0,0,1,1
"24909","worked.when",1,0,0,0,1
"24910","workedbrain",1,0,0,0,1
"24911","workedus",1,0,0,0,1
"24912","workedwith",1,0,0,0,1
"24913","workingman",1,0,0,0,1
"24914","workmanship.there",1,0,0,0,1
"24915","workwhich",1,0,0,0,1
"24916","workyou",1,0,0,0,1
"24917","world_",1,0,0,0,1
"24918","world’sexhibition",1,0,0,0,1
"24919","worldin",1,0,0,0,1
"24920","worldis",1,0,0,0,1
"24921","worldnot",1,0,0,0,1
"24922","worlds",1,0,0,0,1
"24923","worldthat",1,0,0,0,1
"24924","worldwas",1,0,0,0,1
"24925","worldwhere",1,0,0,0,1
"24926","worldwhich",1,0,0,0,1
"24927","wormley",1,0,0,0,1
"24928","wornthin",1,0,0,0,1
"24929","worriedthat",1,0,0,0,1
"24930","worse.preceding",1,0,0,0,1
"24931","worsethan",1,0,0,0,1
"24932","worshiping",0,1,0,0,1
"24933","worshipper",0,0,1,0,1
"24934","worships",0,1,0,0,1
"24935","worthily",0,1,0,0,1
"24936","worthliving",1,0,0,0,1
"24937","woul",0,0,0,1,1
"24938","wouldaddress",1,0,0,0,1
"24939","wouldat",1,0,0,0,1
"24940","wouldbring",1,0,0,0,1
"24941","wouldcost",1,0,0,0,1
"24942","wouldfain",1,0,0,0,1
"24943","wouldgo",1,0,0,0,1
"24944","wouldhe",1,0,0,0,1
"24945","wouldimperil",1,0,0,0,1
"24946","wouldinfluence",1,0,0,0,1
"24947","wouldkeep",1,0,0,0,1
"24948","wouldkidnap",1,0,0,0,1
"24949","wouldmake",1,0,0,0,1
"24950","wouldoccasionally",1,0,0,0,1
"24951","wouldoften",1,0,0,0,1
"24952","wouldprobably",1,0,0,0,1
"24953","wouldrecommend",1,0,0,0,1
"24954","wouldrelent",1,0,0,0,1
"24955","wouldserve",1,0,0,0,1
"24956","wouldso",1,0,0,0,1
"24957","wouldsometimes",1,0,0,0,1
"24958","wouldsoon",1,0,0,0,1
"24959","wouldsuppress",1,0,0,0,1
"24960","wouldtake",1,0,0,0,1
"24961","wouldultimately",1,0,0,0,1
"24962","woundsuntil",1,0,0,0,1
"24963","wrathamongst",1,0,0,0,1
"24964","wrestedfrom",1,0,0,0,1
"24965","wrestler",0,1,0,0,1
"24966","wretchedcondition",1,0,0,0,1
"24967","wretchedly",1,0,0,0,1
"24968","wretchedness.chapter",1,0,0,0,1
"24969","wretchednessand",1,0,0,0,1
"24970","wrinkled",0,0,1,0,1
"24971","wrist",0,1,0,0,1
"24972","write.those",1,0,0,0,1
"24973","writer.in",1,0,0,0,1
"24974","writes",0,1,0,0,1
"24975","writing.after",1,0,0,0,1
"24976","writingletters",1,0,0,0,1
"24977","writingor",1,0,0,0,1
"24978","written.at",1,0,0,0,1
"24979","writtenon",1,0,0,0,1
"24980","wrongfully",0,0,1,0,1
"24981","wrongfulness",0,1,0,0,1
"24982","wroteher",1,0,0,0,1
"24983","ws",0,1,0,0,1
"24984","x.learning",1,0,0,0,1
"24985","x.the",1,0,0,0,1
"24986","xi.growing",1,0,0,0,1
"24987","xi.secession",1,0,0,0,1
"24988","xii.hope",1,0,0,0,1
"24989","xii.religious",1,0,0,0,1
"24990","xiii.the",1,0,0,0,1
"24991","xiii.vast",1,0,0,0,1
"24992","xiv.experience",1,0,0,0,1
"24993","xiv.living",1,0,0,0,1
"24994","xix.retrospection",1,0,0,0,1
"24995","xix.the",1,0,0,0,1
"24996","xv.covey",1,0,0,0,1
"24997","xv.weighed",1,0,0,0,1
"24998","xvi.another",1,0,0,0,1
"24999","xvii.incidents",1,0,0,0,1
"25000","xvii.the",1,0,0,0,1
"25001","xviii.new",1,0,0,0,1
"25002","xx.apprenticeship",1,0,0,0,1
"25003","xxi.escape",1,0,0,0,1
"25004","yale",1,0,0,0,1
"25005","yardat",1,0,0,0,1
"25006","yardnear",1,0,0,0,1
"25007","yardupon",1,0,0,0,1
"25008","yates",1,0,0,0,1
"25009","yawning",1,0,0,0,1
"25010","ye_",0,1,0,0,1
"25011","year",0,0,0,1,1
"25012","year.at",1,0,0,0,1
"25013","yearby",1,0,0,0,1
"25014","yearlyallowance",1,0,0,0,1
"25015","years.there",1,0,0,0,1
"25016","yearsafter",1,0,0,0,1
"25017","yearsthis",1,0,0,0,1
"25018","yearswhen",1,0,0,0,1
"25019","yearswith",1,0,0,0,1
"25020","yeathese",1,0,0,0,1
"25021","yeeld",0,0,0,1,1
"25022","yells",0,1,0,0,1
"25023","yes",0,0,0,1,1
"25024","yeta",1,0,0,0,1
"25025","yethad",1,0,0,0,1
"25026","yethere",1,0,0,0,1
"25027","yetmore",1,0,0,0,1
"25028","yetturning",1,0,0,0,1
"25029","yoked",0,0,1,0,1
"25030","yon",0,1,0,0,1
"25031","yonderheights",1,0,0,0,1
"25032","york_",0,1,0,0,1
"25033","york_evangelist_",1,0,0,0,1
"25034","york_tribune_",1,0,0,0,1
"25035","york.in",1,0,0,0,1
"25036","yorkcentral",1,0,0,0,1
"25037","yorkpapers",1,0,0,0,1
"25038","youare",1,0,0,0,1
"25039","youat",1,0,0,0,1
"25040","youbelong",1,0,0,0,1
"25041","yougave",1,0,0,0,1
"25042","young",0,0,0,1,1
"25043","youngand",1,0,0,0,1
"25044","youngcalkers",1,0,0,0,1
"25045","youngfreemen",1,0,0,0,1
"25046","younggentleman",1,0,0,0,1
"25047","younggirl",1,0,0,0,1
"25048","youngheart",1,0,0,0,1
"25049","younglegs",1,0,0,0,1
"25050","youngnegroes",1,0,0,0,1
"25051","youngroberts",1,0,0,0,1
"25052","youngtendrils",1,0,0,0,1
"25053","youngworking",1,0,0,0,1
"25054","youold",1,0,0,0,1
"25055","yourascal",1,0,0,0,1
"25056","yourescape",1,0,0,0,1
"25057","yourhands",1,0,0,0,1
"25058","yourspeech",1,0,0,0,1
"25059","yourstory",1,0,0,0,1
"25060","youscoundrel",1,0,0,0,1
"25061","youshould",1,0,0,0,1
"25062","youthe",1,0,0,0,1
"25063","youthshould",1,0,0,0,1
"25064","youto",1,0,0,0,1
"25065","youwere",1,0,0,0,1
"25066","zero.although",1,0,0,0,1
"25067","zest",0,1,0,0,1
"25068","zizag",0,0,0,1,1
